userID,trajID,poiID,startTime,endTime,#photo,trajLen,poiDuration
10058801@N06,0,25,1226726126,1226726126,1,1,0
10087938@N02,1,58,1205332532,1205332541,2,2,9
10087938@N02,1,66,1205342722,1205342729,2,2,7
10087938@N02,2,59,1205374109,1205374109,1,1,0
10087938@N02,3,58,1205417265,1205417265,1,1,0
10087938@N02,4,58,1205508764,1205538412,3,2,29648
10087938@N02,4,59,1205512653,1205514882,22,2,2229
10087938@N02,5,59,1205575764,1205595114,4,1,19350
10087938@N02,6,59,1205625724,1205641382,2,1,15658
10087938@N02,7,58,1205812892,1205812892,1,1,0
100895643@N03,8,63,1390881648,1390881648,1,1,0
100895643@N03,9,26,1391604750,1391604752,2,2,2
100895643@N03,9,63,1391604757,1391604761,3,2,4
101884347@N06,10,26,1386888998,1386918382,3,1,29384
101884347@N06,11,50,1386982312,1386982675,6,2,363
101884347@N06,11,71,1386981574,1386982272,7,2,698
10195518@N02,12,44,1180847798,1180847798,1,1,0
10195518@N02,13,22,1187167445,1187172158,2,1,4713
10195518@N02,14,55,1188624755,1188624755,1,6,0
10195518@N02,14,56,1188622886,1188623097,2,6,211
10195518@N02,14,57,1188623870,1188623978,2,6,108
10195518@N02,14,75,1188621562,1188621562,1,6,0
10195518@N02,14,78,1188624626,1188624626,1,6,0
10195518@N02,14,81,1188620918,1188620918,1,6,0
10195518@N02,15,26,1189318797,1189318797,1,1,0
10195518@N02,16,71,1191728406,1191729053,3,1,647
10195518@N02,17,28,1191980375,1191980793,2,1,418
10204545@N02,18,41,1319583950,1319583950,1,1,0
10204545@N02,19,84,1321249118,1321249885,4,1,767
10204545@N02,20,41,1322023815,1322023815,1,1,0
10204545@N02,21,84,1327623667,1327623667,1,1,0
10204545@N02,22,51,1331675460,1331675460,1,1,0
10204545@N02,23,49,1332135762,1332135762,1,1,0
10204545@N02,24,41,1335999097,1335999097,1,1,0
10204545@N02,25,24,1339715328,1339715328,1,1,0
10204545@N02,26,0,1341892052,1341895059,2,1,3007
10204545@N02,27,45,1342248196,1342248196,1,1,0
10204545@N02,28,48,1342313781,1342313781,1,1,0
10204545@N02,29,41,1342747528,1342747528,1,1,0
10204545@N02,30,85,1359928386,1359928386,1,1,0
10204545@N02,31,82,1380497719,1380497719,1,1,0
10204545@N02,32,84,1381220335,1381220335,1,1,0
10204545@N02,33,84,1386809710,1386809710,1,1,0
10271461@N00,34,58,1394710564,1394710564,1,1,0
10284272@N00,35,39,1317878979,1317878979,1,1,0
10286664@N03,36,17,1294700686,1294700686,1,1,0
10357544@N07,37,3,1292897542,1292897542,1,1,0
10357544@N07,38,48,1294538342,1294538342,1,1,0
10357544@N07,39,71,1307754660,1307754660,1,1,0
10368554@N00,40,31,1155547833,1155547833,1,1,0
10368554@N00,41,84,1186242241,1186242241,1,1,0
105106606@N05,42,45,1368084989,1368084989,1,1,0
105106606@N05,43,71,1368327444,1368327444,1,1,0
10512081@N00,44,46,1336215421,1336215421,1,1,0
10512081@N00,45,24,1336354868,1336354868,1,2,0
10512081@N00,45,48,1336355665,1336355665,1,2,0
10512081@N00,46,11,1336562021,1336562021,1,1,0
10559879@N00,47,26,1164702271,1164702271,1,1,0
10559879@N00,48,22,1170035012,1170035012,1,2,0
10559879@N00,48,82,1170036683,1170036807,2,2,124
10559879@N00,49,22,1170211240,1170211240,1,2,0
10559879@N00,49,40,1170206723,1170206723,1,2,0
10559879@N00,50,2,1170311179,1170311179,1,1,0
10559879@N00,51,22,1170401072,1170401072,1,2,0
10559879@N00,51,37,1170409720,1170409720,1,2,0
10559879@N00,52,40,1170545648,1170545648,1,1,0
10559879@N00,53,19,1173921655,1173921679,2,1,24
10559879@N00,54,2,1174040078,1174040078,1,2,0
10559879@N00,54,23,1174044899,1174046905,2,2,2006
10559879@N00,55,19,1174438806,1174439896,3,1,1090
10559879@N00,56,22,1174598479,1174616236,5,1,17757
10559879@N00,57,85,1179477632,1179477632,1,1,0
10559879@N00,58,14,1179888215,1179888229,2,1,14
10559879@N00,59,82,1180664891,1180664956,3,1,65
10559879@N00,60,10,1180742696,1180742716,2,1,20
10559879@N00,61,17,1192171522,1192171522,1,1,0
10559879@N00,62,26,1195722163,1195722196,3,1,33
10559879@N00,63,14,1197533457,1197543567,7,3,10110
10559879@N00,63,17,1197533405,1197533405,1,3,0
10559879@N00,63,40,1197509438,1197511016,4,3,1578
10559879@N00,64,2,1197597660,1197597660,1,4,0
10559879@N00,64,9,1197598202,1197598209,2,4,7
10559879@N00,64,32,1197598316,1197599281,3,4,965
10559879@N00,64,40,1197595510,1197596758,4,4,1248
10559879@N00,65,26,1198364762,1198364762,1,1,0
10559879@N00,66,18,1204350874,1204350891,2,1,17
10559879@N00,67,41,1204612513,1204612513,1,1,0
10559879@N00,68,22,1205380392,1205380412,2,1,20
10559879@N00,69,19,1205568774,1205579960,36,1,11186
10559879@N00,70,19,1205646525,1205646525,1,1,0
10559879@N00,71,22,1205877388,1205890416,3,1,13028
10559879@N00,72,22,1205967504,1205967504,1,1,0
10559879@N00,73,22,1206078994,1206078994,1,1,0
10559879@N00,74,22,1209367493,1209367493,1,1,0
10559879@N00,75,22,1209718443,1209721751,9,1,3308
10559879@N00,76,35,1278571121,1278571121,2,1,0
10559879@N00,77,22,1280465480,1280465480,1,1,0
10559879@N00,78,16,1282597761,1282597841,2,3,80
10559879@N00,78,22,1282599713,1282599713,1,3,0
10559879@N00,78,41,1282599491,1282599540,2,3,49
10559879@N00,79,9,1284104297,1284104297,1,1,0
10559879@N00,80,2,1284672801,1284673247,2,1,446
10559879@N00,81,22,1287647198,1287647198,1,1,0
10559879@N00,82,9,1289279121,1289279121,1,1,0
10559879@N00,83,9,1294160246,1294160246,1,1,0
10559879@N00,84,32,1305860433,1305860433,1,1,0
10559879@N00,85,16,1317955256,1317955256,1,1,0
10559879@N00,86,35,1318909153,1318909153,1,1,0
10559879@N00,87,23,1320722656,1320722656,1,1,0
10559879@N00,88,22,1320970280,1320970280,1,1,0
10559879@N00,89,71,1322599582,1322599582,1,1,0
10559879@N00,90,69,1323829027,1323829087,2,1,60
10559879@N00,91,22,1326772112,1326772112,1,1,0
10559879@N00,92,39,1327300443,1327300443,1,1,0
10559879@N00,93,9,1327339638,1327339653,3,1,15
10559879@N00,94,9,1329278415,1329278415,1,1,0
10559879@N00,95,32,1332390094,1332390094,1,2,0
10559879@N00,95,84,1332390957,1332390957,1,2,0
10559879@N00,96,35,1346643883,1346643883,1,1,0
10559879@N00,97,4,1353893614,1353894443,4,2,829
10559879@N00,97,16,1353893355,1353895578,5,2,2223
10559879@N00,98,22,1355100453,1355100453,1,1,0
10559879@N00,99,46,1359786031,1359786031,1,1,0
10559879@N00,100,82,1369175231,1369175231,1,1,0
10559879@N00,101,84,1369276417,1369276420,2,1,3
10559879@N00,102,32,1369711616,1369711616,1,1,0
10559879@N00,103,22,1369795280,1369795280,1,1,0
10559879@N00,104,25,1371288388,1371288388,1,1,0
10559879@N00,105,22,1372035642,1372035642,1,1,0
10559879@N00,106,9,1372387009,1372387009,1,1,0
10559879@N00,107,2,1372492306,1372497257,5,1,4951
10559879@N00,108,84,1373541850,1373541850,1,1,0
10559879@N00,109,9,1373853082,1373853117,2,1,35
10559879@N00,110,9,1374063429,1374063429,1,1,0
10559879@N00,111,22,1374623718,1374623718,1,1,0
10559879@N00,112,9,1374753044,1374753044,1,1,0
10559879@N00,113,84,1375443842,1375443842,1,1,0
10559879@N00,114,10,1376384054,1376384602,4,1,548
10559879@N00,115,22,1376880380,1376881115,3,1,735
10559879@N00,116,22,1376967987,1376967987,1,2,0
10559879@N00,116,82,1376951876,1376952086,3,2,210
10559879@N00,117,84,1377212608,1377212885,2,1,277
10559879@N00,118,22,1377484605,1377484605,1,1,0
10559879@N00,119,84,1377829131,1377829131,1,1,0
10559879@N00,120,4,1378348080,1378348103,2,2,23
10559879@N00,120,15,1378332967,1378332967,1,2,0
10559879@N00,121,84,1379024857,1379030006,4,1,5149
10559879@N00,122,22,1379918133,1379918133,1,1,0
10559879@N00,123,22,1380077788,1380077788,1,1,0
10559879@N00,124,22,1380672636,1380672636,1,2,0
10559879@N00,124,84,1380666948,1380666948,1,2,0
10559879@N00,125,16,1383268798,1383268798,1,1,0
10602166@N06,126,49,1323921431,1323922719,2,1,1288
10681948@N00,127,3,1279346196,1279346196,1,1,0
10681948@N00,128,84,1287890357,1287890357,1,1,0
10681948@N00,129,3,1303034557,1303034557,1,3,0
10681948@N00,129,23,1303013299,1303013299,1,3,0
10681948@N00,129,40,1303014585,1303015351,2,3,766
10681948@N00,130,28,1305951800,1305951800,1,1,0
10681948@N00,131,3,1308458404,1308460452,5,1,2048
10681948@N00,132,31,1310860190,1310860290,2,2,100
10681948@N00,132,68,1310865071,1310865236,2,2,165
10681948@N00,133,23,1311485648,1311485648,1,1,0
10681948@N00,134,57,1314425999,1314425999,1,1,0
10681948@N00,135,25,1318051245,1318053665,2,1,2420
10681948@N00,136,3,1329633566,1329633566,1,1,0
10681948@N00,137,61,1330239342,1330239342,1,1,0
10681948@N00,138,0,1331521978,1331521978,1,1,0
10681948@N00,139,53,1342321218,1342328630,3,1,7412
10681948@N00,140,53,1344051595,1344051595,1,1,0
10681948@N00,141,48,1347169007,1347170387,2,1,1380
10751935@N00,142,18,1248162065,1248162065,1,1,0
10896675@N00,143,36,1362882407,1362883560,3,6,1153
10896675@N00,143,41,1362879115,1362879115,1,6,0
10896675@N00,143,50,1362912547,1362912547,1,6,0
10896675@N00,143,55,1362890512,1362897292,2,6,6780
10896675@N00,143,71,1362902238,1362902238,1,6,0
10896675@N00,143,81,1362903810,1362908347,2,6,4537
10896675@N00,144,50,1362944157,1362944157,1,1,0
10936890@N00,145,15,1163902348,1163902348,1,8,0
10936890@N00,145,40,1163912419,1163912419,1,8,0
10936890@N00,145,48,1163909112,1163909112,1,8,0
10936890@N00,145,50,1163900859,1163905407,2,8,4548
10936890@N00,145,69,1163907941,1163907941,1,8,0
10936890@N00,145,70,1163906993,1163906993,1,8,0
10936890@N00,145,82,1163900800,1163900830,2,8,30
10936890@N00,145,84,1163914197,1163916571,2,8,2374
10936890@N00,146,36,1164074291,1164079030,7,2,4739
10936890@N00,146,49,1164084824,1164085779,5,2,955
10966462@N02,147,21,1353550725,1353551312,2,4,587
10966462@N02,147,22,1353545964,1353545964,1,4,0
10966462@N02,147,41,1353538738,1353566409,8,4,27671
10966462@N02,147,84,1353552578,1353554268,3,4,1690
10966462@N02,148,37,1353717552,1353717552,1,1,0
110608682@N04,149,45,1388332056,1388332056,1,2,0
110608682@N04,149,81,1388332447,1388333866,4,2,1419
110608682@N04,150,27,1388449068,1388450360,3,4,1292
110608682@N04,150,67,1388444349,1388446069,4,4,1720
110608682@N04,150,71,1388411301,1388417911,5,4,6610
110608682@N04,150,81,1388447529,1388448752,4,4,1223
11061346@N00,151,82,1343694229,1343694229,1,1,0
110846737@N06,152,32,1237255588,1237255588,2,1,0
110846737@N06,153,32,1389623652,1389624774,3,1,1122
110846737@N06,154,32,1392204857,1392204857,1,1,0
112266406@N07,155,26,1387929988,1387934605,3,1,4617
11237774@N04,156,32,1375483470,1375483470,1,1,0
11237774@N04,157,14,1375516104,1375516104,1,1,0
11237774@N04,158,18,1375573336,1375573336,1,1,0
11376310@N00,159,56,1232693416,1232693957,3,1,541
11376310@N00,160,56,1232757526,1232759086,9,1,1560
11376310@N00,161,63,1295650869,1295650869,1,1,0
11376310@N00,162,58,1332046998,1332046998,1,1,0
11576733@N00,163,11,1350688656,1350688656,1,1,0
11576733@N00,164,48,1350794255,1350794414,2,1,159
11674539@N06,165,32,1318734368,1318734368,1,1,0
11674539@N06,166,9,1319867398,1319867502,2,3,104
11674539@N06,166,44,1319870356,1319870356,1,3,0
11674539@N06,166,81,1319870552,1319870552,1,3,0
11706283@N04,167,46,1363984361,1363984361,1,1,0
11827916@N00,168,32,1273895300,1273895300,1,1,0
11845250@N00,169,56,1227196040,1227196240,3,1,200
11845250@N00,170,71,1228467233,1228468890,8,1,1657
11845250@N00,171,4,1253765204,1253765204,1,2,0
11845250@N00,171,24,1253777379,1253777379,1,2,0
11845250@N00,172,56,1258702474,1258706385,4,1,3911
119661606@N06,173,26,1394993033,1394993055,4,1,22
12175332@N06,174,11,1289311599,1289311599,1,1,0
12175332@N06,175,11,1293095016,1293095016,1,1,0
12175332@N06,176,11,1294295073,1294295073,1,1,0
12175332@N06,177,11,1294336619,1294336619,1,1,0
12175332@N06,178,48,1294398871,1294398871,1,1,0
12175332@N06,179,11,1295682797,1295682797,1,1,0
12175332@N06,180,11,1296053896,1296053896,1,1,0
12175332@N06,181,11,1307453518,1307453518,1,1,0
12175332@N06,182,71,1307646420,1307646420,1,1,0
12175332@N06,183,9,1317144701,1317144701,1,1,0
12175332@N06,184,3,1317492735,1317492735,1,1,0
12175332@N06,185,11,1317900705,1317900705,1,1,0
12199582@N00,186,37,1181178801,1181178801,1,1,0
12199582@N00,187,17,1182835024,1182835057,2,1,33
12210244@N04,188,32,1298759088,1298759088,1,1,0
12210244@N04,189,55,1298946456,1298946456,1,1,0
12210244@N04,190,44,1307717944,1307717944,1,1,0
12238277@N04,191,6,1360019689,1360084448,8,5,64759
12238277@N04,191,23,1360021494,1360021623,4,5,129
12238277@N04,191,45,1360031598,1360031598,1,5,0
12238277@N04,191,71,1360058284,1360058406,2,5,122
12238277@N04,191,78,1360014883,1360014927,2,5,44
12275071@N00,192,2,1330842958,1330842958,1,1,0
12275071@N00,193,37,1335262925,1335262925,1,1,0
12275071@N00,194,82,1345263249,1345263249,1,1,0
12275071@N00,195,82,1346204366,1346204366,1,1,0
12275071@N00,196,71,1347449439,1347449439,1,1,0
12275071@N00,197,11,1366252139,1366252139,1,1,0
12284993@N00,198,9,1197711178,1197711550,4,4,372
12284993@N00,198,11,1197734513,1197745907,4,4,11394
12284993@N00,198,40,1197741106,1197741192,2,4,86
12284993@N00,198,50,1197707202,1197707202,1,4,0
12284993@N00,199,26,1197784974,1197785047,2,1,73
12284993@N00,200,2,1197870593,1197870593,1,3,0
12284993@N00,200,15,1197882810,1197882810,1,3,0
12284993@N00,200,32,1197882293,1197882293,1,3,0
12284993@N00,201,50,1197937578,1197937578,1,1,0
12284993@N00,202,2,1198103767,1198103767,1,5,0
12284993@N00,202,4,1198114003,1198114287,2,5,284
12284993@N00,202,50,1198126567,1198126567,1,5,0
12284993@N00,202,71,1198136799,1198138430,3,5,1631
12284993@N00,202,82,1198131544,1198137392,2,5,5848
12284993@N00,203,9,1198225456,1198228415,8,2,2959
12284993@N00,203,50,1198217893,1198218316,4,2,423
12296141@N06,204,31,1320975963,1320975991,3,1,28
12413207@N03,205,68,1231971164,1231971302,2,1,138
12505664@N00,206,0,1351305650,1351305650,1,3,0
12505664@N00,206,71,1351288883,1351289197,2,3,314
12505664@N00,206,81,1351292564,1351312819,3,3,20255
12505664@N00,207,23,1351352074,1351352346,2,2,272
12505664@N00,207,32,1351351191,1351351191,1,2,0
12585995@N00,208,63,1382057850,1382057850,1,1,0
12644939@N02,209,45,1341148920,1341150023,2,2,1103
12644939@N02,209,84,1341159244,1341159244,1,2,0
12644939@N02,210,18,1341248419,1341248419,1,2,0
12644939@N02,210,44,1341256228,1341256228,1,2,0
12644939@N02,211,11,1341508148,1341508148,1,1,0
12900555@N02,212,19,1320533839,1320538753,3,3,4914
12900555@N02,212,21,1320526704,1320527357,3,3,653
12900555@N02,212,44,1320544959,1320544959,1,3,0
12938647@N00,213,84,1354093659,1354093659,1,1,0
12938647@N00,214,41,1357265188,1357265188,1,1,0
12938647@N00,215,40,1358374675,1358374675,1,1,0
12938647@N00,216,35,1360323045,1360323045,1,1,0
12938647@N00,217,23,1360707908,1360707908,1,1,0
12938647@N00,218,19,1365115055,1365115055,1,1,0
12999654@N08,219,71,1331176273,1331176273,1,1,0
12999654@N08,220,18,1331351966,1331351966,1,1,0
12999654@N08,221,19,1346982701,1346987098,4,2,4397
12999654@N08,221,24,1346996196,1346996196,1,2,0
12999654@N08,222,69,1347059282,1347059282,1,1,0
13078717@N07,223,31,1241136337,1241147744,6,1,11407
13233236@N04,224,13,1235627636,1235627636,1,3,0
13233236@N04,224,15,1235627632,1235627632,1,3,0
13233236@N04,224,40,1235627655,1235627655,1,3,0
13233236@N04,225,9,1235784818,1235784938,3,5,120
13233236@N04,225,13,1235784216,1235784305,4,5,89
13233236@N04,225,17,1235784175,1235784175,1,5,0
13233236@N04,225,18,1235784513,1235784660,3,5,147
13233236@N04,225,23,1235784730,1235784793,5,5,63
13233236@N04,226,35,1237724205,1237734777,3,2,10572
13233236@N04,226,39,1237721859,1237722302,3,2,443
13233236@N04,227,9,1249531447,1249531468,2,1,21
13233236@N04,228,25,1250408434,1250408434,1,3,0
13233236@N04,228,32,1250410174,1250410174,1,3,0
13233236@N04,228,71,1250406415,1250411536,2,3,5121
13233236@N04,229,35,1269164111,1269164111,1,1,0
13233236@N04,230,19,1274190758,1274190758,1,1,0
13233236@N04,231,19,1275035862,1275035862,1,1,0
13233236@N04,232,71,1277517096,1277517884,10,3,788
13233236@N04,232,82,1277517996,1277517996,1,3,0
13233236@N04,232,85,1277518442,1277518442,1,3,0
13233236@N04,233,22,1284360558,1284360558,1,1,0
13233236@N04,234,22,1287459082,1287459082,1,1,0
13233236@N04,235,35,1294721938,1294721938,1,1,0
13233236@N04,236,38,1295774930,1295775058,5,1,128
13233236@N04,237,38,1295844147,1295844366,7,1,219
13233236@N04,238,22,1297010494,1297010494,1,1,0
13233236@N04,239,55,1340799349,1340799349,1,1,0
13233236@N04,240,14,1371615785,1371615867,2,1,82
13237839@N00,241,34,1167350687,1167350940,2,3,253
13237839@N00,241,74,1167350407,1167350407,1,3,0
13237839@N00,241,76,1167352451,1167352451,1,3,0
13237839@N00,242,57,1167449867,1167449867,1,1,0
13237839@N00,243,57,1167896620,1167910473,2,1,13853
13237839@N00,244,49,1168086388,1168086388,1,1,0
13237839@N00,245,8,1178437543,1178437543,1,7,0
13237839@N00,245,23,1178436060,1178436178,2,7,118
13237839@N00,245,25,1178430962,1178430962,1,7,0
13237839@N00,245,32,1178435781,1178435781,1,7,0
13237839@N00,245,45,1178430996,1178430996,1,7,0
13237839@N00,245,46,1178429884,1178430096,2,7,212
13237839@N00,245,71,1178432165,1178432165,1,7,0
13237839@N00,246,57,1388198651,1388198651,1,1,0
13288195@N05,247,30,1253673454,1253673486,2,1,32
13288195@N05,248,71,1254371784,1254372515,3,1,731
13288195@N05,249,7,1255660323,1255660323,1,1,0
13288195@N05,250,30,1276831073,1276831073,1,1,0
13288195@N05,251,48,1281247634,1281247634,1,1,0
13288195@N05,252,41,1319850233,1319851266,2,1,1033
13288195@N05,253,29,1344855935,1344855935,2,1,0
13288195@N05,254,7,1346815588,1346815588,1,2,0
13288195@N05,254,30,1346815601,1346815601,1,2,0
13288195@N05,255,35,1361254633,1361254633,1,2,0
13288195@N05,255,70,1361254505,1361254528,2,2,23
13288195@N05,256,29,1377592639,1377592639,1,1,0
13502017@N05,257,71,1313117675,1313117675,1,1,0
13502017@N05,258,31,1313942182,1313942182,1,1,0
13502017@N05,259,2,1321454189,1321454189,1,1,0
13502017@N05,260,2,1321530855,1321530855,1,1,0
13502017@N05,261,26,1328940912,1328940912,1,1,0
13502017@N05,262,12,1332661780,1332661780,1,1,0
13502017@N05,263,22,1334762331,1334762723,2,1,392
13502017@N05,264,22,1335973298,1335973298,1,1,0
13502017@N05,265,26,1336191588,1336191588,1,1,0
13502017@N05,266,0,1345783895,1345783895,1,1,0
13502017@N05,267,46,1348274862,1348289665,4,1,14803
13502017@N05,268,46,1356781275,1356781275,1,1,0
13502017@N05,269,49,1358214399,1358214399,1,1,0
13502017@N05,270,49,1369583696,1369583910,2,1,214
13502017@N05,271,49,1370569671,1370569671,1,1,0
13502017@N05,272,49,1372479242,1372479242,1,1,0
13502017@N05,273,49,1377656536,1377656536,1,1,0
13502017@N05,274,49,1381413517,1381413517,1,1,0
13502017@N05,275,35,1386745074,1386745074,1,1,0
13639096@N06,276,46,1334301944,1334301944,1,1,0
13639096@N06,277,46,1334379953,1334379953,1,1,0
13639096@N06,278,4,1379403225,1379403225,1,1,0
13658024@N00,279,46,1353380435,1353389062,3,1,8627
13742576@N02,280,31,1178425876,1178425876,1,1,0
13742576@N02,281,32,1195370484,1195370484,1,1,0
13834571@N06,282,1,1075554000,1075554000,1,2,0
13834571@N06,282,82,1075554000,1075554000,1,2,0
13871787@N00,283,37,1341803952,1341804611,20,1,659
13871787@N00,284,37,1342414030,1342414055,2,1,25
13871787@N00,285,4,1342493953,1342509529,52,1,15576
13890195@N05,286,84,1368515716,1368515716,1,1,0
13898538@N05,287,41,1295296121,1295296144,2,1,23
13898538@N05,288,38,1325654707,1325654707,1,1,0
13898538@N05,289,38,1330495546,1330495546,1,1,0
13956722@N06,290,2,1361397205,1361397205,1,3,0
13956722@N06,290,75,1361419359,1361419359,1,3,0
13956722@N06,290,82,1361412345,1361412345,1,3,0
14021337@N00,291,9,1294042022,1294042296,3,7,274
14021337@N00,291,22,1294041988,1294042005,2,7,17
14021337@N00,291,41,1294041789,1294041789,1,7,0
14021337@N00,291,50,1294028865,1294028865,1,7,0
14021337@N00,291,71,1294032331,1294032331,1,7,0
14021337@N00,291,75,1294036096,1294036096,1,7,0
14021337@N00,291,84,1294041699,1294041868,3,7,169
14021337@N00,292,11,1294133239,1294133239,1,1,0
14021337@N00,293,11,1294212186,1294212186,1,1,0
14021742@N00,294,25,1337851206,1337851206,1,1,0
14021742@N00,295,78,1340092795,1340092795,1,1,0
14021742@N00,296,81,1345208473,1345208473,1,1,0
14021742@N00,297,70,1346504398,1346504398,1,1,0
14021742@N00,298,40,1349227924,1349227924,1,1,0
14021742@N00,299,32,1353212291,1353212291,1,1,0
14021742@N00,300,26,1361006827,1361006827,1,1,0
14021742@N00,301,84,1363313726,1363313726,1,1,0
14021742@N00,302,16,1367815619,1367815619,1,1,0
14021742@N00,303,11,1383520995,1383520995,1,1,0
14052501@N00,304,9,1233300950,1233300950,1,2,0
14052501@N00,304,50,1233307553,1233314533,3,2,6980
14052501@N00,305,71,1233396646,1233396909,3,1,263
14052501@N00,306,41,1238222259,1238222259,1,2,0
14052501@N00,306,84,1238222188,1238222188,1,2,0
14052501@N00,307,38,1287708203,1287708287,2,1,84
14052501@N00,308,57,1293454566,1293454566,1,1,0
14052501@N00,309,85,1299664981,1299664981,1,1,0
14083210@N00,310,38,1192017662,1192017662,1,1,0
14136614@N03,311,9,1385626703,1385626888,3,4,185
14136614@N03,311,15,1385624527,1385624527,1,4,0
14136614@N03,311,32,1385632455,1385638614,8,4,6159
14136614@N03,311,50,1385625092,1385626064,20,4,972
14136614@N03,312,19,1385890832,1385891387,12,2,555
14136614@N03,312,50,1385880886,1385882747,24,2,1861
14136614@N03,313,9,1386056206,1386056206,1,3,0
14136614@N03,313,19,1386083308,1386083321,2,3,13
14136614@N03,313,22,1386058327,1386058827,13,3,500
14136614@N03,314,85,1386139086,1386139086,1,1,0
14136614@N03,315,11,1386490970,1386500501,16,1,9531
14197203@N05,316,22,1326612023,1326612102,2,2,79
14197203@N05,316,81,1326611081,1326611081,1,2,0
14197203@N05,317,35,1341364475,1341364475,1,1,0
14197203@N05,318,35,1341975465,1341975465,1,1,0
14197203@N05,319,31,1343447142,1343450087,17,1,2945
14197203@N05,320,81,1343523214,1343527538,7,1,4324
14197203@N05,321,35,1343788079,1343788195,2,2,116
14197203@N05,321,82,1343786936,1343786936,1,2,0
14197203@N05,322,35,1346207171,1346207171,1,1,0
14197203@N05,323,11,1346989650,1346989650,1,1,0
14197203@N05,324,4,1347248293,1347248543,2,2,250
14197203@N05,324,24,1347248152,1347248152,1,2,0
14197203@N05,325,8,1349231444,1349231444,1,3,0
14197203@N05,325,18,1349231353,1349231353,1,3,0
14197203@N05,325,32,1349230416,1349230416,1,3,0
14197203@N05,326,9,1349944621,1349944621,1,1,0
14197203@N05,327,18,1350004215,1350004242,2,1,27
14197203@N05,328,31,1351133077,1351133077,1,3,0
14197203@N05,328,43,1351133632,1351133632,1,3,0
14197203@N05,328,44,1351132479,1351132580,2,3,101
14197203@N05,329,35,1353030403,1353030403,1,1,0
14197203@N05,330,31,1353307380,1353307380,1,1,0
14197203@N05,331,71,1353729045,1353729045,1,1,0
14197203@N05,332,35,1354615097,1354615097,1,1,0
14197203@N05,333,35,1355909267,1355909527,3,1,260
14197203@N05,334,31,1356656068,1356656068,1,1,0
14197203@N05,335,50,1356752667,1356752667,1,1,0
14197203@N05,336,50,1358318057,1358318057,1,1,0
14197203@N05,337,0,1358569026,1358569026,1,3,0
14197203@N05,337,2,1358552519,1358552519,1,3,0
14197203@N05,337,40,1358552658,1358553030,3,3,372
14197203@N05,338,18,1360280949,1360280949,1,1,0
14197203@N05,339,9,1360463695,1360463695,1,3,0
14197203@N05,339,70,1360462962,1360462995,3,3,33
14197203@N05,339,71,1360462081,1360462081,1,3,0
14197203@N05,340,31,1360635767,1360635767,1,1,0
14197203@N05,341,35,1361319377,1361319419,2,1,42
14197203@N05,342,9,1361612707,1361613019,4,6,312
14197203@N05,342,35,1361613481,1361613761,3,6,280
14197203@N05,342,41,1361608675,1361612430,7,6,3755
14197203@N05,342,71,1361615351,1361615467,4,6,116
14197203@N05,342,81,1361614694,1361614738,2,6,44
14197203@N05,342,82,1361614237,1361614292,3,6,55
14197203@N05,343,39,1363573061,1363573061,1,1,0
14197203@N05,344,31,1369890660,1369891354,2,1,694
14197203@N05,345,35,1370424143,1370424143,1,3,0
14197203@N05,345,50,1370423851,1370423851,1,3,0
14197203@N05,345,70,1370423921,1370423962,2,3,41
14197203@N05,346,35,1372211503,1372211503,1,1,0
14197203@N05,347,31,1372565364,1372573566,3,1,8202
14197203@N05,348,15,1374026761,1374026761,1,1,0
14197203@N05,349,71,1374136855,1374136855,1,1,0
14197203@N05,350,50,1374560782,1374560782,1,1,0
14197203@N05,351,19,1374902320,1374902584,2,1,264
14197203@N05,352,35,1374970068,1374982061,4,1,11993
14197203@N05,353,71,1379227285,1379227285,1,1,0
14197203@N05,354,35,1379473417,1379473417,1,1,0
14197203@N05,355,71,1384491365,1384491365,1,1,0
14197203@N05,356,71,1385378465,1385378465,1,1,0
14197203@N05,357,71,1390367429,1390367429,1,1,0
14197203@N05,358,35,1391842893,1391842893,1,1,0
14205692@N08,359,82,1239600363,1239600363,1,1,0
14205692@N08,360,41,1242183330,1242183330,1,1,0
14205692@N08,361,9,1242443471,1242443471,1,1,0
14205692@N08,362,15,1245040675,1245040675,1,2,0
14205692@N08,362,68,1245045277,1245045277,1,2,0
14205692@N08,363,20,1350100433,1350101407,2,1,974
14205692@N08,364,86,1367436872,1367436872,1,1,0
14318774@N00,365,45,1282527390,1282527390,1,1,0
14410773@N08,366,57,1303800197,1303800197,1,1,0
14472354@N00,367,25,1171534172,1171534172,1,1,0
14481533@N00,368,9,1159501299,1159501303,2,9,4
14481533@N00,368,15,1159501258,1159501263,2,9,5
14481533@N00,368,32,1159501266,1159501280,2,9,14
14481533@N00,368,41,1159501289,1159501294,2,9,5
14481533@N00,368,44,1159501216,1159501216,1,9,0
14481533@N00,368,50,1159501225,1159501235,2,9,10
14481533@N00,368,71,1159501239,1159501252,4,9,13
14481533@N00,368,82,1159501230,1159501230,1,9,0
14481533@N00,368,84,1159501285,1159501285,1,9,0
14481533@N00,369,9,1198472728,1198475771,5,1,3043
14596407@N06,370,45,1362213571,1362218732,2,1,5161
14596407@N06,371,14,1369487698,1369487698,1,1,0
14707846@N00,372,40,1350911630,1350911630,1,1,0
14776228@N06,373,22,1300774873,1300774873,1,1,0
14821912@N00,374,46,1134205647,1134205647,1,1,0
14821912@N00,375,9,1134380206,1134380206,1,1,0
14821912@N00,376,40,1135140436,1135140436,1,1,0
14821912@N00,377,7,1138866807,1138866807,1,2,0
14821912@N00,377,48,1138869152,1138869152,1,2,0
14821912@N00,378,17,1141539841,1141539841,1,2,0
14821912@N00,378,81,1141533161,1141533161,1,2,0
14821912@N00,379,35,1146397779,1146397779,1,2,0
14821912@N00,379,71,1146396768,1146397218,2,2,450
14821912@N00,380,68,1150041763,1150041763,1,2,0
14821912@N00,380,71,1150043433,1150043433,1,2,0
14821912@N00,381,81,1150112083,1150112083,1,1,0
14821912@N00,382,45,1150978387,1150978387,1,2,0
14821912@N00,382,82,1150977390,1150977531,2,2,141
14821912@N00,383,34,1160207263,1160207263,1,1,0
14831239@N02,384,26,1174279711,1174279711,1,1,0
15213592@N03,385,15,1349421703,1349422009,6,4,306
15213592@N03,385,27,1349420322,1349420688,7,4,366
15213592@N03,385,71,1349422336,1349422680,8,4,344
15213592@N03,385,82,1349421949,1349422234,7,4,285
15308437@N00,386,44,1337062580,1337062580,1,2,0
15308437@N00,386,76,1337072833,1337072833,1,2,0
15308437@N00,387,14,1337730456,1337730456,1,2,0
15308437@N00,387,42,1337731859,1337731859,1,2,0
15808182@N00,388,71,1377757172,1377757172,1,1,0
16076309@N00,389,45,1281940317,1281940317,1,1,0
16076309@N00,390,45,1281970698,1281970698,1,1,0
16679609@N00,391,14,1302380571,1302380571,1,1,0
16767930@N05,392,12,1214696868,1214696868,1,10,0
16767930@N05,392,20,1214698976,1214698976,1,10,0
16767930@N05,392,31,1214718874,1214718874,1,10,0
16767930@N05,392,34,1214714910,1214716373,3,10,1463
16767930@N05,392,44,1214719857,1214719857,1,10,0
16767930@N05,392,49,1214710497,1214713523,3,10,3026
16767930@N05,392,74,1214716842,1214716842,1,10,0
16767930@N05,392,75,1214708874,1214708874,1,10,0
16767930@N05,392,81,1214719562,1214719562,1,10,0
16767930@N05,392,82,1214708183,1214708183,1,10,0
16767930@N05,393,81,1215931714,1215931714,1,1,0
16867627@N06,394,2,1354059190,1354059440,5,8,250
16867627@N06,394,38,1354053137,1354053229,2,8,92
16867627@N06,394,39,1354058722,1354058785,2,8,63
16867627@N06,394,40,1354058546,1354058546,1,8,0
16867627@N06,394,48,1354054202,1354055672,13,8,1470
16867627@N06,394,51,1354058345,1354058513,3,8,168
16867627@N06,394,69,1354053986,1354054122,3,8,136
16867627@N06,394,73,1354052634,1354052634,1,8,0
16867627@N06,395,1,1354223298,1354223310,2,13,12
16867627@N06,395,3,1354234082,1354234164,3,13,82
16867627@N06,395,15,1354238705,1354238705,1,13,0
16867627@N06,395,19,1354229974,1354230254,2,13,280
16867627@N06,395,21,1354228411,1354234432,12,13,6021
16867627@N06,395,25,1354239123,1354239123,1,13,0
16867627@N06,395,31,1354231834,1354237139,2,13,5305
16867627@N06,395,34,1354237378,1354237424,2,13,46
16867627@N06,395,42,1354227069,1354227069,1,13,0
16867627@N06,395,61,1354235209,1354235548,2,13,339
16867627@N06,395,69,1354233845,1354233845,1,13,0
16867627@N06,395,71,1354231630,1354233002,5,13,1372
16867627@N06,395,85,1354222866,1354225605,4,13,2739
16921893@N00,396,84,1224888737,1224888759,2,1,22
16921893@N00,397,48,1225239318,1225243032,6,2,3714
16921893@N00,397,69,1225243599,1225243698,3,2,99
16934054@N07,398,32,1337070793,1337070793,1,1,0
16934054@N07,399,32,1337150486,1337150735,2,1,249
16934054@N07,400,26,1337410743,1337410743,1,1,0
16935369@N06,401,8,1270606161,1270606161,1,1,0
16941958@N02,402,34,1198871966,1198871966,1,2,0
16941958@N02,402,49,1198871887,1198871887,1,2,0
16941958@N02,403,45,1203253101,1203253101,1,1,0
16941958@N02,404,48,1209526598,1209526598,1,1,0
16941958@N02,405,68,1230728796,1230729767,3,1,971
16941958@N02,406,3,1334569857,1334569857,1,1,0
16941958@N02,407,7,1349075965,1349075965,1,1,0
16941958@N02,408,20,1357642252,1357642252,1,1,0
16941958@N02,409,73,1387011338,1387011338,1,1,0
16971123@N05,410,51,1204425076,1204425122,2,1,46
17017492@N00,411,20,1355037512,1355037512,1,1,0
17017492@N00,412,26,1355989118,1355989118,1,1,0
17211040@N00,413,26,1385173978,1385173978,1,3,0
17211040@N00,413,71,1385170332,1385170332,1,3,0
17211040@N00,413,82,1385169102,1385169102,1,3,0
17211040@N00,414,22,1385272740,1385274186,9,3,1446
17211040@N00,414,71,1385258449,1385275356,4,3,16907
17211040@N00,414,84,1385274492,1385274492,1,3,0
17211040@N00,415,84,1385362429,1385362429,1,1,0
17273128@N05,416,63,1327138646,1327138646,1,1,0
17348671@N00,417,9,1356691159,1356691159,1,1,0
17464786@N00,418,2,1290201487,1290201487,1,1,0
17665235@N03,419,82,1323417349,1323418561,2,1,1212
17685860@N00,420,45,1296857990,1296860114,3,2,2124
17685860@N00,420,56,1296866056,1296866541,3,2,485
17685860@N00,421,56,1297202703,1297202703,1,1,0
17754071@N00,422,63,1359292384,1359292384,1,1,0
17754071@N00,423,71,1359716191,1359716191,1,1,0
17754071@N00,424,84,1364735946,1364735946,1,1,0
17897232@N00,425,50,1301547649,1301547672,2,1,23
18271014@N00,426,67,1308669174,1308669174,1,1,0
18271014@N00,427,15,1308866720,1308866720,1,1,0
18292035@N00,428,47,1389122986,1389122986,1,1,0
18362614@N00,429,39,1360648496,1360648496,1,1,0
18426552@N00,430,48,1218194673,1218194673,1,1,0
18426552@N00,431,86,1231666906,1231666906,1,1,0
18426552@N00,432,86,1232270012,1232270012,1,1,0
18426552@N00,433,32,1246771714,1246771714,1,2,0
18426552@N00,433,48,1246774440,1246774440,1,2,0
18426552@N00,434,82,1313566695,1313566695,1,1,0
18627431@N08,435,41,1394929172,1394935363,13,1,6191
18892175@N02,436,48,1311998586,1311998586,1,1,0
18935424@N00,437,52,1337706807,1337706807,1,1,0
18935424@N00,438,0,1338177453,1338177453,1,7,0
18935424@N00,438,13,1338181722,1338181851,2,7,129
18935424@N00,438,15,1338176583,1338176583,1,7,0
18935424@N00,438,31,1338179935,1338179935,1,7,0
18935424@N00,438,44,1338180497,1338180497,1,7,0
18935424@N00,438,81,1338180443,1338180443,1,7,0
18935424@N00,438,82,1338176890,1338176890,1,7,0
19117007@N05,439,35,1354532233,1354532233,1,1,0
19289077@N00,440,4,1392962302,1392972051,2,9,9749
19289077@N00,440,15,1392968430,1392968430,1,9,0
19289077@N00,440,17,1392968105,1392968105,1,9,0
19289077@N00,440,36,1392962806,1392963850,5,9,1044
19289077@N00,440,41,1392964271,1392964271,1,9,0
19289077@N00,440,70,1392968020,1392968020,1,9,0
19289077@N00,440,81,1392969130,1392969288,2,9,158
19289077@N00,440,82,1392968578,1392968578,1,9,0
19289077@N00,440,84,1392965060,1392965744,4,9,684
19368730@N03,441,29,1325058264,1325058264,1,1,0
19368730@N03,442,50,1361615311,1361615311,1,2,0
19368730@N03,442,82,1361616053,1361616053,1,2,0
19447876@N00,443,15,1345243074,1345243074,1,3,0
19447876@N00,443,50,1345243421,1345243421,1,3,0
19447876@N00,443,71,1345243756,1345243756,1,3,0
19447876@N00,444,26,1345318809,1345319056,2,1,247
19447876@N00,445,45,1345416981,1345418076,2,4,1095
19447876@N00,445,74,1345404903,1345411046,3,4,6143
19447876@N00,445,76,1345410453,1345410453,1,4,0
19447876@N00,445,81,1345402740,1345402740,1,4,0
19451080@N00,446,71,1328183403,1328183403,1,1,0
19516393@N00,447,31,1144798277,1144798277,1,1,0
19604783@N00,448,63,1390409362,1390409362,1,1,0
19761391@N06,449,48,1357179088,1357179304,2,1,216
19844957@N00,450,17,1079009640,1079010357,14,1,717
19844957@N00,451,2,1160994152,1160997236,8,1,3084
19844957@N00,452,2,1161040912,1161040912,1,1,0
19894496@N00,453,71,1259377655,1259377655,1,1,0
19894496@N00,454,82,1266114779,1266114779,1,1,0
19894496@N00,455,70,1276250506,1276250506,1,1,0
19894496@N00,456,32,1320988503,1320988503,1,1,0
19933120@N00,457,45,1088297972,1088297972,1,1,0
19933120@N00,458,45,1151139242,1151139242,1,1,0
19933120@N00,459,14,1157615990,1157615990,1,2,0
19933120@N00,459,81,1157619022,1157619022,1,2,0
19933120@N00,460,2,1162031069,1162031069,1,1,0
20006561@N00,461,81,1392452522,1392452522,1,1,0
20055849@N00,462,71,1333771799,1333771826,2,1,27
20055849@N00,463,56,1333802451,1333802451,1,1,0
20055849@N00,464,57,1333953407,1333953407,1,1,0
20266194@N00,465,27,1332219925,1332219925,1,2,0
20266194@N00,465,45,1332206443,1332206443,1,2,0
20473443@N07,466,25,1330566116,1330566116,1,1,0
20473443@N07,467,38,1335568162,1335568162,1,1,0
20483509@N00,468,26,1239412100,1239412100,1,1,0
20599123@N00,469,9,1155773556,1155786395,34,1,12839
20599123@N00,470,9,1156149362,1156149883,5,1,521
20599123@N00,471,9,1156282152,1156296141,4,1,13989
20599123@N00,472,9,1156403228,1156403228,1,1,0
20599123@N00,473,9,1157499422,1157499422,1,1,0
20599123@N00,474,9,1157630999,1157631028,3,1,29
20599123@N00,475,9,1158268289,1158268342,4,1,53
20599123@N00,476,9,1158567150,1158567150,1,1,0
20599123@N00,477,9,1158665603,1158665619,3,1,16
20599123@N00,478,9,1158997675,1158997675,1,1,0
20599123@N00,479,9,1159320975,1159327696,95,1,6721
20599123@N00,480,9,1162932405,1162932405,1,1,0
20599123@N00,481,9,1163289370,1163295382,9,1,6012
20599123@N00,482,9,1163889167,1163897749,60,1,8582
20599123@N00,483,9,1165048011,1165069690,25,1,21679
20599123@N00,484,9,1165384231,1165384231,1,1,0
20599123@N00,485,9,1166167874,1166172835,5,1,4961
20599123@N00,486,9,1166254446,1166254446,1,1,0
20599123@N00,487,9,1170840664,1170840664,1,1,0
20599123@N00,488,9,1172017135,1172017135,1,1,0
20599123@N00,489,9,1172210370,1172224235,25,1,13865
20599123@N00,490,9,1174264167,1174264167,1,1,0
20599123@N00,491,9,1177209648,1177231162,2,1,21514
20599123@N00,492,9,1178431560,1178435429,7,1,3869
20599123@N00,493,9,1180189994,1180189994,1,1,0
20599123@N00,494,9,1180219209,1180219209,1,1,0
20599123@N00,495,9,1185595653,1185597151,2,1,1498
20599123@N00,496,9,1186900816,1186900880,3,1,64
20599123@N00,497,9,1197100344,1197129565,32,1,29221
20599123@N00,498,9,1198193745,1198196189,4,1,2444
20599123@N00,499,9,1198311384,1198311384,1,1,0
20599123@N00,500,9,1198386664,1198387793,4,1,1129
20599123@N00,501,9,1198475613,1198475613,1,1,0
20599123@N00,502,9,1198531610,1198540624,3,1,9014
20599123@N00,503,9,1199095738,1199095738,1,1,0
20599123@N00,504,9,1199233131,1199239233,3,1,6102
20599123@N00,505,9,1200298314,1200298381,3,1,67
20599123@N00,506,9,1202458384,1202458384,1,1,0
20599123@N00,507,9,1202601149,1202603837,4,1,2688
20599123@N00,508,9,1202719308,1202719308,1,1,0
20599123@N00,509,9,1203289325,1203293677,7,1,4352
20599123@N00,510,9,1204518714,1204522809,24,1,4095
20599123@N00,511,9,1205107564,1205113141,14,1,5577
20599123@N00,512,9,1205155112,1205155112,1,1,0
20599123@N00,513,9,1205755119,1205755119,1,1,0
20599123@N00,514,9,1206323631,1206330017,11,1,6386
20599123@N00,515,9,1206393879,1206393879,1,1,0
20599123@N00,516,9,1206835046,1206835124,2,1,78
20599123@N00,517,9,1209870353,1209876940,30,1,6587
20599123@N00,518,9,1211699972,1211703144,10,1,3172
20599123@N00,519,9,1211773678,1211781731,10,1,8053
20599123@N00,520,9,1212910117,1212912740,2,1,2623
20599123@N00,521,9,1214197741,1214199772,13,1,2031
20599123@N00,522,9,1214308299,1214308299,1,1,0
20599123@N00,523,9,1215320674,1215320881,3,1,207
20599123@N00,524,9,1217735271,1217735701,5,1,430
20599123@N00,525,9,1218340451,1218340462,2,1,11
20599123@N00,526,9,1218964974,1218964974,1,1,0
20599123@N00,527,9,1219552324,1219552934,3,1,610
20599123@N00,528,9,1219640695,1219647566,2,1,6871
20599123@N00,529,9,1222581103,1222584650,16,1,3547
20599123@N00,530,9,1227864671,1227864671,1,1,0
20599123@N00,531,9,1229597166,1229597232,2,1,66
20599123@N00,532,9,1230066972,1230070127,7,1,3155
20599123@N00,533,9,1230510471,1230537903,7,1,27432
20599123@N00,534,9,1230620769,1230621058,2,1,289
20599123@N00,535,9,1231628577,1231628577,1,1,0
20599123@N00,536,9,1231658722,1231664637,2,1,5915
20599123@N00,537,9,1232323494,1232334864,6,1,11370
20599123@N00,538,9,1232878964,1232879515,2,1,551
20681884@N00,539,48,1109468240,1109468240,1,1,0
20681884@N00,540,44,1109810533,1109810743,2,1,210
20681884@N00,541,44,1110409928,1110411386,4,1,1458
20942555@N07,542,57,1341841012,1341841012,1,1,0
20942555@N07,543,84,1342108704,1342108780,2,1,76
20984626@N00,544,31,1140694653,1140694653,1,1,0
21008552@N06,545,72,1327720589,1327723829,2,1,3240
21008552@N06,546,4,1330048217,1330048217,1,1,0
21008552@N06,547,48,1349214987,1349214987,1,1,0
21008552@N06,548,84,1353233871,1353233871,1,1,0
21008552@N06,549,71,1357375971,1357375971,1,1,0
21042665@N08,550,1,1199059336,1199059731,14,1,395
21042665@N08,551,71,1293769615,1293772464,5,1,2849
21042665@N08,552,5,1310110241,1310115882,32,1,5641
21050486@N08,553,85,1381641077,1381641077,1,1,0
21050486@N08,554,51,1381716059,1381716059,1,1,0
21079635@N00,555,14,1230515634,1230515634,1,1,0
21079635@N00,556,14,1233886651,1233886651,1,1,0
21079635@N00,557,14,1234313294,1234313294,1,1,0
21079635@N00,558,50,1239102973,1239102973,1,1,0
21079635@N00,559,71,1252495446,1252495446,1,1,0
21160385@N02,560,25,1293841754,1293841941,3,3,187
21160385@N02,560,45,1293836674,1293836674,1,3,0
21160385@N02,560,85,1293843828,1293843828,1,3,0
21182717@N04,561,25,1314951826,1314975433,5,1,23607
21225669@N00,562,32,1210866248,1210866248,1,3,0
21225669@N00,562,35,1210865792,1210865792,1,3,0
21225669@N00,562,78,1210871290,1210871290,1,3,0
21397012@N00,563,39,1340415226,1340417884,27,1,2658
21404803@N00,564,15,1388499283,1388499283,1,2,0
21404803@N00,564,81,1388494819,1388495796,5,2,977
21404803@N00,565,27,1389080112,1389080112,1,1,0
21442750@N07,566,50,1044018000,1044018000,1,1,0
21475518@N00,567,2,1299044768,1299044768,1,1,0
21475518@N00,568,14,1306036686,1306036725,2,1,39
21475518@N00,569,26,1359761475,1359761475,1,1,0
21489607@N03,570,59,1196668800,1196668856,51,1,56
21489607@N03,571,59,1197801998,1197806396,24,1,4398
21489607@N03,572,59,1197882210,1197884288,7,1,2078
21489607@N03,573,32,1199875859,1199876650,8,1,791
21489607@N03,574,32,1200472233,1200472233,1,1,0
21489607@N03,575,9,1200559626,1200559847,3,2,221
21489607@N03,575,32,1200558652,1200558792,4,2,140
21489607@N03,576,32,1200645149,1200645149,1,1,0
21550108@N02,577,32,1269656654,1269656654,1,1,0
21769199@N00,578,19,1329510435,1329510435,1,1,0
21769199@N00,579,32,1329909951,1329909951,1,1,0
21818828@N00,580,11,1290837830,1290837830,1,1,0
21929094@N02,581,45,1203556092,1203557333,6,2,1241
21929094@N02,581,71,1203555036,1203555036,1,2,0
21929094@N02,582,41,1203653454,1203653454,1,3,0
21929094@N02,582,48,1203644457,1203648554,7,3,4097
21929094@N02,582,71,1203635147,1203635147,1,3,0
22056394@N00,583,42,1168480226,1168480226,1,1,0
22056394@N00,584,24,1269237349,1269237349,1,1,0
22056394@N00,585,82,1371768555,1371768555,1,1,0
22092918@N00,586,21,1397690508,1397690508,1,1,0
22131083@N08,587,6,1313825928,1313825928,1,3,0
22131083@N08,587,57,1313831077,1313831077,1,3,0
22131083@N08,587,72,1313813371,1313813371,1,3,0
22148797@N00,588,24,1212481809,1212481919,2,1,110
22148797@N00,589,24,1212628006,1212655529,6,1,27523
22148797@N00,590,24,1213149855,1213149896,2,1,41
22148797@N00,591,19,1213184664,1213184664,1,1,0
22148797@N00,592,24,1213233379,1213233430,3,1,51
22148797@N00,593,19,1216645818,1216645818,1,1,0
22148797@N00,594,51,1289764026,1289764026,1,1,0
22363956@N02,595,71,1294997336,1294997570,2,1,234
22363956@N02,596,71,1295301652,1295301652,1,1,0
22363956@N02,597,44,1310558224,1310558437,3,1,213
22363956@N02,598,40,1353133025,1353133025,1,1,0
22446527@N05,599,24,1328378418,1328379623,3,1,1205
22446527@N05,600,24,1341871647,1341871647,1,1,0
22480788@N08,601,71,1202960172,1202960172,1,1,0
22480788@N08,602,15,1206011105,1206011105,1,1,0
22480788@N08,603,7,1209288084,1209288084,1,1,0
22480788@N08,604,7,1209639354,1209639480,4,1,126
22480788@N08,605,48,1214462517,1214462517,1,1,0
22670857@N03,606,35,1362595580,1362595580,1,1,0
22670857@N03,607,4,1364390331,1364390331,1,3,0
22670857@N03,607,32,1364404800,1364404800,1,3,0
22670857@N03,607,41,1364395437,1364395437,1,3,0
22670857@N03,608,80,1364984283,1364984283,1,1,0
22670857@N03,609,31,1370378173,1370378463,3,2,290
22670857@N03,609,81,1370376757,1370376757,1,2,0
22670857@N03,610,32,1370461293,1370461293,1,1,0
22670857@N03,611,50,1370798228,1370798228,1,3,0
22670857@N03,611,71,1370800565,1370800629,2,3,64
22670857@N03,611,82,1370794113,1370794113,1,3,0
22670857@N03,612,49,1370906960,1370906960,1,2,0
22670857@N03,612,71,1370907125,1370908649,2,2,1524
22670857@N03,613,32,1370985833,1370985833,1,1,0
22670857@N03,614,31,1371593086,1371593086,1,3,0
22670857@N03,614,67,1371593042,1371593042,1,3,0
22670857@N03,614,71,1371591889,1371591889,1,3,0
22670857@N03,615,81,1371644301,1371644346,2,1,45
22670857@N03,616,81,1371781748,1371781748,1,1,0
22670857@N03,617,9,1372112175,1372112175,1,2,0
22670857@N03,617,17,1372090550,1372090550,1,2,0
22670857@N03,618,0,1372396742,1372396742,1,1,0
22670857@N03,619,41,1373487037,1373487037,1,2,0
22670857@N03,619,82,1373512962,1373512962,1,2,0
22670857@N03,620,32,1373581615,1373581615,1,1,0
22670857@N03,621,70,1373991055,1373991055,1,1,0
22670857@N03,622,9,1374958215,1374961395,2,2,3180
22670857@N03,622,44,1374961454,1374961454,1,2,0
22670857@N03,623,66,1375055046,1375055046,1,2,0
22670857@N03,623,81,1375047040,1375047040,1,2,0
22670857@N03,624,20,1375123688,1375123688,1,1,0
22670857@N03,625,15,1375298623,1375298623,1,1,0
22670857@N03,626,70,1375655782,1375655782,1,1,0
22670857@N03,627,26,1376181300,1376181300,1,1,0
22670857@N03,628,68,1376258591,1376258591,1,1,0
22670857@N03,629,9,1376516733,1376516733,1,1,0
22670857@N03,630,31,1376849103,1376851244,2,1,2141
22670857@N03,631,66,1378085179,1378085179,1,1,0
22670857@N03,632,20,1378416880,1378416880,1,1,0
22670857@N03,633,8,1379620280,1379620280,1,1,0
22670857@N03,634,81,1380676915,1380676915,1,1,0
22670857@N03,635,75,1380743235,1380743235,1,1,0
22670857@N03,636,81,1381710987,1381710987,1,1,0
22670857@N03,637,44,1382483593,1382483593,1,1,0
22670857@N03,638,57,1382563994,1382563994,1,1,0
22670857@N03,639,32,1383346696,1383346696,1,1,0
22670857@N03,640,84,1383475223,1383475223,1,1,0
22670857@N03,641,9,1383860492,1383860492,1,2,0
22670857@N03,641,14,1383838384,1383838384,1,2,0
22670857@N03,642,21,1384185277,1384185277,1,1,0
22670857@N03,643,32,1384471002,1384471002,1,1,0
22670857@N03,644,9,1384894173,1384894173,1,2,0
22670857@N03,644,32,1384876700,1384876700,1,2,0
22670857@N03,645,42,1384952875,1384952875,1,1,0
22670857@N03,646,67,1385077307,1385077363,2,1,56
22670857@N03,647,9,1385231781,1385231781,1,1,0
22670857@N03,648,71,1385378791,1385378791,1,1,0
22670857@N03,649,14,1385573032,1385573032,1,1,0
22670857@N03,650,0,1385602141,1385602141,1,1,0
22670857@N03,651,14,1385669814,1385669814,1,1,0
22670857@N03,652,19,1385910903,1385910903,1,1,0
22670857@N03,653,14,1386264490,1386264490,1,1,0
22670857@N03,654,82,1386534106,1386534106,1,1,0
22670857@N03,655,1,1386801789,1386801789,1,2,0
22670857@N03,655,18,1386777864,1386777864,1,2,0
22670857@N03,656,19,1386858951,1386858951,1,1,0
22670857@N03,657,27,1387487700,1387488255,2,1,555
22670857@N03,658,32,1389713356,1389713356,1,1,0
22670857@N03,659,9,1389832932,1389832932,1,1,0
22670857@N03,660,17,1390146682,1390146682,1,1,0
22670857@N03,661,18,1390493599,1390493599,1,1,0
22670857@N03,662,14,1391350585,1391350585,1,1,0
22670857@N03,663,81,1391469648,1391469648,1,1,0
22670857@N03,664,46,1391730650,1391730650,1,1,0
22670857@N03,665,35,1392065262,1392065262,1,3,0
22670857@N03,665,63,1392068440,1392068440,1,3,0
22670857@N03,665,68,1392065371,1392065371,1,3,0
22670857@N03,666,70,1392133847,1392133847,1,1,0
22670857@N03,667,32,1393445408,1393445408,1,1,0
22670857@N03,668,31,1393618291,1393618291,1,1,0
22670857@N03,669,35,1393892374,1393892374,1,1,0
22670857@N03,670,9,1396478749,1396478749,1,1,0
22670857@N03,671,68,1396791876,1396791876,1,1,0
22670857@N03,672,11,1396822297,1396822297,1,1,0
22718392@N07,673,81,1252044975,1252044975,1,1,0
22718392@N07,674,82,1266570812,1266570812,1,1,0
22766548@N00,675,35,1377406125,1377406125,1,1,0
22852813@N04,676,25,1270357153,1270360987,55,5,3834
22852813@N04,676,27,1270357773,1270360178,20,5,2405
22852813@N04,676,42,1270357499,1270357756,4,5,257
22852813@N04,676,48,1270346538,1270350581,100,5,4043
22852813@N04,676,69,1270346310,1270346533,25,5,223
22852813@N04,677,32,1355707084,1355707084,1,1,0
22852813@N04,678,18,1356312745,1356312745,1,2,0
22852813@N04,678,23,1356312836,1356312836,1,2,0
22852813@N04,679,2,1360192223,1360192223,1,1,0
22853276@N05,680,68,1206623650,1206623650,1,4,0
22853276@N05,680,71,1206623188,1206623188,1,4,0
22853276@N05,680,76,1206600989,1206600989,1,4,0
22853276@N05,680,81,1206623142,1206623792,2,4,650
22853276@N05,681,35,1209129786,1209129786,1,3,0
22853276@N05,681,39,1209127714,1209127714,1,3,0
22853276@N05,681,78,1209131023,1209131059,2,3,36
22853276@N05,682,49,1252110664,1252110800,2,2,136
22853276@N05,682,76,1252101844,1252103211,11,2,1367
22853276@N05,683,85,1332632170,1332632170,1,1,0
22853276@N05,684,85,1337419118,1337419613,3,1,495
22853276@N05,685,14,1359367356,1359367356,1,8,0
22853276@N05,685,25,1359367886,1359367886,1,8,0
22853276@N05,685,27,1359368270,1359368270,1,8,0
22853276@N05,685,45,1359366495,1359366594,2,8,99
22853276@N05,685,68,1359364632,1359364632,1,8,0
22853276@N05,685,71,1359365273,1359365273,1,8,0
22853276@N05,685,82,1359365669,1359366316,3,8,647
22853276@N05,685,85,1359368812,1359368812,1,8,0
22853276@N05,686,67,1385709960,1385715416,10,3,5456
22853276@N05,686,71,1385708075,1385708452,2,3,377
22853276@N05,686,81,1385716438,1385716438,1,3,0
22887802@N07,687,8,1203216694,1203216893,2,2,199
22887802@N07,687,9,1203211618,1203211618,1,2,0
22887802@N07,688,44,1213414644,1213414644,1,2,0
22887802@N07,688,81,1213414574,1213414574,1,2,0
23033288@N05,689,71,1343526735,1343526735,1,1,0
23033288@N05,690,71,1345164293,1345164293,1,1,0
23033288@N05,691,18,1368780771,1368780771,1,1,0
23033288@N05,692,71,1369801858,1369822430,2,1,20572
23033288@N05,693,71,1377995455,1377995455,1,1,0
23033288@N05,694,45,1378278985,1378278985,1,2,0
23033288@N05,694,71,1378268527,1378268527,1,2,0
23033288@N05,695,9,1387426698,1387426698,1,2,0
23033288@N05,695,51,1387405911,1387405911,1,2,0
23033288@N05,696,63,1389602573,1389602573,1,1,0
23033288@N05,697,25,1389820320,1389820320,1,1,0
23033288@N05,698,41,1393628889,1393628889,1,1,0
23033288@N05,699,67,1394353899,1394354933,5,1,1034
23033288@N05,700,84,1395991507,1395991507,1,1,0
23059063@N00,701,70,1223790788,1223790788,1,1,0
23073717@N07,702,85,1341758683,1341758683,1,1,0
23073717@N07,703,46,1341846141,1341846141,1,1,0
23073717@N07,704,46,1341901289,1341901289,1,1,0
23073717@N07,705,46,1342100384,1342100384,1,1,0
23073717@N07,706,49,1342358458,1342362832,2,1,4374
23073717@N07,707,31,1342602338,1342602338,1,2,0
23073717@N07,707,71,1342613926,1342613926,1,2,0
23245161@N00,708,63,1106412423,1106412423,1,1,0
23245161@N00,709,57,1198627809,1198645875,6,1,18066
23245161@N00,710,71,1198674936,1198674936,1,1,0
23245161@N00,711,57,1199866455,1199866455,1,1,0
23245161@N00,712,55,1200623310,1200624111,2,2,801
23245161@N00,712,63,1200618820,1200631799,3,2,12979
23245161@N00,713,63,1200710447,1200763832,8,1,53385
23245161@N00,714,84,1200799061,1200799061,1,1,0
23245161@N00,715,63,1201850044,1201850044,1,1,0
23245161@N00,716,57,1221820461,1221822500,2,1,2039
23245161@N00,717,53,1250843261,1250846922,2,1,3661
23594111@N02,718,71,1281148392,1281148392,1,1,0
23727693@N05,719,70,1207400479,1207400479,1,1,0
23806189@N00,720,4,1328070791,1328070791,1,4,0
23806189@N00,720,50,1328074045,1328074168,2,4,123
23806189@N00,720,70,1328073853,1328073853,1,4,0
23806189@N00,720,84,1328070232,1328070289,2,4,57
23806189@N00,721,8,1328170506,1328170506,1,6,0
23806189@N00,721,15,1328170951,1328170951,1,6,0
23806189@N00,721,23,1328170129,1328170129,1,6,0
23806189@N00,721,45,1328159818,1328164552,6,6,4734
23806189@N00,721,56,1328162036,1328162036,1,6,0
23806189@N00,721,70,1328170390,1328170390,1,6,0
23806189@N00,722,45,1328683084,1328683084,1,1,0
23809369@N08,723,13,1356392963,1356393003,2,8,40
23809369@N08,723,15,1356392189,1356392364,2,8,175
23809369@N08,723,17,1356392848,1356392877,2,8,29
23809369@N08,723,31,1356405364,1356405364,1,8,0
23809369@N08,723,35,1356393944,1356435435,7,8,41491
23809369@N08,723,50,1356390203,1356426739,5,8,36536
23809369@N08,723,71,1356388862,1356389997,8,8,1135
23809369@N08,723,81,1356429324,1356429324,1,8,0
23809369@N08,724,2,1356585789,1356585789,1,6,0
23809369@N08,724,21,1356569735,1356569735,1,6,0
23809369@N08,724,32,1356569650,1356569650,1,6,0
23809369@N08,724,40,1356585254,1356585568,3,6,314
23809369@N08,724,48,1356580013,1356581323,4,6,1310
23809369@N08,724,51,1356586796,1356587908,5,6,1112
23809369@N08,725,17,1356662553,1356662553,1,4,0
23809369@N08,725,18,1356663034,1356663034,1,4,0
23809369@N08,725,23,1356663796,1356663796,1,4,0
23809369@N08,725,49,1356651844,1356653111,5,4,1267
23875378@N06,726,25,1293322640,1293322640,1,2,0
23875378@N06,726,31,1293324403,1293324403,1,2,0
23875378@N06,727,0,1293391350,1293391350,1,5,0
23875378@N06,727,44,1293380340,1293380340,1,5,0
23875378@N06,727,45,1293382884,1293383586,2,5,702
23875378@N06,727,71,1293382937,1293382937,1,5,0
23875378@N06,727,82,1293385816,1293385816,1,5,0
23875378@N06,728,71,1293531794,1293531794,1,1,0
23887491@N00,729,30,1169927264,1169927264,1,1,0
23956016@N00,730,13,1170746455,1170746455,1,1,0
23956016@N00,731,36,1308372853,1308372870,2,1,17
23956016@N00,732,12,1308801489,1308801489,1,1,0
23956016@N00,733,39,1329557895,1329557895,1,1,0
23956016@N00,734,24,1335182366,1335182366,1,1,0
23956016@N00,735,24,1336796526,1336796526,1,2,0
23956016@N00,735,41,1336794661,1336794661,1,2,0
23956016@N00,736,41,1369405469,1369411245,6,2,5776
23956016@N00,736,84,1369412548,1369412548,1,2,0
23956016@N00,737,85,1387652294,1387652294,1,1,0
23956016@N00,738,70,1398467207,1398467207,1,1,0
23956016@N00,739,19,1398556404,1398556404,1,1,0
24011587@N06,740,23,1384739550,1384739550,1,1,0
24011587@N06,741,84,1384923180,1384923180,1,1,0
24011587@N06,742,32,1385099234,1385099234,1,1,0
24017046@N05,743,35,1248264564,1248264564,1,1,0
24017046@N05,744,35,1253237744,1253237744,1,1,0
24017046@N05,745,35,1254122592,1254122592,1,1,0
24017046@N05,746,35,1254795014,1254795201,2,1,187
24017046@N05,747,53,1265889374,1265889374,1,1,0
24017046@N05,748,0,1267332360,1267332360,1,1,0
24122821@N05,749,41,1319587933,1319591261,10,3,3328
24122821@N05,749,51,1319585652,1319586812,2,3,1160
24122821@N05,749,71,1319580625,1319581463,7,3,838
24130645@N06,750,11,1370356768,1370357011,2,1,243
24145635@N02,751,48,1245985715,1245986081,4,1,366
24147900@N06,752,55,1169010030,1169010030,1,2,0
24147900@N06,752,56,1169006906,1169006906,1,2,0
24147900@N06,753,63,1175227391,1175227391,1,1,0
24147900@N06,754,49,1180074189,1180074293,2,1,104
24147900@N06,755,44,1183437730,1183437730,1,1,0
24236874@N00,756,42,1079066265,1079066265,1,1,0
24236874@N00,757,57,1238064218,1238064218,1,1,0
24236874@N00,758,69,1242946074,1242946074,1,1,0
24236874@N00,759,11,1244097067,1244097067,1,1,0
24236874@N00,760,11,1259726461,1259726461,1,1,0
24236874@N00,761,22,1266901174,1266901206,2,2,32
24236874@N00,761,40,1266904350,1266904350,1,2,0
24405143@N05,762,26,1376206231,1376206231,1,1,0
24413182@N00,763,9,1268009421,1268009896,5,7,475
24413182@N00,763,25,1268003010,1268003010,1,7,0
24413182@N00,763,27,1268002548,1268002946,4,7,398
24413182@N00,763,35,1268006465,1268009176,53,7,2711
24413182@N00,763,45,1268005114,1268005114,1,7,0
24413182@N00,763,50,1268005935,1268006097,3,7,162
24413182@N00,763,81,1268005470,1268005705,5,7,235
24413182@N00,764,9,1268445745,1268447400,12,1,1655
24413182@N00,765,26,1268529278,1268529846,6,4,568
24413182@N00,765,44,1268538703,1268539052,3,4,349
24413182@N00,765,45,1268540190,1268541080,11,4,890
24413182@N00,765,81,1268537820,1268537820,1,4,0
24413182@N00,766,9,1269055659,1269055672,2,8,13
24413182@N00,766,35,1269055774,1269055910,2,8,136
24413182@N00,766,39,1269059005,1269059005,1,8,0
24413182@N00,766,50,1269057072,1269057268,3,8,196
24413182@N00,766,70,1269057047,1269057047,1,8,0
24413182@N00,766,71,1269057538,1269057648,2,8,110
24413182@N00,766,81,1269057855,1269057855,1,8,0
24413182@N00,766,82,1269058279,1269058563,2,8,284
24413182@N00,767,60,1269742602,1269757324,50,1,14722
24413182@N00,768,25,1270107866,1270109638,17,1,1772
24431382@N03,769,8,1274233492,1274233492,1,1,0
24431382@N03,770,8,1275692313,1275692313,1,1,0
24453935@N00,771,44,1332565043,1332565043,1,4,0
24453935@N00,771,71,1332549709,1332549709,1,4,0
24453935@N00,771,75,1332565263,1332565680,4,4,417
24453935@N00,771,81,1332567577,1332567577,1,4,0
24453935@N00,772,28,1332637129,1332646419,41,1,9290
24453935@N00,773,68,1332898514,1332898580,2,1,66
24453935@N00,774,48,1332980140,1332993614,11,1,13474
24484507@N00,775,49,1081549257,1081549257,1,2,0
24484507@N00,775,71,1081526440,1081526440,1,2,0
24484507@N00,776,36,1081818364,1081818364,1,1,0
24484507@N00,777,71,1081928245,1081928245,1,1,0
24510946@N07,778,9,1244437631,1244437631,1,3,0
24510946@N07,778,35,1244437167,1244437167,1,3,0
24510946@N07,778,71,1244444307,1244446056,6,3,1749
24510946@N07,779,0,1244857003,1244857021,2,3,18
24510946@N07,779,44,1244856042,1244856042,1,3,0
24510946@N07,779,45,1244855750,1244855791,3,3,41
24510946@N07,780,21,1244949169,1244949269,3,1,100
24761036@N00,781,51,1214716447,1214716447,1,1,0
24761036@N00,782,51,1218351742,1218352425,2,1,683
24761036@N00,783,51,1219548735,1219548735,1,1,0
24761036@N00,784,84,1220432529,1220432828,4,1,299
24761036@N00,785,9,1221121891,1221122070,8,4,179
24761036@N00,785,22,1221118560,1221118695,4,4,135
24761036@N00,785,23,1221122113,1221122209,6,4,96
24761036@N00,785,41,1221123792,1221123850,2,4,58
24761036@N00,786,76,1221287737,1221290000,14,1,2263
24761036@N00,787,22,1221640341,1221640341,1,2,0
24761036@N00,787,84,1221640061,1221641614,5,2,1553
24761036@N00,788,9,1221730419,1221730419,1,2,0
24761036@N00,788,36,1221724677,1221724761,2,2,84
24761036@N00,789,11,1221894820,1221901058,23,2,6238
24761036@N00,789,24,1221890882,1221890882,1,2,0
24761036@N00,790,71,1223020878,1223020960,2,1,82
24761036@N00,791,11,1228038835,1228039060,5,1,225
24761036@N00,792,13,1228376353,1228376353,1,1,0
24761036@N00,793,22,1232251888,1232251888,1,1,0
24761036@N00,794,11,1234064298,1234064315,2,1,17
24761036@N00,795,41,1234160463,1234162665,7,2,2202
24761036@N00,795,84,1234162923,1234163188,8,2,265
24761036@N00,796,11,1264066041,1264066041,1,1,0
24761036@N00,797,51,1296340208,1296340208,1,1,0
24761036@N00,798,13,1297914535,1297915107,4,3,572
24761036@N00,798,15,1297913215,1297917423,8,3,4208
24761036@N00,798,17,1297912639,1297915442,8,3,2803
24761036@N00,799,17,1301024214,1301024214,1,1,0
24761036@N00,800,9,1301374162,1301374162,1,2,0
24761036@N00,800,23,1301371966,1301371966,1,2,0
24761036@N00,801,41,1301902952,1301905212,3,1,2260
24761036@N00,802,41,1303286935,1303287147,2,1,212
24761036@N00,803,34,1306038466,1306039457,10,1,991
24761036@N00,804,78,1306556338,1306561048,2,1,4710
24905543@N00,805,85,1211103578,1211103578,1,1,0
24905543@N00,806,13,1303008959,1303008959,1,1,0
24905543@N00,807,32,1315102243,1315102243,1,2,0
24905543@N00,807,71,1315113737,1315113737,1,2,0
24905543@N00,808,14,1315274104,1315274104,1,1,0
24905543@N00,809,85,1334528590,1334528590,1,1,0
24905543@N00,810,2,1334585764,1334585764,1,1,0
24905543@N00,811,32,1334617789,1334617789,1,1,0
24905543@N00,812,72,1341628109,1341628109,1,1,0
24918835@N03,813,67,1284176372,1284179200,7,1,2828
24918835@N03,814,67,1287561290,1287561990,6,1,700
24918835@N03,815,32,1298091440,1298091440,1,1,0
24918835@N03,816,8,1331324371,1331324371,1,1,0
24998164@N06,817,44,1370155054,1370155232,9,6,178
24998164@N06,817,45,1370155398,1370155417,2,6,19
24998164@N06,817,50,1370151837,1370151869,5,6,32
24998164@N06,817,71,1370151715,1370152589,25,6,874
24998164@N06,817,81,1370152495,1370152932,19,6,437
24998164@N06,817,82,1370151779,1370156498,22,6,4719
24998164@N06,818,43,1371355798,1371362110,8,2,6312
24998164@N06,818,76,1371356409,1371361605,24,2,5196
24998164@N06,819,0,1372398846,1372399130,4,7,284
24998164@N06,819,15,1372402973,1372402973,1,7,0
24998164@N06,819,25,1372400951,1372400951,1,7,0
24998164@N06,819,44,1372398840,1372400611,3,7,1771
24998164@N06,819,45,1372396779,1372402615,168,7,5836
24998164@N06,819,81,1372396376,1372396510,2,7,134
24998164@N06,819,82,1372396380,1372402968,4,7,6588
24998164@N06,820,8,1373604025,1373609200,11,9,5175
24998164@N06,820,9,1373607799,1373608962,18,9,1163
24998164@N06,820,13,1373609199,1373609313,5,9,114
24998164@N06,820,15,1373609453,1373609550,9,9,97
24998164@N06,820,17,1373609396,1373609396,1,9,0
24998164@N06,820,18,1373604487,1373609045,34,9,4558
24998164@N06,820,23,1373604614,1373608768,34,9,4154
24998164@N06,820,71,1373602384,1373602483,3,9,99
24998164@N06,820,82,1373602382,1373609822,11,9,7440
25017556@N07,821,49,1294103001,1294103001,1,1,0
25017556@N07,822,46,1310118471,1310118471,1,1,0
25046991@N00,823,32,1300006966,1300006966,1,1,0
25046991@N00,824,42,1302147776,1302147776,1,1,0
25046991@N00,825,19,1304235799,1304235799,1,1,0
25046991@N00,826,42,1304295286,1304295286,1,1,0
25046991@N00,827,82,1308914824,1308914847,3,1,23
25046991@N00,828,19,1309072581,1309072605,2,1,24
25046991@N00,829,42,1311059883,1311059883,1,1,0
25046991@N00,830,22,1331984007,1331984007,1,1,0
25159380@N00,831,0,1254579986,1254579986,1,1,0
25287507@N02,832,50,1265071008,1265071008,1,1,0
25287507@N02,833,51,1265613157,1265613157,1,1,0
25287507@N02,834,70,1270665059,1270665059,1,1,0
25287507@N02,835,9,1271076169,1271082355,4,4,6186
25287507@N02,835,15,1271081589,1271081809,4,4,220
25287507@N02,835,35,1271082297,1271082432,2,4,135
25287507@N02,835,50,1271082222,1271082222,1,4,0
25287507@N02,836,36,1271169826,1271169826,1,3,0
25287507@N02,836,37,1271169271,1271169773,6,3,502
25287507@N02,836,40,1271168495,1271168551,2,3,56
25287507@N02,837,4,1271246307,1271246391,2,5,84
25287507@N02,837,14,1271247934,1271248241,4,5,307
25287507@N02,837,35,1271249012,1271249012,1,5,0
25287507@N02,837,50,1271246711,1271246711,1,5,0
25287507@N02,837,84,1271246481,1271246639,3,5,158
25287507@N02,838,40,1271758453,1271758742,3,2,289
25287507@N02,838,51,1271758834,1271766864,10,2,8030
25287507@N02,839,40,1271849706,1271849908,4,1,202
25287507@N02,840,51,1271881599,1271882057,2,1,458
25287507@N02,841,8,1271968114,1271968163,3,4,49
25287507@N02,841,9,1271968005,1271968042,2,4,37
25287507@N02,841,13,1271968133,1271968133,1,4,0
25287507@N02,841,23,1271967988,1271967988,1,4,0
25287507@N02,842,2,1272073707,1272073707,1,1,0
25287507@N02,843,9,1272364414,1272364414,1,2,0
25287507@N02,843,36,1272363408,1272363426,2,2,18
25287507@N02,844,40,1272968261,1272968266,2,1,5
25287507@N02,845,40,1273176733,1273176750,2,1,17
25287507@N02,846,40,1273355798,1273355820,3,1,22
25287507@N02,847,84,1273691834,1273691834,1,1,0
25287507@N02,848,40,1276687977,1276688240,11,1,263
25287507@N02,849,40,1276803553,1276803553,1,1,0
25323591@N03,850,71,1386041767,1386041767,1,1,0
25323591@N03,851,71,1386122333,1386122333,1,1,0
25356196@N08,852,32,1321000967,1321000967,1,1,0
25369515@N00,853,86,1247359192,1247359192,1,1,0
25369515@N00,854,57,1317437896,1317454934,13,2,17038
25369515@N00,854,79,1317444662,1317444662,1,2,0
25369515@N00,855,1,1334717872,1334717872,1,1,0
25369515@N00,856,31,1334815989,1334815989,1,3,0
25369515@N00,856,35,1334810592,1334810592,1,3,0
25369515@N00,856,81,1334818448,1334818448,1,3,0
25369515@N00,857,53,1345958249,1345959953,2,1,1704
25369515@N00,858,63,1348886867,1348886867,1,1,0
25509772@N00,859,45,1326238292,1326238292,1,2,0
25509772@N00,859,82,1326235898,1326235898,1,2,0
25526372@N03,860,16,1293777420,1293777420,1,1,0
25543011@N00,861,71,1275814898,1275814898,1,1,0
25543011@N00,862,71,1276054890,1276054890,1,1,0
25543011@N00,863,4,1277340146,1277340146,1,1,0
25543011@N00,864,11,1283600925,1283600925,1,1,0
25543011@N00,865,27,1295685146,1295685146,1,1,0
25547600@N02,866,71,1335658894,1335659130,9,1,236
25562642@N03,867,9,1207979129,1207979129,1,1,0
25588248@N00,868,40,1314111952,1314129452,3,2,17500
25588248@N00,868,51,1314112702,1314112702,1,2,0
25654955@N03,869,69,1255490214,1255490225,2,1,11
25654955@N03,870,41,1256344354,1256344354,1,2,0
25654955@N03,870,48,1256340182,1256340182,1,2,0
25654955@N03,871,72,1384645981,1384645981,1,2,0
25654955@N03,871,78,1384646289,1384654579,3,2,8290
25654955@N03,872,78,1385111767,1385112278,2,1,511
25777909@N00,873,82,1312594238,1312594718,2,1,480
25777909@N00,874,82,1312781859,1312781859,1,1,0
25777909@N00,875,82,1312866391,1312866391,1,1,0
25777909@N00,876,82,1312941095,1312950347,2,1,9252
25777909@N00,877,82,1313115993,1313115993,1,1,0
25777909@N00,878,25,1313200697,1313200697,1,2,0
25777909@N00,878,82,1313197665,1313202484,4,2,4819
25785996@N06,879,6,1289860343,1289860343,1,1,0
25866248@N04,880,14,1267593546,1267594837,2,1,1291
25866248@N04,881,9,1268885914,1268885914,1,1,0
25866248@N04,882,9,1269234257,1269234257,1,1,0
25866248@N04,883,29,1271516199,1271516199,1,1,0
25866248@N04,884,43,1272844314,1272844314,1,1,0
25866248@N04,885,15,1273732363,1273732363,1,1,0
25866248@N04,886,15,1274674640,1274674640,1,1,0
25866248@N04,887,8,1277170550,1277170550,1,2,0
25866248@N04,887,9,1277170166,1277170258,2,2,92
25866248@N04,888,8,1279075747,1279078572,8,1,2825
25866248@N04,889,9,1280106571,1280117035,13,1,10464
25866248@N04,890,8,1280984303,1280984303,1,1,0
25866248@N04,891,8,1289269844,1289269844,1,1,0
25866248@N04,892,49,1298681279,1298681279,1,1,0
25866248@N04,893,75,1311822041,1311822041,1,1,0
25866248@N04,894,8,1319769111,1319769111,1,1,0
25869855@N04,895,71,1258937315,1258937956,3,3,641
25869855@N04,895,75,1258950037,1258950037,1,3,0
25869855@N04,895,76,1258943190,1258944367,7,3,1177
25917046@N06,896,28,1286577889,1286577889,1,1,0
25917046@N06,897,34,1290545823,1290548634,8,1,2811
25917046@N06,898,71,1291619004,1291619004,1,1,0
25925793@N00,899,8,1249792743,1249792899,4,1,156
25925793@N00,900,9,1302832584,1302832584,1,1,0
25963075@N04,901,0,1284559476,1284559476,1,3,0
25963075@N04,901,31,1284559473,1284559473,1,3,0
25963075@N04,901,40,1284559495,1284559495,1,3,0
25976134@N04,902,17,1335163343,1335163343,1,4,0
25976134@N04,902,23,1335162331,1335162331,1,4,0
25976134@N04,902,35,1335165489,1335165489,1,4,0
25976134@N04,902,50,1335163955,1335165013,2,4,1058
25976134@N04,903,71,1335592937,1335592937,1,1,0
25976134@N04,904,4,1339816516,1339816516,1,2,0
25976134@N04,904,36,1339816821,1339817811,2,2,990
25976134@N04,905,8,1340517440,1340517440,1,1,0
25976134@N04,906,81,1341490155,1341490155,1,1,0
26036678@N07,907,20,1310893325,1310893325,1,1,0
26036678@N07,908,8,1354788868,1354788868,1,1,0
26036678@N07,909,82,1355168039,1355168039,1,1,0
26071009@N04,910,28,1282959805,1282967740,17,1,7935
26071009@N04,911,48,1287877188,1287881365,3,1,4177
26071009@N04,912,0,1297480330,1297480330,1,6,0
26071009@N04,912,35,1297465676,1297465676,1,6,0
26071009@N04,912,45,1297470152,1297479506,2,6,9354
26071009@N04,912,50,1297480291,1297480291,1,6,0
26071009@N04,912,68,1297475342,1297475402,2,6,60
26071009@N04,912,71,1297470236,1297480280,2,6,10044
26071009@N04,913,28,1309061126,1309067835,6,1,6709
26071009@N04,914,27,1309663867,1309667293,6,2,3426
26071009@N04,914,28,1309665568,1309665568,1,2,0
26071009@N04,915,71,1362806532,1362806532,1,1,0
26085795@N02,916,2,1318636495,1318647039,2,11,10544
26085795@N02,916,4,1318656707,1318656707,1,11,0
26085795@N02,916,8,1318651210,1318651210,1,11,0
26085795@N02,916,14,1318652244,1318653517,4,11,1273
26085795@N02,916,17,1318652092,1318652092,1,11,0
26085795@N02,916,19,1318634951,1318634951,1,11,0
26085795@N02,916,35,1318649714,1318649714,1,11,0
26085795@N02,916,38,1318655315,1318655315,1,11,0
26085795@N02,916,40,1318636765,1318636765,1,11,0
26085795@N02,916,42,1318654836,1318654836,1,11,0
26085795@N02,916,84,1318656405,1318656405,1,11,0
26085795@N02,917,71,1318715933,1318716034,2,1,101
26118209@N07,918,35,1208583678,1208589430,14,1,5752
26125239@N00,919,35,1367387256,1367392585,17,1,5329
26127259@N02,920,21,1148631656,1148632633,2,1,977
26169593@N00,921,7,1327136462,1327136462,1,1,0
26227335@N02,922,32,1303512347,1303512347,1,1,0
26258401@N03,923,82,1393070166,1393070166,1,1,0
26303188@N00,924,71,1369041124,1369041124,1,1,0
26303188@N00,925,71,1397624779,1397624779,1,1,0
26320335@N06,926,14,1359018502,1359018502,1,1,0
26399791@N07,927,14,1210826067,1210826067,1,2,0
26399791@N07,927,15,1210826787,1210826787,1,2,0
26399791@N07,928,4,1212686710,1212686710,1,1,0
26489950@N03,929,31,1373159358,1373159358,1,1,0
26670541@N07,930,16,1312958452,1312958452,1,1,0
26670541@N07,931,8,1313719123,1313719123,1,6,0
26670541@N07,931,16,1313720927,1313720949,2,6,22
26670541@N07,931,18,1313718864,1313719439,5,6,575
26670541@N07,931,22,1313718423,1313718508,2,6,85
26670541@N07,931,32,1313719464,1313719656,3,6,192
26670541@N07,931,84,1313719777,1313720298,2,6,521
26670541@N07,932,24,1313982869,1313983838,6,1,969
26670541@N07,933,24,1314082142,1314082142,1,1,0
26771458@N08,934,75,1211447224,1211447224,1,1,0
26908483@N00,935,21,1328184026,1328184083,4,1,57
26908483@N00,936,57,1330679216,1330679216,1,1,0
26908483@N00,937,55,1351158810,1351158810,1,1,0
26978304@N08,938,0,1291533177,1291533177,1,1,0
26978304@N08,939,0,1291700077,1291700077,1,1,0
26978304@N08,940,0,1291795319,1291795319,1,2,0
26978304@N08,940,21,1291788112,1291788112,1,2,0
26978304@N08,941,0,1291836707,1291836707,1,1,0
27078865@N00,942,31,1278763657,1278763657,1,1,0
27158819@N00,943,85,1139059642,1139059642,1,1,0
27158819@N00,944,81,1142404955,1142422468,45,1,17513
27158819@N00,945,81,1142479983,1142480898,2,1,915
27158819@N00,946,44,1154226914,1154227006,3,1,92
27164277@N00,947,35,1215772196,1215772196,2,1,0
27324070@N00,948,8,1259108242,1259108242,1,2,0
27324070@N00,948,15,1259107658,1259109635,2,2,1977
27324070@N00,949,15,1259183906,1259183906,1,1,0
27324070@N00,950,8,1259631267,1259631267,1,1,0
27324070@N00,951,15,1260828465,1260828465,1,1,0
27503513@N05,952,50,1372022153,1372022153,1,1,0
27503513@N05,953,50,1372215500,1372215500,1,1,0
27503513@N05,954,55,1372286335,1372286335,1,1,0
27503513@N05,955,9,1372412050,1372412050,1,1,0
27759575@N05,956,35,1253844058,1253846078,49,1,2020
27759575@N05,957,84,1254518483,1254519035,6,1,552
27759575@N05,958,7,1256201075,1256202302,19,1,1227
27759575@N05,959,19,1257027392,1257027410,4,3,18
27759575@N05,959,38,1257027152,1257027184,3,3,32
27759575@N05,959,73,1257026772,1257026899,8,3,127
27759575@N05,960,73,1257663576,1257664198,13,1,622
27759575@N05,961,22,1258101181,1258101185,2,5,4
27759575@N05,961,49,1258089754,1258091560,25,5,1806
27759575@N05,961,67,1258083517,1258083624,9,5,107
27759575@N05,961,74,1258085282,1258085619,3,5,337
27759575@N05,961,76,1258088398,1258088398,1,5,0
27759575@N05,962,21,1259741855,1259746081,27,1,4226
27759575@N05,963,30,1260015414,1260015460,4,1,46
27759575@N05,964,21,1260349137,1260349306,3,1,169
27759575@N05,965,9,1260630721,1260630721,1,2,0
27759575@N05,965,50,1260630271,1260630407,4,2,136
27759575@N05,966,14,1260870253,1260873139,5,4,2886
27759575@N05,966,32,1260876217,1260876300,4,4,83
27759575@N05,966,70,1260875131,1260875131,1,4,0
27759575@N05,966,84,1260877232,1260877430,5,4,198
27759575@N05,967,41,1261290392,1261290392,1,2,0
27759575@N05,967,73,1261273852,1261273875,6,2,23
27844104@N00,968,15,1275032228,1275032228,1,2,0
27844104@N00,968,84,1275025418,1275025418,1,2,0
27844104@N00,969,45,1275121295,1275122465,2,1,1170
27853330@N05,970,48,1304867769,1304867769,1,1,0
27938958@N00,971,44,1236912926,1236913334,3,1,408
27938958@N00,972,25,1237343702,1237343702,1,1,0
27938958@N00,973,45,1295580082,1295580090,2,1,8
27938958@N00,974,30,1299233849,1299233868,2,1,19
27938958@N00,975,27,1326591157,1326595021,10,1,3864
27938958@N00,976,71,1359707711,1359709734,75,1,2023
27982139@N00,977,11,1099108024,1099122546,11,1,14522
27982139@N00,978,11,1120480392,1120480392,1,2,0
27982139@N00,978,50,1120480439,1120480439,1,2,0
27982139@N00,979,11,1130780566,1130781061,5,1,495
27982139@N00,980,11,1131208019,1131209539,26,1,1520
27982139@N00,981,11,1135950972,1135950972,1,1,0
27982139@N00,982,11,1138014816,1138015859,10,1,1043
27982139@N00,983,11,1140271186,1140271186,1,1,0
27982139@N00,984,11,1140337500,1140338913,3,1,1413
27982139@N00,985,11,1140787289,1140787289,1,1,0
27982139@N00,986,11,1140852100,1140852143,3,1,43
27982139@N00,987,11,1142686410,1142686410,1,1,0
27982139@N00,988,11,1150782029,1150782076,2,1,47
27982139@N00,989,11,1152787760,1152808884,5,1,21124
27982139@N00,990,11,1152974198,1152974306,2,1,108
27982139@N00,991,11,1153051264,1153051629,7,1,365
27982139@N00,992,11,1154043966,1154043966,1,1,0
27982139@N00,993,11,1156129866,1156129875,2,1,9
27982139@N00,994,11,1158661266,1158661266,1,1,0
27982139@N00,995,11,1159002188,1159002188,1,1,0
27982139@N00,996,7,1159259150,1159259150,1,1,0
27982139@N00,997,7,1161240492,1161240492,1,1,0
27982139@N00,998,11,1162453632,1162459868,6,1,6236
27982139@N00,999,32,1162518035,1162518035,1,1,0
27982139@N00,1000,11,1163218888,1163218888,1,1,0
27982139@N00,1001,7,1165756492,1165761500,3,2,5008
27982139@N00,1001,11,1165737016,1165742929,2,2,5913
27982139@N00,1002,11,1199187631,1199187631,1,1,0
27982139@N00,1003,11,1200369205,1200369205,1,1,0
27982139@N00,1004,11,1200722468,1200722468,1,1,0
27982139@N00,1005,11,1201540193,1201540193,1,1,0
27982139@N00,1006,11,1201784400,1201784400,2,1,0
27982139@N00,1007,11,1202190399,1202190399,1,1,0
27982139@N00,1008,11,1202982282,1202984629,3,1,2347
27982139@N00,1009,11,1203426383,1203430339,2,1,3956
27982139@N00,1010,11,1204523455,1204523455,1,1,0
27982139@N00,1011,2,1209831221,1209831221,1,1,0
28030740@N02,1012,50,1338741726,1338741726,1,1,0
28030740@N02,1013,71,1372277471,1372277471,1,1,0
28030740@N02,1014,48,1373421401,1373423083,6,2,1682
28030740@N02,1014,69,1373422490,1373422490,1,2,0
28030740@N02,1015,71,1379054255,1379054255,1,1,0
28030740@N02,1016,48,1389663327,1389663327,1,1,0
28067218@N00,1017,2,1326517991,1326517991,1,5,0
28067218@N00,1017,17,1326512754,1326512754,1,5,0
28067218@N00,1017,50,1326512641,1326512641,1,5,0
28067218@N00,1017,81,1326511987,1326511987,1,5,0
28067218@N00,1017,82,1326512330,1326512330,1,5,0
28067218@N00,1018,2,1327900507,1327900507,1,2,0
28067218@N00,1018,35,1327904157,1327904157,1,2,0
28067218@N00,1019,4,1328751597,1328751597,1,1,0
28067218@N00,1020,26,1329011490,1329011490,1,1,0
28067218@N00,1021,1,1329102569,1329102569,1,1,0
28067218@N00,1022,39,1329701825,1329701825,1,1,0
28067218@N00,1023,9,1331963421,1331963421,1,3,0
28067218@N00,1023,22,1331956375,1331956783,2,3,408
28067218@N00,1023,41,1331951558,1331951558,1,3,0
28067218@N00,1024,84,1332384878,1332384878,1,1,0
28067218@N00,1025,8,1332743809,1332743809,1,1,0
28067218@N00,1026,8,1333359672,1333359672,1,1,0
28067218@N00,1027,22,1335869965,1335869965,1,1,0
28067218@N00,1028,18,1336454648,1336454648,1,2,0
28067218@N00,1028,32,1336459497,1336459497,1,2,0
28067218@N00,1029,67,1336880628,1336880628,1,2,0
28067218@N00,1029,71,1336880476,1336880476,1,2,0
28067218@N00,1030,41,1340865598,1340865598,1,1,0
28067218@N00,1031,9,1347530331,1347530331,1,1,0
28067218@N00,1032,67,1367908314,1367908314,1,1,0
28067218@N00,1033,1,1379129132,1379129132,1,1,0
28135215@N00,1034,29,1234505282,1234505282,1,1,0
28135215@N00,1035,0,1237536386,1237536386,1,1,0
28135215@N00,1036,58,1238234707,1238250777,6,2,16070
28135215@N00,1036,59,1238213603,1238230553,5,2,16950
28135215@N00,1037,1,1239447301,1239452937,2,2,5636
28135215@N00,1037,85,1239460025,1239460025,1,2,0
28135215@N00,1038,57,1241185165,1241185165,1,1,0
28135215@N00,1039,57,1244291760,1244291760,1,1,0
28135215@N00,1040,26,1259080982,1259080982,1,1,0
28135215@N00,1041,62,1328952609,1328960276,18,2,7667
28135215@N00,1041,63,1328958442,1328958444,2,2,2
28135215@N00,1042,22,1332636073,1332636753,7,4,680
28135215@N00,1042,26,1332662383,1332663095,2,4,712
28135215@N00,1042,41,1332635206,1332639401,8,4,4195
28135215@N00,1042,84,1332635276,1332635276,1,4,0
28135215@N00,1043,28,1344010719,1344010719,1,1,0
28135215@N00,1044,36,1345575972,1345575972,1,1,0
28135215@N00,1045,36,1350938880,1350938880,1,1,0
28135215@N00,1046,46,1353760354,1353776057,2,1,15703
28135215@N00,1047,78,1368776054,1368776054,1,1,0
28135215@N00,1048,26,1370650435,1370656326,2,1,5891
28139537@N07,1049,50,1331514331,1331514429,2,1,98
28139537@N07,1050,26,1336290403,1336291422,4,1,1019
28139537@N07,1051,26,1347355541,1347356417,3,1,876
28248416@N03,1052,14,1222145073,1222159347,11,2,14274
28248416@N03,1052,82,1222150109,1222150109,1,2,0
28285551@N03,1053,0,1340954281,1340954281,1,1,0
28348255@N07,1054,71,1394961844,1394961844,1,1,0
28348255@N07,1055,41,1395792631,1395792631,1,1,0
28348255@N07,1056,71,1395821674,1395821674,1,1,0
28348255@N07,1057,18,1396254932,1396254932,1,2,0
28348255@N07,1057,42,1396255818,1396255818,1,2,0
28348255@N07,1058,32,1396521849,1396522117,2,2,268
28348255@N07,1058,50,1396522344,1396522344,1,2,0
28388746@N04,1059,84,1176623680,1176623680,1,1,0
28435348@N04,1060,57,1231669612,1231669612,1,1,0
28435348@N04,1061,17,1360811565,1360811565,1,1,0
28461660@N00,1062,13,1362107089,1362107089,1,5,0
28461660@N00,1062,25,1362113104,1362113104,1,5,0
28461660@N00,1062,44,1362111942,1362111942,1,5,0
28461660@N00,1062,81,1362098838,1362098838,1,5,0
28461660@N00,1062,82,1362098704,1362113955,2,5,15251
28461660@N00,1063,21,1362193162,1362193162,1,5,0
28461660@N00,1063,23,1362176251,1362203294,3,5,27043
28461660@N00,1063,24,1362168353,1362196085,3,5,27732
28461660@N00,1063,48,1362197888,1362197888,1,5,0
28461660@N00,1063,82,1362204109,1362204109,1,5,0
28461660@N00,1064,46,1362271077,1362271077,1,1,0
28461660@N00,1065,71,1362340875,1362340875,1,1,0
28527865@N05,1066,35,1380976642,1380976644,2,5,2
28527865@N05,1066,46,1380976405,1380976405,1,5,0
28527865@N05,1066,50,1380976898,1380976904,4,5,6
28527865@N05,1066,71,1380976908,1380976908,1,5,0
28527865@N05,1066,78,1380976555,1380976564,5,5,9
28566715@N06,1067,79,1347105149,1347105149,1,1,0
28566715@N06,1068,57,1348900391,1348900391,1,1,0
28566715@N06,1069,51,1349583929,1349583929,1,1,0
28566715@N06,1070,81,1393066624,1393066624,1,1,0
28595835@N00,1071,26,1180064840,1180064840,1,1,0
28595835@N00,1072,26,1182570919,1182584574,52,1,13655
28595835@N00,1073,57,1186201614,1186201617,2,1,3
28595835@N00,1074,7,1194008404,1194008404,1,1,0
28685313@N00,1075,8,1332055486,1332059040,11,6,3554
28685313@N00,1075,25,1332063204,1332063852,2,6,648
28685313@N00,1075,59,1332019459,1332062947,10,6,43488
28685313@N00,1075,66,1332063074,1332063363,2,6,289
28685313@N00,1075,82,1332026779,1332026779,1,6,0
28685313@N00,1075,85,1332013373,1332020353,3,6,6980
28716478@N07,1076,16,1247835431,1247835431,1,1,0
28716478@N07,1077,71,1312722040,1312722303,2,1,263
28732794@N00,1078,31,1305953362,1305953362,1,1,0
28732794@N00,1079,26,1306044052,1306044052,1,1,0
28793375@N00,1080,39,1279545687,1279547704,19,1,2017
28886849@N00,1081,85,1234421396,1234421396,1,1,0
28886849@N00,1082,85,1238136955,1238136955,1,1,0
28886849@N00,1083,5,1263263000,1263263000,1,1,0
28886849@N00,1084,85,1266215527,1266215527,1,1,0
28886849@N00,1085,42,1271062838,1271062838,1,1,0
28886849@N00,1086,85,1271921794,1271921794,1,1,0
28964800@N03,1087,14,1218900014,1218900014,1,4,0
28964800@N03,1087,18,1218900006,1218900006,1,4,0
28964800@N03,1087,35,1218899975,1218899980,2,4,5
28964800@N03,1087,70,1218899991,1218899991,1,4,0
28964800@N03,1088,56,1295144680,1295144680,1,1,0
28964800@N03,1089,53,1298711069,1298711069,1,1,0
28964800@N03,1090,53,1302417399,1302417399,1,1,0
28964800@N03,1091,53,1305949438,1305949438,1,1,0
28964800@N03,1092,57,1308382098,1308382098,1,1,0
28964800@N03,1093,53,1312536985,1312536985,1,1,0
28964800@N03,1094,53,1315644578,1315644578,1,1,0
28964800@N03,1095,46,1328341848,1328341848,1,1,0
28964800@N03,1096,53,1330070885,1330070885,1,1,0
29135768@N07,1097,85,1343887383,1343887383,1,1,0
29135768@N07,1098,85,1363149903,1363149903,1,1,0
29174998@N05,1099,48,1128573105,1128573105,1,1,0
29174998@N05,1100,25,1134854616,1134854784,2,1,168
29174998@N05,1101,9,1273633028,1273634896,5,3,1868
29174998@N05,1101,32,1273634479,1273634486,2,3,7
29174998@N05,1101,35,1273633114,1273633323,2,3,209
29259735@N00,1102,26,1193990038,1193990038,1,1,0
29297680@N00,1103,2,1278734256,1278734256,1,1,0
29299860@N05,1104,71,1359274726,1359274726,1,1,0
29323801@N00,1105,71,1389416400,1389416401,2,1,1
29385474@N00,1106,82,1315709767,1315709767,1,1,0
29385474@N00,1107,68,1335595723,1335595723,1,1,0
29385474@N00,1108,9,1339221665,1339221777,3,2,112
29385474@N00,1108,50,1339212858,1339212858,1,2,0
29385474@N00,1109,68,1340520794,1340520869,3,1,75
29385474@N00,1110,69,1341727672,1341728007,2,1,335
29385474@N00,1111,63,1343522018,1343523100,2,1,1082
29385474@N00,1112,50,1367124377,1367124377,1,1,0
29385474@N00,1113,48,1368243994,1368244019,2,2,25
29385474@N00,1113,68,1368235469,1368235469,1,2,0
29385474@N00,1114,70,1368870319,1368870319,1,1,0
29385474@N00,1115,67,1370673277,1370673609,5,1,332
29465723@N00,1116,71,1345550804,1345550804,1,1,0
29465723@N00,1117,13,1345581835,1345581835,1,3,0
29465723@N00,1117,39,1345583978,1345583978,1,3,0
29465723@N00,1117,81,1345583406,1345583607,2,3,201
29654828@N05,1118,13,1258331652,1258331652,1,1,0
29728054@N00,1119,31,1340984978,1340984978,1,4,0
29728054@N00,1119,32,1340988098,1340988098,1,4,0
29728054@N00,1119,50,1340986279,1340986302,2,4,23
29728054@N00,1119,71,1340985957,1340985957,1,4,0
29728054@N00,1120,31,1370835441,1370837934,3,1,2493
29728054@N00,1121,71,1372631853,1372631853,1,1,0
29728054@N00,1122,51,1377731329,1377731329,1,1,0
29728054@N00,1123,27,1377935748,1377935748,1,1,0
29728054@N00,1124,23,1380254058,1380254058,1,1,0
29728054@N00,1125,17,1387857708,1387857708,1,1,0
29728054@N00,1126,70,1393064989,1393065135,2,1,146
29731635@N00,1127,63,1263803883,1263803883,1,1,0
29731635@N00,1128,71,1302934828,1302934828,1,1,0
29731635@N00,1129,44,1316838637,1316838706,2,1,69
29731635@N00,1130,71,1320557582,1320557582,1,1,0
29731635@N00,1131,63,1390034973,1390034973,1,1,0
29731635@N00,1132,32,1396135543,1396135543,1,1,0
29793329@N07,1133,81,1243139821,1243139821,1,1,0
29954226@N00,1134,15,1230049475,1230049475,1,4,0
29954226@N00,1134,26,1230044722,1230045379,5,4,657
29954226@N00,1134,41,1230058448,1230058960,5,4,512
29954226@N00,1134,71,1230061099,1230061694,2,4,595
29954226@N00,1135,71,1230119451,1230119470,2,1,19
29954226@N00,1136,1,1230185038,1230185159,3,1,121
29954226@N00,1137,68,1230275350,1230276513,11,2,1163
29954226@N00,1137,71,1230277607,1230285104,2,2,7497
29954226@N00,1138,50,1230357894,1230361023,2,1,3129
29977619@N03,1139,84,1360551064,1360551064,1,1,0
29979532@N08,1140,22,1370680536,1370680536,1,2,0
29979532@N08,1140,78,1370677910,1370678210,7,2,300
29979532@N08,1141,27,1370858402,1370858668,238,1,266
30034121@N04,1142,2,1385939833,1385939833,1,2,0
30034121@N04,1142,20,1385953958,1385953958,1,2,0
30034121@N04,1143,35,1393075915,1393076181,4,1,266
30034121@N04,1144,2,1393683645,1393683645,1,1,0
30034121@N04,1145,45,1394420277,1394420277,1,1,0
30126548@N00,1146,9,1389337510,1389337579,2,1,69
30126548@N00,1147,14,1389404092,1389404092,1,2,0
30126548@N00,1147,27,1389407520,1389408863,5,2,1343
30206889@N00,1148,50,1175592815,1175592815,1,1,0
30206889@N00,1149,27,1175658881,1175658881,1,12,0
30206889@N00,1149,29,1175659825,1175659967,2,12,142
30206889@N00,1149,31,1175666829,1175669938,3,12,3109
30206889@N00,1149,44,1175670068,1175670068,1,12,0
30206889@N00,1149,48,1175644749,1175651466,3,12,6717
30206889@N00,1149,50,1175642180,1175680801,3,12,38621
30206889@N00,1149,56,1175663693,1175663693,1,12,0
30206889@N00,1149,63,1175663178,1175664756,2,12,1578
30206889@N00,1149,68,1175665425,1175665651,3,12,226
30206889@N00,1149,69,1175644337,1175644337,1,12,0
30206889@N00,1149,71,1175666113,1175666113,1,12,0
30206889@N00,1149,81,1175676613,1175676719,2,12,106
30206889@N00,1150,50,1175823222,1175837865,2,4,14643
30206889@N00,1150,68,1175820574,1175820574,1,4,0
30206889@N00,1150,71,1175821489,1175837610,6,4,16121
30206889@N00,1150,81,1175818924,1175819142,3,4,218
30265340@N00,1151,48,1138831639,1138841549,8,2,9910
30265340@N00,1151,85,1138855648,1138856018,5,2,370
30265340@N00,1152,27,1174113746,1174114352,12,1,606
30265340@N00,1153,59,1194744430,1194752472,3,1,8042
30265340@N00,1154,21,1209543718,1209548044,7,1,4326
30265340@N00,1155,11,1232920459,1232920661,6,1,202
30265340@N00,1156,41,1232953257,1232953257,1,1,0
30265340@N00,1157,38,1257583822,1257583822,1,1,0
30265340@N00,1158,50,1273118464,1273119347,9,2,883
30265340@N00,1158,71,1273118220,1273118220,1,2,0
30265340@N00,1159,85,1275112408,1275112421,2,1,13
30265340@N00,1160,18,1325248124,1325248124,1,2,0
30265340@N00,1160,23,1325243487,1325243487,1,2,0
30265340@N00,1161,22,1332381536,1332381536,1,1,0
30265340@N00,1162,35,1334112418,1334112418,1,1,0
30265340@N00,1163,22,1334201161,1334201161,1,2,0
30265340@N00,1163,37,1334201183,1334201183,1,2,0
30265340@N00,1164,81,1335331561,1335331561,1,2,0
30265340@N00,1164,82,1335333341,1335333341,1,2,0
30265340@N00,1165,40,1337204504,1337204504,1,1,0
30265340@N00,1166,26,1342076876,1342079379,3,1,2503
30265340@N00,1167,84,1346757053,1346757053,1,1,0
30265340@N00,1168,84,1347592328,1347592328,1,1,0
30265340@N00,1169,69,1351120492,1351120538,2,1,46
30265340@N00,1170,22,1351198678,1351198815,2,4,137
30265340@N00,1170,32,1351197944,1351197944,1,4,0
30265340@N00,1170,41,1351197752,1351197781,2,4,29
30265340@N00,1170,84,1351197613,1351197613,1,4,0
30265340@N00,1171,32,1354805548,1354805548,1,1,0
30265340@N00,1172,0,1355047150,1355047193,3,8,43
30265340@N00,1172,9,1355051522,1355051892,2,8,370
30265340@N00,1172,23,1355051861,1355051861,1,8,0
30265340@N00,1172,31,1355046872,1355046872,1,8,0
30265340@N00,1172,35,1355051124,1355051270,3,8,146
30265340@N00,1172,44,1355047565,1355047565,1,8,0
30265340@N00,1172,70,1355050772,1355050880,2,8,108
30265340@N00,1172,81,1355047789,1355047789,1,8,0
30265340@N00,1173,85,1356311707,1356311707,1,1,0
30265340@N00,1174,26,1359333196,1359347986,10,1,14790
30265340@N00,1175,9,1360028207,1360028207,1,1,0
30265340@N00,1176,9,1360462246,1360462246,1,3,0
30265340@N00,1176,22,1360460761,1360460761,1,3,0
30265340@N00,1176,40,1360465518,1360465518,1,3,0
30265340@N00,1177,84,1363139853,1363139853,1,1,0
30265340@N00,1178,69,1366667946,1366667946,1,1,0
30265340@N00,1179,84,1367547100,1367547100,1,1,0
30265340@N00,1180,48,1368414983,1368417452,6,2,2469
30265340@N00,1180,69,1368417670,1368417670,1,2,0
30265340@N00,1181,2,1370235029,1370235029,1,1,0
30265340@N00,1182,22,1371177194,1371177194,1,1,0
30265340@N00,1183,40,1371705681,1371705724,4,1,43
30265340@N00,1184,2,1371794478,1371794478,1,1,0
30265340@N00,1185,46,1374022274,1374023906,4,1,1632
30265340@N00,1186,22,1377051782,1377052471,2,1,689
30265340@N00,1187,71,1379128733,1379130359,3,2,1626
30265340@N00,1187,82,1379137139,1379137139,1,2,0
30265340@N00,1188,22,1379560167,1379560167,1,1,0
30265340@N00,1189,37,1383269408,1383269408,1,1,0
30265340@N00,1190,48,1383779336,1383779336,1,1,0
30265340@N00,1191,0,1384819940,1384819940,1,8,0
30265340@N00,1191,8,1384815932,1384815932,1,8,0
30265340@N00,1191,13,1384815677,1384815785,4,8,108
30265340@N00,1191,22,1384828802,1384829889,4,8,1087
30265340@N00,1191,41,1384828206,1384828206,1,8,0
30265340@N00,1191,44,1384820025,1384820025,1,8,0
30265340@N00,1191,50,1384815540,1384815540,1,8,0
30265340@N00,1191,84,1384827171,1384827171,1,8,0
30265340@N00,1192,16,1385946423,1385948071,2,1,1648
30265340@N00,1193,22,1386196427,1386196427,1,1,0
30265340@N00,1194,45,1386297536,1386304863,4,1,7327
30265340@N00,1195,22,1387141106,1387141171,3,1,65
30265340@N00,1196,40,1387336573,1387336573,1,1,0
30265340@N00,1197,9,1387446810,1387447031,2,2,221
30265340@N00,1197,85,1387440926,1387440926,1,2,0
30265340@N00,1198,22,1387846718,1387846718,1,2,0
30265340@N00,1198,36,1387849112,1387849301,3,2,189
30265340@N00,1199,22,1392683233,1392683233,1,1,0
30265340@N00,1200,16,1392946903,1392946903,1,2,0
30265340@N00,1200,41,1392949455,1392949455,1,2,0
30265340@N00,1201,16,1393205322,1393205322,1,1,0
30342939@N00,1202,27,1195800624,1195802136,8,2,1512
30342939@N00,1202,81,1195804765,1195804765,1,2,0
30342939@N00,1203,1,1195868675,1195869499,8,20,824
30342939@N00,1203,8,1195851260,1195851382,2,20,122
30342939@N00,1203,9,1195850064,1195863749,6,20,13685
30342939@N00,1203,13,1195851839,1195851839,1,20,0
30342939@N00,1203,14,1195858790,1195858790,1,20,0
30342939@N00,1203,15,1195851930,1195851986,2,20,56
30342939@N00,1203,17,1195851560,1195851560,1,20,0
30342939@N00,1203,25,1195873693,1195873787,3,20,94
30342939@N00,1203,27,1195872406,1195872460,2,20,54
30342939@N00,1203,32,1195849087,1195864220,8,20,15133
30342939@N00,1203,35,1195850910,1195851029,3,20,119
30342939@N00,1203,42,1195848657,1195848734,2,20,77
30342939@N00,1203,44,1195853967,1195854342,4,20,375
30342939@N00,1203,45,1195854771,1195854856,2,20,85
30342939@N00,1203,50,1195852343,1195852548,2,20,205
30342939@N00,1203,53,1195869619,1195869619,1,20,0
30342939@N00,1203,71,1195852823,1195853327,6,20,504
30342939@N00,1203,81,1195853383,1195853813,6,20,430
30342939@N00,1203,82,1195852188,1195852188,1,20,0
30342939@N00,1203,85,1195865063,1195871375,5,20,6312
30391546@N02,1204,57,1285992692,1285992692,1,1,0
30391546@N02,1205,31,1324462027,1324462027,1,1,0
30405626@N00,1206,25,1290394698,1290394698,1,1,0
30500614@N03,1207,9,1298156123,1298156123,1,1,0
30628871@N00,1208,15,1140723393,1140723393,1,4,0
30628871@N00,1208,50,1140722722,1140723016,3,4,294
30628871@N00,1208,71,1140721867,1140722476,8,4,609
30628871@N00,1208,82,1140721411,1140723139,5,4,1728
30628871@N00,1209,45,1154040236,1154040319,2,1,83
30628871@N00,1210,45,1165776884,1165776884,1,1,0
30628871@N00,1211,45,1165827566,1165827566,1,1,0
30628871@N00,1212,45,1165862905,1165862905,1,1,0
30628871@N00,1213,44,1165951459,1165951459,1,1,0
30628871@N00,1214,71,1292981533,1292981533,1,1,0
30628871@N00,1215,71,1293672734,1293672734,1,1,0
30628871@N00,1216,42,1328311884,1328311884,1,1,0
30628871@N00,1217,13,1328401579,1328401579,1,4,0
30628871@N00,1217,42,1328394101,1328394101,1,4,0
30628871@N00,1217,50,1328402885,1328408413,2,4,5528
30628871@N00,1217,71,1328400034,1328404793,12,4,4759
30628871@N00,1218,71,1328673123,1328673123,1,1,0
30659367@N00,1219,26,1381785735,1381785797,3,2,62
30659367@N00,1219,48,1381794454,1381796976,10,2,2522
30668772@N02,1220,22,1347525066,1347525105,4,2,39
30668772@N02,1220,57,1347525056,1347525056,1,2,0
30783433@N06,1221,5,1219471985,1219471993,2,1,8
30783433@N06,1222,57,1250931718,1250931718,1,1,0
30783433@N06,1223,32,1251505867,1251505867,1,1,0
30783433@N06,1224,50,1284259059,1284259209,2,1,150
30783433@N06,1225,55,1295663888,1295667274,18,1,3386
30830430@N03,1226,13,1296399029,1296399029,1,1,0
30830430@N03,1227,45,1317477490,1317477490,1,1,0
30864080@N00,1228,6,1244064531,1244064531,1,1,0
31043650@N04,1229,57,1357888934,1357888934,1,1,0
31043650@N04,1230,17,1357963427,1357963427,1,3,0
31043650@N04,1230,32,1357953220,1357953220,1,3,0
31043650@N04,1230,57,1357967750,1357967750,1,3,0
31058815@N00,1231,50,1327714370,1327714370,1,3,0
31058815@N00,1231,63,1327715346,1327745358,8,3,30012
31058815@N00,1231,68,1327715163,1327715163,1,3,0
31087663@N02,1232,22,1323412420,1323412420,1,1,0
31124964@N00,1233,27,1249094639,1249094710,2,4,71
31124964@N00,1233,35,1249101273,1249101273,1,4,0
31124964@N00,1233,36,1249108684,1249108684,1,4,0
31124964@N00,1233,69,1249107788,1249107788,1,4,0
31124964@N00,1234,26,1249182918,1249183245,2,1,327
31148157@N00,1235,71,1121690892,1121690892,1,1,0
31148157@N00,1236,8,1121757224,1121757224,1,1,0
31148157@N00,1237,81,1122013671,1122013671,1,1,0
31148157@N00,1238,71,1122198220,1122198220,1,1,0
31148157@N00,1239,18,1135340696,1135340708,2,1,12
31148157@N00,1240,8,1160200297,1160200297,1,3,0
31148157@N00,1240,14,1160200284,1160200284,1,3,0
31148157@N00,1240,15,1160200210,1160200210,1,3,0
31148157@N00,1241,24,1160472510,1160472510,1,4,0
31148157@N00,1241,32,1160460090,1160460367,5,4,277
31148157@N00,1241,36,1160472185,1160472185,1,4,0
31148157@N00,1241,41,1160470887,1160470887,1,4,0
31148157@N00,1242,32,1160708834,1160709165,3,1,331
31148157@N00,1243,41,1160967898,1160968214,3,2,316
31148157@N00,1243,71,1160978522,1160978522,1,2,0
31148157@N00,1244,14,1161331879,1161332624,2,1,745
31148157@N00,1245,8,1161420888,1161420888,1,4,0
31148157@N00,1245,14,1161426428,1161426428,1,4,0
31148157@N00,1245,18,1161408364,1161408364,1,4,0
31148157@N00,1245,71,1161413044,1161426417,2,4,13373
31148157@N00,1246,35,1161518746,1161518746,1,1,0
31148157@N00,1247,32,1161597061,1161597061,1,2,0
31148157@N00,1247,41,1161582978,1161597071,2,2,14093
31148157@N00,1248,41,1161675027,1161675027,1,1,0
31148157@N00,1249,31,1162696468,1162696468,1,3,0
31148157@N00,1249,44,1162695852,1162695852,1,3,0
31148157@N00,1249,71,1162699679,1162700500,2,3,821
31148157@N00,1250,50,1163226399,1163226399,1,2,0
31148157@N00,1250,81,1163225236,1163225236,1,2,0
31148157@N00,1251,16,1163489466,1163489466,1,1,0
31148157@N00,1252,32,1164363644,1164363644,1,2,0
31148157@N00,1252,41,1164352864,1164352864,1,2,0
31148157@N00,1253,10,1374272698,1374272698,1,1,0
31174848@N00,1254,82,1308466196,1308466196,1,1,0
31174848@N00,1255,36,1308528330,1308528330,1,2,0
31174848@N00,1255,71,1308549955,1308549955,1,2,0
31174848@N00,1256,46,1308638796,1308638796,1,1,0
31174848@N00,1257,31,1308891701,1308891701,1,2,0
31174848@N00,1257,75,1308884745,1308884745,1,2,0
31174848@N00,1258,11,1308973227,1308973227,1,1,0
31174848@N00,1259,11,1340097203,1340097203,1,2,0
31174848@N00,1259,31,1340093341,1340093341,1,2,0
31331368@N00,1260,17,1336253458,1336253458,1,1,0
31331368@N00,1261,40,1347026400,1347026400,1,1,0
31331368@N00,1262,85,1347631200,1347631200,1,1,0
31400835@N03,1263,31,1372124307,1372129948,10,1,5641
31404528@N02,1264,23,1392491181,1392491181,1,2,0
31404528@N02,1264,82,1392490217,1392490217,1,2,0
31404528@N02,1265,32,1392838728,1392838935,2,4,207
31404528@N02,1265,46,1392837601,1392838478,3,4,877
31404528@N02,1265,71,1392837762,1392838030,4,4,268
31404528@N02,1265,82,1392839034,1392839034,1,4,0
31418217@N03,1266,32,1300297416,1300297416,1,1,0
31418217@N03,1267,32,1300809310,1300812517,3,1,3207
31691278@N00,1268,51,1357177739,1357178009,2,2,270
31691278@N00,1268,72,1357175592,1357175592,1,2,0
31691278@N00,1269,45,1357292373,1357293941,3,2,1568
31691278@N00,1269,48,1357263972,1357271529,4,2,7557
31699508@N04,1270,85,1271540759,1271540759,1,1,0
31699508@N04,1271,85,1285305507,1285305507,1,1,0
31813931@N03,1272,50,1327436435,1327436435,1,2,0
31813931@N03,1272,71,1327436646,1327436646,1,2,0
31975807@N06,1273,45,1237533548,1237533548,1,1,0
32165728@N00,1274,10,1117859332,1117859332,1,1,0
32165728@N00,1275,10,1117951790,1117952125,2,1,335
32165728@N00,1276,48,1120260941,1120260941,1,1,0
32165728@N00,1277,10,1152462577,1152462577,1,4,0
32165728@N00,1277,55,1152460689,1152462573,3,4,1884
32165728@N00,1277,60,1152460619,1152460619,1,4,0
32165728@N00,1277,69,1152460741,1152460741,1,4,0
32165728@N00,1278,1,1156653050,1156654000,5,1,950
32165728@N00,1279,1,1156683033,1156683033,1,1,0
32165728@N00,1280,70,1161051456,1161051456,1,1,0
32165728@N00,1281,80,1196844171,1196860483,2,1,16312
32165728@N00,1282,57,1199193257,1199193257,1,1,0
32394656@N00,1283,68,1325092071,1325092071,1,1,0
32394656@N00,1284,17,1325158467,1325165030,4,3,6563
32394656@N00,1284,36,1325167813,1325167813,1,3,0
32394656@N00,1284,71,1325160745,1325160745,1,3,0
32394656@N00,1285,13,1325238836,1325238836,1,2,0
32394656@N00,1285,17,1325232778,1325239125,3,2,6347
32446767@N03,1286,44,1277183636,1277183636,1,3,0
32446767@N03,1286,45,1277186733,1277186780,4,3,47
32446767@N03,1286,82,1277182405,1277182405,1,3,0
32446767@N03,1287,48,1294017740,1294017740,1,1,0
32515931@N00,1288,2,1163855038,1163857532,5,1,2494
32515931@N00,1289,2,1171031919,1171034700,8,1,2781
32554587@N00,1290,70,1220729357,1220729357,1,1,0
32629603@N00,1291,57,1285988709,1286005292,21,1,16583
32629603@N00,1292,18,1299113768,1299114334,3,1,566
32629603@N00,1293,18,1301263420,1301263690,2,1,270
32629603@N00,1294,18,1301535144,1301535754,2,1,610
32629603@N00,1295,24,1302045616,1302045616,1,1,0
32629603@N00,1296,18,1302146588,1302146588,1,1,0
32629603@N00,1297,18,1302740810,1302754786,8,1,13976
32701432@N05,1298,32,1365726381,1365726381,1,1,0
32859340@N00,1299,84,1211600081,1211600081,1,1,0
32863757@N03,1300,8,1308463260,1308463260,1,1,0
32863757@N03,1301,45,1311320238,1311320238,1,1,0
32863757@N03,1302,80,1311931467,1311931467,1,1,0
32863757@N03,1303,44,1343438263,1343438263,1,1,0
32863757@N03,1304,35,1355910647,1355910647,1,1,0
32911813@N00,1305,45,1183862766,1183862766,1,1,0
32911813@N00,1306,45,1188358974,1188358974,1,1,0
32911813@N00,1307,45,1286412956,1286412956,1,1,0
32911813@N00,1308,57,1388014019,1388036666,4,1,22647
32967799@N02,1309,71,1360906278,1360906428,3,1,150
32974871@N00,1310,49,1217708287,1217710251,4,1,1964
33060808@N05,1311,41,1228610093,1228610093,1,2,0
33060808@N05,1311,45,1228613386,1228613588,4,2,202
33060808@N05,1312,84,1260404753,1260404753,1,1,0
33062815@N00,1313,11,1364686160,1364686813,2,2,653
33062815@N00,1313,71,1364690393,1364696321,4,2,5928
33062815@N00,1314,52,1392446284,1392446284,1,1,0
33062815@N00,1315,13,1392518800,1392518800,1,4,0
33062815@N00,1315,27,1392502458,1392502458,1,4,0
33062815@N00,1315,35,1392510233,1392510233,1,4,0
33062815@N00,1315,82,1392507527,1392507527,1,4,0
33062815@N00,1316,31,1392601022,1392601076,2,1,54
33195950@N00,1317,84,1346227443,1346227443,1,1,0
33195950@N00,1318,0,1379468280,1379468280,1,12,0
33195950@N00,1318,16,1379463181,1379463319,2,12,138
33195950@N00,1318,19,1379415804,1379487334,6,12,71530
33195950@N00,1318,21,1379462743,1379462934,2,12,191
33195950@N00,1318,35,1379466559,1379466609,2,12,50
33195950@N00,1318,41,1379465883,1379465883,1,12,0
33195950@N00,1318,44,1379468172,1379468172,1,12,0
33195950@N00,1318,70,1379466786,1379466786,1,12,0
33195950@N00,1318,71,1379466865,1379467968,5,12,1103
33195950@N00,1318,74,1379469846,1379469846,1,12,0
33195950@N00,1318,81,1379468036,1379468049,2,12,13
33195950@N00,1318,84,1379463581,1379464952,3,12,1371
33195950@N00,1319,19,1379527916,1379527916,1,1,0
33200530@N04,1320,9,1376192720,1376192720,1,7,0
33200530@N04,1320,17,1376191086,1376192239,4,7,1153
33200530@N04,1320,18,1376187494,1376187494,1,7,0
33200530@N04,1320,35,1376187365,1376188464,9,7,1099
33200530@N04,1320,44,1376189518,1376190563,7,7,1045
33200530@N04,1320,71,1376185614,1376189125,5,7,3511
33200530@N04,1320,81,1376189253,1376189253,1,7,0
33200530@N04,1321,11,1376360994,1376362335,3,1,1341
33422296@N00,1322,22,1312002368,1312002368,1,1,0
33593406@N03,1323,27,1391420351,1391420351,1,2,0
33593406@N03,1323,41,1391416926,1391416926,1,2,0
33593406@N03,1324,70,1391559177,1391559177,1,1,0
33593406@N03,1325,31,1391590482,1391590482,1,1,0
33732173@N00,1326,50,1320906131,1320906263,4,1,132
33732173@N00,1327,7,1338942434,1338942434,1,1,0
33739230@N02,1328,0,1363947880,1363947880,1,1,0
33739230@N02,1329,28,1364013085,1364013085,1,1,0
33748343@N00,1330,21,1241641855,1241642705,3,1,850
33898753@N00,1331,14,1327372216,1327372216,1,1,0
33898753@N00,1332,14,1382853794,1382853794,1,1,0
33917831@N00,1333,82,1141478926,1141478926,1,1,0
33917831@N00,1334,32,1141541160,1141542805,6,2,1645
33917831@N00,1334,71,1141522225,1141539506,8,2,17281
33917831@N00,1335,39,1145174921,1145177730,4,2,2809
33917831@N00,1335,51,1145176469,1145177500,3,2,1031
33917831@N00,1336,1,1146640452,1146640934,6,2,482
33917831@N00,1336,85,1146642145,1146642145,1,2,0
33975030@N00,1337,81,1231189705,1231189705,1,1,0
33975030@N00,1338,45,1231686860,1231686860,1,1,0
34094515@N00,1339,35,1244359464,1244359464,1,1,0
34120957@N04,1340,82,1189144458,1189144458,1,1,0
34120957@N04,1341,82,1189177773,1189177773,1,1,0
34342620@N06,1342,81,1331283584,1331283584,1,2,0
34342620@N06,1342,82,1331282146,1331282146,1,2,0
34397166@N00,1343,26,1361055973,1361055973,1,1,0
34397166@N00,1344,32,1365205663,1365205663,1,1,0
34397166@N00,1345,48,1368334523,1368334523,1,1,0
34397166@N00,1346,8,1372480372,1372480372,1,1,0
34397166@N00,1347,15,1377911067,1377911067,1,1,0
34397166@N00,1348,18,1378259291,1378259291,1,1,0
34397166@N00,1349,14,1378955426,1378955426,1,1,0
34397166@N00,1350,14,1379431673,1379431673,1,1,0
34397166@N00,1351,14,1382466716,1382466716,1,1,0
34397166@N00,1352,8,1383174093,1383174093,1,1,0
34397166@N00,1353,13,1385420398,1385420398,1,1,0
34397166@N00,1354,32,1388506023,1388506023,1,1,0
34397166@N00,1355,46,1389302730,1389302730,1,1,0
34397166@N00,1356,71,1393041405,1393041405,1,1,0
34397166@N00,1357,68,1393080508,1393080508,1,2,0
34397166@N00,1357,82,1393080434,1393080671,2,2,237
34397166@N00,1358,67,1394371323,1394371323,1,1,0
34397166@N00,1359,14,1396804476,1396804476,1,1,0
34516804@N04,1360,14,1263719981,1263720113,2,2,132
34516804@N04,1360,68,1263715965,1263715965,1,2,0
34516804@N04,1361,32,1268020672,1268020672,1,2,0
34516804@N04,1361,67,1268022065,1268022065,1,2,0
34516804@N04,1362,19,1268945213,1268945213,1,1,0
34516804@N04,1363,53,1269041323,1269041323,1,1,0
34516804@N04,1364,12,1269934658,1269934658,1,1,0
34516804@N04,1365,71,1270020465,1270020465,1,1,0
34516804@N04,1366,26,1272619407,1272630069,5,1,10662
34516804@N04,1367,50,1272776323,1272776323,1,1,0
34516804@N04,1368,35,1273696424,1273696424,1,1,0
34654604@N08,1369,34,1338957204,1338957204,1,1,0
34823318@N06,1370,30,949323600,949323600,1,1,0
34823318@N06,1371,7,1233141989,1233142072,2,1,83
34823318@N06,1372,7,1235613994,1235613994,1,1,0
34823318@N06,1373,7,1240279709,1240279709,1,1,0
34823318@N06,1374,7,1257460702,1257460702,1,1,0
34823318@N06,1375,7,1258769824,1258769824,1,1,0
34823318@N06,1376,7,1285816300,1285816300,1,1,0
34823318@N06,1377,7,1286503442,1286503442,1,1,0
34823318@N06,1378,7,1307673662,1307673662,1,1,0
34823318@N06,1379,7,1311165144,1311165144,1,1,0
34823318@N06,1380,0,1313056429,1313056746,2,1,317
34838158@N00,1381,31,1329527561,1329529219,7,1,1658
34923544@N00,1382,14,1367387670,1367387670,1,2,0
34923544@N00,1382,25,1367395039,1367395048,2,2,9
34933544@N00,1383,82,1342929747,1342929747,1,1,0
34948727@N00,1384,50,1154156213,1154156213,1,1,0
34948727@N00,1385,18,1154755544,1154755544,1,1,0
34948727@N00,1386,4,1169767808,1169767808,1,5,0
34948727@N00,1386,31,1169774731,1169774731,1,5,0
34948727@N00,1386,44,1169774522,1169774522,1,5,0
34948727@N00,1386,71,1169769741,1169769780,2,5,39
34948727@N00,1386,81,1169774376,1169774376,1,5,0
34948727@N00,1387,9,1171594777,1171594846,3,1,69
34948727@N00,1388,18,1172365200,1172365200,1,1,0
34948727@N00,1389,82,1174419089,1174419129,2,1,40
34948727@N00,1390,9,1180835659,1180835659,1,1,0
34948727@N00,1391,9,1181442927,1181442927,1,1,0
34948727@N00,1392,35,1183261982,1183262165,2,1,183
34948727@N00,1393,71,1197611602,1197611602,1,1,0
34948727@N00,1394,9,1214100944,1214100944,1,1,0
34948727@N00,1395,12,1256458486,1256458486,1,1,0
34948727@N00,1396,20,1295418939,1295418939,1,1,0
34948727@N00,1397,9,1310799721,1310800457,3,5,736
34948727@N00,1397,15,1310803843,1310803843,1,5,0
34948727@N00,1397,32,1310800701,1310803544,2,5,2843
34948727@N00,1397,50,1310805417,1310805417,1,5,0
34948727@N00,1397,68,1310806520,1310806568,2,5,48
34948727@N00,1398,20,1312608069,1312608069,1,1,0
34948727@N00,1399,20,1315709017,1315709017,1,1,0
34948727@N00,1400,44,1316166768,1316166768,1,1,0
34948727@N00,1401,24,1316242052,1316242052,1,1,0
34948727@N00,1402,17,1318113422,1318113422,1,1,0
34948727@N00,1403,20,1319244324,1319244324,1,1,0
34948727@N00,1404,20,1320623104,1320623104,1,1,0
34948727@N00,1405,20,1321667193,1321668314,2,1,1121
34948727@N00,1406,20,1325301096,1325301096,1,1,0
34948727@N00,1407,20,1327535737,1327535737,1,1,0
34948727@N00,1408,20,1328313435,1328313435,1,1,0
34948727@N00,1409,20,1329015017,1329015017,1,1,0
34948727@N00,1410,4,1330216109,1330216109,1,2,0
34948727@N00,1410,20,1330210913,1330210913,1,2,0
34948727@N00,1411,20,1331336661,1331336661,1,1,0
34948727@N00,1412,20,1331420552,1331420552,1,1,0
34948727@N00,1413,20,1332115658,1332115658,1,1,0
34948727@N00,1414,20,1336441189,1336441189,1,1,0
34948727@N00,1415,20,1337391736,1337392487,2,1,751
34948727@N00,1416,32,1337495286,1337495286,1,1,0
34948727@N00,1417,20,1339810810,1339810810,1,1,0
34948727@N00,1418,20,1340946988,1340946988,1,1,0
34948727@N00,1419,20,1341714785,1341714785,1,1,0
34948727@N00,1420,31,1341795887,1341796567,3,1,680
34948727@N00,1421,22,1342071920,1342071920,1,1,0
34948727@N00,1422,20,1342229778,1342229778,1,1,0
34948727@N00,1423,32,1342313640,1342313640,1,1,0
34948727@N00,1424,20,1342838743,1342838743,1,1,0
34948727@N00,1425,20,1343437878,1343437878,1,1,0
34948727@N00,1426,3,1343522426,1343522426,1,1,0
34948727@N00,1427,20,1343963658,1343963658,1,1,0
34948727@N00,1428,71,1344213542,1344213542,1,1,0
34948727@N00,1429,20,1344651294,1344651294,1,1,0
34948727@N00,1430,20,1345799631,1345799631,1,1,0
34948727@N00,1431,20,1345941398,1345941398,1,1,0
34948727@N00,1432,20,1346463225,1346463225,1,1,0
34948727@N00,1433,12,1347148854,1347148854,1,1,0
34948727@N00,1434,20,1347762425,1347762425,1,1,0
34948727@N00,1435,20,1347933436,1347933436,1,1,0
34948727@N00,1436,31,1350695540,1350696768,2,1,1228
34948727@N00,1437,20,1350772059,1350791706,2,1,19647
34948727@N00,1438,20,1351906953,1351906979,2,1,26
34948727@N00,1439,20,1351985579,1351985579,1,1,0
34948727@N00,1440,20,1352157694,1352157694,1,1,0
34948727@N00,1441,20,1353109775,1353109775,1,1,0
34948727@N00,1442,31,1353879129,1353879129,1,1,0
34948727@N00,1443,20,1354334996,1354334996,1,1,0
34948727@N00,1444,20,1355532212,1355532212,1,1,0
34948727@N00,1445,20,1356136175,1356136175,1,1,0
34948727@N00,1446,20,1357953594,1357953594,1,1,0
34948727@N00,1447,20,1358033603,1358033603,1,1,0
34948727@N00,1448,19,1358559538,1358572376,2,1,12838
34948727@N00,1449,20,1360978003,1360978003,1,1,0
34948727@N00,1450,20,1361580130,1361580130,1,1,0
34948727@N00,1451,20,1362555481,1362555537,2,1,56
34948727@N00,1452,20,1362790533,1362790579,2,1,46
34948727@N00,1453,20,1363397831,1363398320,3,1,489
34948727@N00,1454,20,1364605974,1364605974,1,1,0
34948727@N00,1455,20,1365211688,1365211688,1,1,0
34948727@N00,1456,10,1367656392,1367656392,1,1,0
34948727@N00,1457,16,1370663536,1370663536,1,1,0
34948727@N00,1458,16,1376274692,1376274692,1,1,0
34948727@N00,1459,20,1378534255,1378534255,1,1,0
34948727@N00,1460,20,1380951902,1380951902,1,1,0
34948727@N00,1461,82,1385455971,1385455971,1,1,0
34948727@N00,1462,20,1388184575,1388184575,1,1,0
34948727@N00,1463,20,1389422253,1389422294,2,1,41
34948727@N00,1464,20,1390698896,1390698896,1,1,0
34948727@N00,1465,20,1391302967,1391302967,1,1,0
34948727@N00,1466,20,1394246832,1394246832,1,1,0
34948727@N00,1467,10,1394927901,1394927901,1,1,0
34948727@N00,1468,10,1398559448,1398559448,1,1,0
34974864@N00,1469,49,1174282939,1174282939,1,1,0
35034356424@N01,1470,71,1158128771,1158128771,1,1,0
35034356424@N01,1471,71,1158219179,1158229844,18,1,10665
35173917@N05,1472,85,1326521224,1326526644,2,1,5420
35173917@N05,1473,85,1326598507,1326598507,1,1,0
35314767@N00,1474,71,1351047548,1351047548,1,1,0
35314767@N00,1475,78,1363293622,1363293622,1,1,0
35373460@N05,1476,22,1312714101,1312714101,1,1,0
35468141938@N01,1477,8,1314107782,1314107782,1,5,0
35468141938@N01,1477,20,1314139442,1314139442,1,5,0
35468141938@N01,1477,23,1314108495,1314108495,1,5,0
35468141938@N01,1477,31,1314110666,1314121073,3,5,10407
35468141938@N01,1477,71,1314098510,1314106161,3,5,7651
35468141938@N01,1478,20,1314178341,1314178341,1,1,0
35468141938@N01,1479,11,1314290552,1314290552,1,1,0
35468143526@N01,1480,57,1334337746,1334337746,1,1,0
35468143526@N01,1481,57,1344710763,1344710763,1,1,0
35468151759@N01,1482,27,1137116842,1137116842,1,1,0
35468151759@N01,1483,71,1137203139,1137203139,1,1,0
35473829@N07,1484,32,1363310283,1363310283,1,2,0
35473829@N07,1484,71,1363310117,1363310423,2,2,306
35473829@N07,1485,31,1363397886,1363398628,3,1,742
35473829@N07,1486,48,1363490749,1363490749,1,1,0
35558720@N03,1487,25,1364043600,1364043769,170,1,169
35574630@N00,1488,19,1300403731,1300403731,1,1,0
35578740@N00,1489,41,1354077619,1354078023,2,1,404
35578740@N00,1490,40,1357612845,1357612845,1,1,0
35578740@N00,1491,48,1360623510,1360623510,1,2,0
35578740@N00,1491,69,1360637910,1360637910,1,2,0
35578740@N00,1492,11,1361327980,1361327980,1,1,0
35578740@N00,1493,1,1364092290,1364092290,1,1,0
35578740@N00,1494,48,1368428174,1368428174,1,1,0
35578740@N00,1495,2,1371206548,1371206548,1,1,0
35578740@N00,1496,48,1371781355,1371781355,1,1,0
35578740@N00,1497,48,1376002322,1376002322,1,1,0
35597024@N08,1498,45,1160064665,1160064665,1,1,0
35945984@N00,1499,82,1142210974,1142210974,1,1,0
35945984@N00,1500,34,1168741580,1168741580,1,2,0
35945984@N00,1500,74,1168742545,1168742895,6,2,350
35945984@N00,1501,71,1173396387,1173396387,1,1,0
35945984@N00,1502,71,1178878597,1178878707,3,1,110
35945984@N00,1503,71,1178926749,1178935841,2,1,9092
35945984@N00,1504,39,1195701956,1195701956,1,1,0
35945984@N00,1505,71,1274957094,1274961492,4,1,4398
35945984@N00,1506,71,1279684396,1279684499,8,1,103
35955268@N00,1507,21,1267222836,1267222836,1,1,0
35955268@N00,1508,15,1267308725,1267308725,1,1,0
36061217@N04,1509,48,1241406867,1241407353,3,1,486
36189428@N00,1510,16,1184733672,1184733672,1,1,0
36189428@N00,1511,21,1184902929,1184902929,1,1,0
36189428@N00,1512,71,1196327427,1196327427,1,1,0
36189428@N00,1513,36,1208264209,1208264209,1,1,0
36195531@N00,1514,2,1351150418,1351163067,2,2,12649
36195531@N00,1514,8,1351174827,1351174827,1,2,0
36236458@N00,1515,80,1162770862,1162770862,1,1,0
36330826404@N01,1516,71,1137593330,1137593330,1,1,0
36330826404@N01,1517,71,1141109597,1141109597,1,1,0
36330826404@N01,1518,86,1162794582,1162794582,1,1,0
36330826404@N01,1519,67,1163323406,1163324070,2,1,664
36330826404@N01,1520,71,1164198218,1164198529,3,1,311
36330826404@N01,1521,8,1165109238,1165111982,3,9,2744
36330826404@N01,1521,13,1165112082,1165112314,6,9,232
36330826404@N01,1521,15,1165108086,1165108086,1,9,0
36330826404@N01,1521,32,1165109555,1165110120,4,9,565
36330826404@N01,1521,50,1165107038,1165113267,3,9,6229
36330826404@N01,1521,51,1165136623,1165138274,9,9,1651
36330826404@N01,1521,70,1165112829,1165113094,2,9,265
36330826404@N01,1521,71,1165105799,1165106083,5,9,284
36330826404@N01,1521,82,1165107759,1165107759,1,9,0
36330826404@N01,1522,2,1166319816,1166319816,1,7,0
36330826404@N01,1522,9,1166319265,1166319360,2,7,95
36330826404@N01,1522,27,1166344746,1166344746,1,7,0
36330826404@N01,1522,32,1166318979,1166318979,1,7,0
36330826404@N01,1522,63,1166342283,1166342283,1,7,0
36330826404@N01,1522,68,1166342706,1166343000,5,7,294
36330826404@N01,1522,81,1166343417,1166343417,1,7,0
36330826404@N01,1523,49,1167812044,1167815237,12,1,3193
36330826404@N01,1524,86,1168474656,1168474862,4,1,206
36330826404@N01,1525,48,1169782359,1169788758,42,1,6399
36330826404@N01,1526,20,1196220946,1196220946,1,1,0
36330826404@N01,1527,48,1232701803,1232701803,1,1,0
36330826404@N01,1528,82,1323749905,1323749905,1,1,0
36368503@N00,1529,19,1292006763,1292006763,1,2,0
36368503@N00,1529,71,1292027625,1292050105,2,2,22480
36368503@N00,1530,32,1292280996,1292280996,1,2,0
36368503@N00,1530,71,1292268234,1292295570,2,2,27336
36368503@N00,1531,8,1292555606,1292555606,1,2,0
36368503@N00,1531,71,1292539886,1292539886,1,2,0
36368503@N00,1532,19,1292820340,1292820340,1,1,0
36368503@N00,1533,71,1293126390,1293126390,1,1,0
36368503@N00,1534,71,1293753126,1293753126,1,1,0
36368503@N00,1535,63,1295337623,1295337623,1,1,0
36368503@N00,1536,63,1295605924,1295606617,2,1,693
36368503@N00,1537,6,1296612084,1296612084,1,1,0
36368503@N00,1538,6,1296942013,1296942013,1,1,0
36368503@N00,1539,71,1297379203,1297379203,1,1,0
36368503@N00,1540,6,1297454848,1297454848,1,1,0
36368503@N00,1541,15,1297898389,1297898389,1,1,0
36368503@N00,1542,82,1298241703,1298241703,1,1,0
36368503@N00,1543,39,1298422871,1298422871,1,1,0
36368503@N00,1544,19,1299814028,1299814028,1,1,0
36368503@N00,1545,63,1299887680,1299887680,1,1,0
36368503@N00,1546,71,1300056277,1300056277,1,1,0
36368503@N00,1547,40,1300343148,1300343148,1,1,0
36368503@N00,1548,15,1302513894,1302513894,1,1,0
36368503@N00,1549,0,1303092235,1303092235,1,1,0
36368503@N00,1550,71,1303535000,1303535000,1,1,0
36368503@N00,1551,32,1304903388,1304903388,1,1,0
36368503@N00,1552,31,1305347607,1305347607,1,1,0
36368503@N00,1553,22,1326089362,1326089362,1,1,0
36368503@N00,1554,35,1331119529,1331119529,1,1,0
36368503@N00,1555,71,1339056419,1339056419,1,1,0
36368503@N00,1556,71,1347009917,1347009917,1,1,0
36368503@N00,1557,55,1347244206,1347244206,1,1,0
36368503@N00,1558,35,1351147131,1351147131,1,1,0
36368503@N00,1559,32,1357860897,1357860897,1,1,0
36368503@N00,1560,63,1359179459,1359179459,1,1,0
36398523@N00,1561,28,1249037879,1249052074,4,1,14195
36424619@N00,1562,41,1176901985,1176901999,2,4,14
36424619@N00,1562,50,1176873442,1176873442,1,4,0
36424619@N00,1562,62,1176874640,1176874640,1,4,0
36424619@N00,1562,76,1176877125,1176877265,3,4,140
36521966482@N01,1563,27,1093754825,1093754825,1,3,0
36521966482@N01,1563,71,1093758183,1093758183,1,3,0
36521966482@N01,1563,82,1093767449,1093767449,1,3,0
36521966482@N01,1564,82,1130131768,1130135829,2,1,4061
36521966482@N01,1565,26,1130311723,1130311723,1,3,0
36521966482@N01,1565,45,1130317891,1130317891,1,3,0
36521966482@N01,1565,81,1130316246,1130316839,4,3,593
36521966482@N01,1566,56,1130486219,1130486219,1,2,0
36521966482@N01,1566,62,1130489699,1130498647,2,2,8948
36521966482@N01,1567,1,1235804057,1235804057,1,1,0
36521967117@N01,1568,12,1271218293,1271218293,1,1,0
36582935@N00,1569,49,1177451259,1177472698,7,1,21439
36656940@N00,1570,24,1104632251,1104632557,5,1,306
36656940@N00,1571,22,1142044889,1142044889,1,1,0
36656940@N00,1572,77,1148627368,1148627368,1,1,0
36656940@N00,1573,1,1149398428,1149398428,1,1,0
36656940@N00,1574,77,1149929455,1149929455,1,1,0
36656940@N00,1575,35,1150079579,1150079827,4,2,248
36656940@N00,1575,71,1150076863,1150076863,1,2,0
36656940@N00,1576,32,1154317992,1154317992,1,1,0
36656940@N00,1577,21,1157780021,1157780021,1,1,0
36656940@N00,1578,84,1173391824,1173391824,1,1,0
36656940@N00,1579,84,1174383808,1174383808,1,1,0
36656940@N00,1580,26,1175824984,1175828834,2,1,3850
36656940@N00,1581,65,1181643317,1181643317,1,1,0
36656940@N00,1582,84,1183259086,1183259086,1,1,0
36656940@N00,1583,18,1190523536,1190523536,1,3,0
36656940@N00,1583,32,1190527880,1190527880,1,3,0
36656940@N00,1583,35,1190523687,1190523899,2,3,212
36656940@N00,1584,21,1196839865,1196839865,1,1,0
36656940@N00,1585,32,1198120364,1198120364,1,1,0
36656940@N00,1586,23,1200195940,1200195940,1,1,0
36656940@N00,1587,49,1206153614,1206155232,5,1,1618
36656940@N00,1588,15,1206828184,1206828189,2,1,5
36656940@N00,1589,9,1208061498,1208061498,1,2,0
36656940@N00,1589,41,1208056257,1208056257,1,2,0
36656940@N00,1590,7,1208995984,1208995984,1,1,0
36656940@N00,1591,3,1215743284,1215743284,1,1,0
36656940@N00,1592,11,1223698459,1223698459,1,1,0
36656940@N00,1593,16,1226114363,1226114363,1,4,0
36656940@N00,1593,32,1226118889,1226118889,1,4,0
36656940@N00,1593,35,1226118098,1226118098,1,4,0
36656940@N00,1593,84,1226114614,1226114663,2,4,49
36656940@N00,1594,71,1243675186,1243675186,1,1,0
36656940@N00,1595,56,1258700513,1258702353,5,1,1840
36656940@N00,1596,50,1258856636,1258856668,2,1,32
36656940@N00,1597,21,1284086731,1284086731,1,1,0
36656940@N00,1598,71,1285389783,1285394775,6,1,4992
36656940@N00,1599,27,1298686405,1298686405,1,1,0
36656940@N00,1600,18,1381633433,1381633433,1,1,0
36692429@N00,1601,49,1209237321,1209237321,1,2,0
36692429@N00,1601,71,1209218773,1209224115,2,2,5342
36713728@N08,1602,14,1315141535,1315141535,1,1,0
36713728@N08,1603,14,1315245447,1315245447,1,1,0
36760290@N08,1604,25,1341136729,1341136729,1,1,0
36760290@N08,1605,23,1341214283,1341214283,1,2,0
36760290@N08,1605,50,1341214092,1341214092,1,2,0
36760290@N08,1606,19,1343256595,1343256595,1,1,0
36959804@N02,1607,20,1314345877,1314345877,1,1,0
37069385@N00,1608,77,1305107835,1305107835,1,1,0
37069385@N00,1609,7,1338950982,1338951033,2,1,51
37069385@N00,1610,14,1350294948,1350294948,1,1,0
37069385@N00,1611,32,1351313164,1351313164,1,1,0
37069385@N00,1612,7,1361750012,1361750012,1,1,0
37069385@N00,1613,77,1380701786,1380701809,2,1,23
37069385@N00,1614,77,1380873028,1380873028,1,1,0
37069385@N00,1615,77,1381389128,1381389128,1,1,0
37069385@N00,1616,77,1381475444,1381475444,1,1,0
37069385@N00,1617,77,1381560111,1381560111,1,1,0
37069385@N00,1618,77,1381906978,1381906978,1,1,0
37069385@N00,1619,77,1382168557,1382168557,1,1,0
37069385@N00,1620,77,1382767984,1382767984,1,1,0
37069385@N00,1621,77,1382855914,1382855914,1,1,0
37069385@N00,1622,77,1383112850,1383112850,1,1,0
37069385@N00,1623,77,1383199452,1383199452,1,1,0
37069385@N00,1624,77,1383384411,1383384411,1,1,0
37069385@N00,1625,16,1383463833,1383463833,1,2,0
37069385@N00,1625,77,1383460154,1383460154,1,2,0
37069385@N00,1626,77,1383545598,1383545598,1,1,0
37069385@N00,1627,77,1383632001,1383632001,1,1,0
37069385@N00,1628,77,1383720224,1383720439,2,1,215
37069385@N00,1629,77,1383886904,1383887093,2,1,189
37069385@N00,1630,77,1384500073,1384500073,1,1,0
37069385@N00,1631,77,1384585371,1384585371,1,1,0
37069385@N00,1632,77,1384841870,1384841870,1,1,0
37069385@N00,1633,77,1385537741,1385537741,1,1,0
37069385@N00,1634,77,1385626001,1385626001,1,1,0
37069385@N00,1635,77,1386141458,1386141458,1,1,0
37069385@N00,1636,77,1386309743,1386309743,1,1,0
37069385@N00,1637,77,1386397798,1386397976,2,1,178
37069385@N00,1638,77,1386570035,1386570035,1,1,0
37069385@N00,1639,77,1386744937,1386744937,1,1,0
37069385@N00,1640,77,1386830849,1386830849,1,1,0
37069385@N00,1641,77,1387174705,1387174705,1,1,0
37069385@N00,1642,77,1387261031,1387261031,1,1,0
37069385@N00,1643,77,1387779039,1387779039,1,1,0
37069385@N00,1644,77,1387855931,1387855931,1,1,0
37069385@N00,1645,77,1388141374,1388141374,1,1,0
37069385@N00,1646,77,1388468902,1388468902,1,1,0
37069385@N00,1647,77,1388730531,1388730531,1,1,0
37069385@N00,1648,77,1389071733,1389071733,1,1,0
37069385@N00,1649,77,1389153094,1389153094,1,1,0
37069385@N00,1650,77,1389345753,1389345753,1,1,0
37069385@N00,1651,77,1389518016,1389518016,1,1,0
37069385@N00,1652,77,1389561016,1389561016,1,1,0
37069385@N00,1653,77,1389732825,1389732825,1,1,0
37069385@N00,1654,77,1390209779,1390209779,1,1,0
37069385@N00,1655,77,1390376489,1390376489,1,1,0
37069385@N00,1656,77,1390476701,1390476701,1,2,0
37069385@N00,1656,84,1390472323,1390472323,1,2,0
37069385@N00,1657,77,1390639861,1390639861,1,1,0
37069385@N00,1658,77,1390902631,1390902631,1,1,0
37069385@N00,1659,77,1391073403,1391073462,2,1,59
37069385@N00,1660,77,1391506020,1391506020,1,1,0
37069385@N00,1661,77,1393406924,1393406924,1,1,0
37069385@N00,1662,77,1393576660,1393576660,1,1,0
37069385@N00,1663,77,1393925483,1393925483,1,1,0
37069385@N00,1664,77,1394094617,1394094617,1,1,0
37069385@N00,1665,77,1394174796,1394174796,1,1,0
37069385@N00,1666,77,1394443911,1394443911,1,1,0
37069385@N00,1667,77,1394526878,1394526878,1,1,0
37069385@N00,1668,77,1394612571,1394612571,1,1,0
37069385@N00,1669,77,1394794914,1394794914,1,1,0
37069385@N00,1670,77,1394948390,1394948390,1,1,0
37069385@N00,1671,77,1396088619,1396088619,1,1,0
37069385@N00,1672,77,1396595271,1396595271,1,1,0
37069385@N00,1673,77,1397113676,1397113676,1,1,0
37069385@N00,1674,77,1397281083,1397281083,1,1,0
37069385@N00,1675,77,1397369406,1397369406,2,1,0
37069385@N00,1676,77,1397981250,1397981250,1,1,0
37086457@N00,1677,2,1332752131,1332752131,1,3,0
37086457@N00,1677,50,1332728230,1332728377,2,3,147
37086457@N00,1677,71,1332735051,1332735051,1,3,0
37086457@N00,1678,3,1332813783,1332813783,1,1,0
37103729@N02,1679,23,1345254555,1345263085,3,5,8530
37103729@N02,1679,32,1345260634,1345262478,3,5,1844
37103729@N02,1679,35,1345263976,1345264280,4,5,304
37103729@N02,1679,50,1345267221,1345269021,7,5,1800
37103729@N02,1679,70,1345268706,1345268706,1,5,0
37103729@N02,1680,27,1345337713,1345337713,1,1,0
37202464@N04,1681,1,1238369929,1238369929,1,1,0
37202464@N04,1682,49,1256954900,1256955601,2,1,701
37202464@N04,1683,41,1327701858,1327706766,2,2,4908
37202464@N04,1683,86,1327690144,1327690215,2,2,71
37202464@N04,1684,26,1380195028,1380195028,1,1,0
37468950@N08,1685,1,1166755008,1166755139,2,14,131
37468950@N08,1685,8,1166740217,1166740273,2,14,56
37468950@N08,1685,13,1166739479,1166739505,2,14,26
37468950@N08,1685,14,1166740425,1166741293,5,14,868
37468950@N08,1685,17,1166739593,1166739593,1,14,0
37468950@N08,1685,25,1166758343,1166760667,4,14,2324
37468950@N08,1685,27,1166757747,1166757796,2,14,49
37468950@N08,1685,35,1166738783,1166738783,1,14,0
37468950@N08,1685,39,1166743597,1166743986,2,14,389
37468950@N08,1685,51,1166742287,1166743113,8,14,826
37468950@N08,1685,57,1166745769,1166745769,1,14,0
37468950@N08,1685,71,1166763585,1166763711,4,14,126
37468950@N08,1685,78,1166745110,1166745110,1,14,0
37468950@N08,1685,85,1166747667,1166748004,2,14,337
37468950@N08,1686,9,1166835132,1166835132,1,7,0
37468950@N08,1686,22,1166834683,1166834989,3,7,306
37468950@N08,1686,41,1166832903,1166832903,1,7,0
37468950@N08,1686,49,1166849373,1166849941,2,7,568
37468950@N08,1686,67,1166853706,1166853794,2,7,88
37468950@N08,1686,81,1166853966,1166853988,2,7,22
37468950@N08,1686,84,1166831939,1166832244,3,7,305
37532348@N02,1687,85,1341742182,1341742182,1,1,0
37540231@N03,1688,15,1343341691,1343341691,1,1,0
37545627@N06,1689,22,1302920586,1302920586,1,1,0
37569287@N00,1690,9,1205896800,1205896800,1,1,0
37647589@N00,1691,63,1386852518,1386852518,1,1,0
37703201@N00,1692,49,1357432646,1357432745,2,1,99
37703201@N00,1693,63,1358408962,1358410310,2,1,1348
37912374670@N01,1694,71,1034680650,1034682466,21,1,1816
37912374670@N01,1695,9,1116793061,1116793209,4,2,148
37912374670@N01,1695,11,1116772476,1116772602,3,2,126
37912374670@N01,1696,9,1166485680,1166486207,2,1,527
37912374670@N01,1697,82,1166571883,1166572075,4,1,192
37912374670@N01,1698,11,1166738563,1166738563,1,1,0
37912374670@N01,1699,9,1166895978,1166896365,5,2,387
37912374670@N01,1699,24,1166893143,1166893143,1,2,0
37912374670@N01,1700,11,1167174288,1167174782,8,1,494
37912374670@N01,1701,71,1167435346,1167435759,4,2,413
37912374670@N01,1701,82,1167436222,1167436549,2,2,327
37912374670@N01,1702,70,1167777446,1167777470,2,1,24
37912374670@N01,1703,40,1167851992,1167851992,1,3,0
37912374670@N01,1703,50,1167870292,1167870292,1,3,0
37912374670@N01,1703,70,1167868034,1167868034,1,3,0
37912374670@N01,1704,2,1168023508,1168023508,1,2,0
37912374670@N01,1704,11,1168026016,1168026158,4,2,142
37912374670@N01,1705,82,1168280155,1168280155,1,1,0
37912374670@N01,1706,50,1233952078,1233952078,1,2,0
37912374670@N01,1706,71,1233951002,1233951354,2,2,352
37912374670@N01,1707,11,1295684155,1295684155,1,1,0
37912374670@N01,1708,9,1295774859,1295774859,1,1,0
37950797@N03,1709,8,1356052932,1356060595,42,1,7663
37956197@N00,1710,32,1185672822,1185672822,1,1,0
37956197@N00,1711,26,1187583788,1187583788,1,1,0
37956197@N00,1712,25,1188094030,1188094048,4,1,18
37996586683@N01,1713,31,1381143910,1381143910,1,1,0
38028368@N00,1714,32,1313800430,1313800430,1,1,0
38028368@N00,1715,15,1313879458,1313879458,1,1,0
38028368@N00,1716,35,1321861449,1321861449,1,2,0
38028368@N00,1716,46,1321868581,1321868581,1,2,0
38028368@N00,1717,58,1363482329,1363509636,2,1,27307
38028368@N00,1718,81,1372231060,1372231060,1,1,0
38173835@N08,1719,27,1253505556,1253505556,1,1,0
38228574@N00,1720,15,1260146377,1260146377,1,1,0
38331851@N00,1721,48,1391022190,1391022419,2,1,229
38331851@N00,1722,48,1391061219,1391061219,1,1,0
38331851@N00,1723,48,1391134704,1391136653,5,1,1949
38331851@N00,1724,9,1391421044,1391421044,1,3,0
38331851@N00,1724,41,1391435028,1391435028,1,3,0
38331851@N00,1724,46,1391442808,1391442808,1,3,0
38331851@N00,1725,9,1391479375,1391505224,2,2,25849
38331851@N00,1725,46,1391496909,1391496909,1,2,0
38419041@N00,1726,57,1202607549,1202627493,60,1,19944
38419041@N00,1727,26,1205028085,1205030290,3,1,2205
38419041@N00,1728,57,1206044770,1206044770,1,1,0
38419041@N00,1729,57,1214712408,1214721779,4,1,9371
38419041@N00,1730,44,1221563973,1221563989,2,1,16
38419041@N00,1731,25,1224310979,1224320057,2,1,9078
38419041@N00,1732,33,1232933133,1232933586,7,1,453
38419041@N00,1733,57,1246681968,1246693371,39,1,11403
38419041@N00,1734,57,1247374753,1247384291,13,1,9538
38419041@N00,1735,57,1249187523,1249192835,12,1,5312
38419041@N00,1736,57,1250400535,1250405371,25,1,4836
38419041@N00,1737,57,1251610955,1251618480,21,1,7525
38419041@N00,1738,57,1276482671,1276493661,6,1,10990
38425817@N00,1739,10,1173060704,1173061393,3,2,689
38425817@N00,1739,39,1173066310,1173066431,3,2,121
38488245@N00,1740,31,1267685840,1267685840,1,1,0
38647896@N00,1741,4,1359602662,1359602662,1,1,0
38647896@N00,1742,4,1361838542,1361838542,1,1,0
38647896@N00,1743,24,1363844345,1363844345,1,1,0
38647896@N00,1744,4,1367298007,1367298065,2,1,58
38647896@N00,1745,4,1367464742,1367472809,2,1,8067
38647896@N00,1746,4,1367906901,1367906901,1,1,0
38647896@N00,1747,4,1368061469,1368061469,1,1,0
38647896@N00,1748,4,1368512990,1368512990,1,1,0
38647896@N00,1749,37,1369269031,1369269031,1,1,0
38647896@N00,1750,4,1369618567,1369628505,2,1,9938
38647896@N00,1751,4,1369892642,1369892642,1,1,0
38647896@N00,1752,4,1371002061,1371002061,1,1,0
38647896@N00,1753,4,1371794245,1371794245,2,1,0
38647896@N00,1754,4,1372132934,1372132945,3,1,11
38647896@N00,1755,4,1372466533,1372473855,9,1,7322
38647896@N00,1756,4,1372835305,1372835345,3,1,40
38647896@N00,1757,24,1372899424,1372912301,3,1,12877
38647896@N00,1758,4,1382500380,1382500400,3,1,20
38647896@N00,1759,4,1383792914,1383793092,10,1,178
38751621@N00,1760,50,1092285004,1092285004,1,2,0
38751621@N00,1760,82,1092285888,1092285888,1,2,0
38751621@N00,1761,50,1092375938,1092375938,1,2,0
38751621@N00,1761,51,1092370100,1092371334,8,2,1234
38751621@N00,1762,26,1092545018,1092545054,2,2,36
38751621@N00,1762,85,1092526529,1092526529,1,2,0
38795388@N06,1763,45,1347950089,1347950089,1,1,0
38919006@N00,1764,16,1211462189,1211462189,1,1,0
38919006@N00,1765,1,1234336120,1234336120,1,1,0
38919006@N00,1766,22,1234506346,1234516997,4,1,10651
38919006@N00,1767,17,1235776806,1235776806,1,1,0
39297387@N00,1768,26,1356860712,1356860774,2,1,62
39297387@N00,1769,25,1356952708,1356958902,2,4,6194
39297387@N00,1769,32,1356926258,1356926258,1,4,0
39297387@N00,1769,45,1356934776,1356934776,1,4,0
39297387@N00,1769,71,1356918838,1356918838,1,4,0
39297387@N00,1770,71,1357008619,1357021258,4,1,12639
39297387@N00,1771,40,1357102514,1357102514,1,2,0
39297387@N00,1771,49,1357090598,1357095449,3,2,4851
39297387@N00,1772,71,1357340495,1357348897,5,2,8402
39297387@N00,1772,81,1357340323,1357340323,1,2,0
39551170@N02,1773,15,1362468323,1362468323,1,1,0
39603449@N04,1774,85,1203660694,1203660946,2,1,252
39603449@N04,1775,68,1213705097,1213705186,2,1,89
39603449@N04,1776,85,1214447621,1214447621,1,1,0
39652830@N04,1777,22,1366967237,1366975908,16,1,8671
39652830@N04,1778,41,1367017309,1367044339,172,1,27030
39652830@N04,1779,41,1367107382,1367133710,102,1,26328
39916636@N00,1780,45,1159971660,1159971660,1,1,0
39916636@N00,1781,40,1163141791,1163141791,1,1,0
39916636@N00,1782,25,1164959977,1164960558,2,2,581
39916636@N00,1782,70,1164973720,1164973720,1,2,0
39916636@N00,1783,22,1165575581,1165586892,2,2,11311
39916636@N00,1783,70,1165580528,1165580528,1,2,0
39916636@N00,1784,22,1165919474,1165921070,2,1,1596
39916636@N00,1785,14,1166394717,1166394917,2,2,200
39916636@N00,1785,17,1166403481,1166403502,2,2,21
39916636@N00,1786,35,1166603981,1166604171,2,3,190
39916636@N00,1786,50,1166604632,1166604632,1,3,0
39916636@N00,1786,70,1166604391,1166604391,1,3,0
39916636@N00,1787,21,1166746238,1166746238,1,2,0
39916636@N00,1787,40,1166756914,1166756914,1,2,0
39916636@N00,1788,35,1167575605,1167575605,1,2,0
39916636@N00,1788,81,1167570107,1167570611,7,2,504
39916636@N00,1789,31,1168661016,1168661016,1,1,0
39916636@N00,1790,1,1169794582,1169794829,2,2,247
39916636@N00,1790,81,1169807165,1169807165,1,2,0
39916636@N00,1791,84,1183177314,1183177314,1,1,0
39916636@N00,1792,3,1184217141,1184217141,1,1,0
39916636@N00,1793,80,1184822309,1184822309,1,1,0
39916636@N00,1794,36,1185161291,1185161291,1,1,0
39916636@N00,1795,26,1185252761,1185252761,1,1,0
39916636@N00,1796,82,1185941912,1185941912,1,1,0
39916636@N00,1797,7,1186375140,1186375140,1,1,0
39916636@N00,1798,71,1189140507,1189141870,2,1,1363
39916636@N00,1799,32,1189222515,1189222593,2,1,78
39916636@N00,1800,21,1190954309,1190954309,1,1,0
39916636@N00,1801,49,1191212912,1191214377,2,2,1465
39916636@N00,1801,82,1191211554,1191211554,1,2,0
39916636@N00,1802,15,1191384907,1191385007,2,1,100
39916636@N00,1803,1,1217748095,1217748133,2,1,38
39916636@N00,1804,27,1218954752,1218954752,1,1,0
39916636@N00,1805,53,1323865595,1323865595,1,1,0
39916636@N00,1806,71,1324636220,1324636220,1,1,0
39916636@N00,1807,47,1365758481,1365758481,1,1,0
39916636@N00,1808,22,1367468178,1367468178,1,1,0
39916636@N00,1809,47,1382690785,1382690785,1,1,0
39916636@N00,1810,46,1391488337,1391488337,1,1,0
39932276@N00,1811,21,1298597059,1298597141,2,1,82
40082311@N00,1812,24,1147486708,1147514122,3,1,27414
40082311@N00,1813,45,1147954859,1147954859,1,1,0
40082311@N00,1814,85,1148025459,1148025459,1,1,0
40082311@N00,1815,85,1148083832,1148088293,2,1,4461
40082311@N00,1816,85,1148217118,1148217118,1,1,0
40082311@N00,1817,26,1154294430,1154294430,1,1,0
40082311@N00,1818,26,1154429676,1154429676,1,1,0
40082311@N00,1819,80,1159141547,1159141547,1,1,0
40082311@N00,1820,8,1162360849,1162360849,1,3,0
40082311@N00,1820,35,1162359770,1162360172,2,3,402
40082311@N00,1820,40,1162360448,1162360448,1,3,0
40082311@N00,1821,35,1163623451,1163623451,1,1,0
40082311@N00,1822,35,1163931730,1163931730,1,1,0
40082311@N00,1823,14,1164109950,1164109950,1,3,0
40082311@N00,1823,35,1164111206,1164112052,2,3,846
40082311@N00,1823,40,1164111576,1164111576,1,3,0
40082311@N00,1824,14,1164196856,1164197679,2,2,823
40082311@N00,1824,39,1164198102,1164198102,1,2,0
40082311@N00,1825,40,1164284185,1164285986,2,2,1801
40082311@N00,1825,70,1164285149,1164285149,1,2,0
40082311@N00,1826,35,1164574675,1164574675,1,3,0
40082311@N00,1826,39,1164575181,1164575181,1,3,0
40082311@N00,1826,40,1164575569,1164575966,2,3,397
40082311@N00,1827,2,1164627900,1164627900,1,5,0
40082311@N00,1827,14,1164628827,1164628827,1,5,0
40082311@N00,1827,35,1164628369,1164628369,1,5,0
40082311@N00,1827,39,1164627495,1164627495,1,5,0
40082311@N00,1827,40,1164626545,1164626545,1,5,0
40082311@N00,1828,4,1168388797,1168388805,2,1,8
40082311@N00,1829,85,1185353312,1185353312,1,1,0
40082311@N00,1830,85,1208956286,1208956286,1,1,0
40082311@N00,1831,14,1248817600,1248817600,1,1,0
40082311@N00,1832,46,1278644352,1278644352,1,1,0
40082311@N00,1833,2,1390210346,1390210346,1,1,0
40145535@N04,1834,84,1346329489,1346329489,1,1,0
40204125@N08,1835,33,1289117424,1289120170,18,2,2746
40204125@N08,1835,49,1289115876,1289116560,7,2,684
40204125@N08,1836,33,1289169675,1289186330,10,1,16655
40224013@N05,1837,69,1272684272,1272684272,1,1,0
40235190@N00,1838,5,1283811882,1283811882,1,1,0
40235190@N00,1839,57,1284801098,1284801098,1,1,0
40286466@N00,1840,50,1318049133,1318049133,1,1,0
40286466@N00,1841,85,1318596176,1318596176,1,1,0
40286466@N00,1842,49,1320956797,1320956797,1,1,0
40286466@N00,1843,4,1327735742,1327735742,1,2,0
40286466@N00,1843,22,1327732976,1327733212,2,2,236
40286466@N00,1844,14,1331103946,1331103946,1,1,0
40286466@N00,1845,13,1341372742,1341372742,1,1,0
40286466@N00,1846,40,1341893128,1341893128,1,1,0
40286466@N00,1847,9,1357449019,1357449019,1,1,0
40288584@N03,1848,70,1344830211,1344830324,2,1,113
40565107@N03,1849,72,1367415193,1367415193,1,1,0
40575018@N07,1850,8,1264562039,1264562039,1,1,0
40575018@N07,1851,17,1265271511,1265271511,1,1,0
40575018@N07,1852,8,1265335738,1265335738,1,1,0
40575018@N07,1853,14,1268825282,1268825282,1,1,0
40575018@N07,1854,13,1269735288,1269735288,1,3,0
40575018@N07,1854,50,1269735029,1269735029,1,3,0
40575018@N07,1854,70,1269734666,1269734666,1,3,0
40575018@N07,1855,72,1270178512,1270178512,1,1,0
40575018@N07,1856,18,1271024598,1271024598,1,1,0
40575018@N07,1857,8,1272927337,1272927581,2,1,244
40575018@N07,1858,8,1274611812,1274611812,1,1,0
40575018@N07,1859,14,1276830166,1276830166,1,1,0
40575018@N07,1860,82,1284200435,1284200435,1,1,0
40575018@N07,1861,18,1291676390,1291676390,1,1,0
40575018@N07,1862,14,1291933328,1291933328,1,1,0
40575018@N07,1863,85,1301997011,1301997011,1,1,0
40575018@N07,1864,53,1312634186,1312634186,1,1,0
40575018@N07,1865,51,1312933030,1312934670,5,1,1640
40575018@N07,1866,53,1313232996,1313232996,1,1,0
40575018@N07,1867,39,1315349206,1315349206,1,1,0
40575018@N07,1868,82,1315468091,1315468091,1,1,0
40575018@N07,1869,14,1318397064,1318397064,1,1,0
40575018@N07,1870,46,1322002667,1322003387,3,1,720
40575018@N07,1871,35,1323910189,1323910189,1,1,0
40575018@N07,1872,5,1325036225,1325036225,1,1,0
40575018@N07,1873,5,1325151335,1325151335,1,1,0
40575018@N07,1874,5,1325206946,1325206946,1,2,0
40575018@N07,1874,85,1325199492,1325199492,1,2,0
40575018@N07,1875,5,1326454152,1326454152,1,1,0
40575018@N07,1876,5,1327048402,1327048402,1,1,0
40575018@N07,1877,5,1328254644,1328259432,3,1,4788
40575018@N07,1878,14,1328689142,1328689142,1,1,0
40575018@N07,1879,5,1329468958,1329468958,1,1,0
40575018@N07,1880,5,1330084588,1330084588,1,1,0
40575018@N07,1881,2,1332314687,1332314687,1,1,0
40575018@N07,1882,14,1332987298,1332987298,1,1,0
40575018@N07,1883,5,1334925307,1334925307,1,1,0
40575018@N07,1884,14,1336106358,1336106358,1,1,0
40575018@N07,1885,46,1338558832,1338558840,2,1,8
40662996@N00,1886,81,1390721492,1390721492,1,1,0
40729822@N00,1887,40,1297197895,1297197895,1,1,0
40729822@N00,1888,14,1297232432,1297234778,10,2,2346
40729822@N00,1888,48,1297228694,1297231786,6,2,3092
40732544715@N01,1889,35,1225481520,1225481568,2,1,48
40732544715@N01,1890,53,1225549481,1225549481,1,1,0
40732544715@N01,1891,82,1234693966,1234693966,1,1,0
40732565852@N01,1892,22,1364192076,1364192076,1,2,0
40732565852@N01,1892,41,1364197442,1364197442,1,2,0
40732565852@N01,1893,9,1364692898,1364692898,1,1,0
40742367@N04,1894,9,1290995294,1290995294,1,8,0
40742367@N04,1894,14,1290989517,1290989517,1,8,0
40742367@N04,1894,45,1291019154,1291019200,2,8,46
40742367@N04,1894,49,1291012363,1291012502,3,8,139
40742367@N04,1894,53,1290989076,1290989076,1,8,0
40742367@N04,1894,69,1290998270,1290998405,3,8,135
40742367@N04,1894,82,1290989545,1291019064,2,8,29519
40742367@N04,1894,84,1290997887,1290997887,1,8,0
40742367@N04,1895,21,1291074613,1291074613,1,3,0
40742367@N04,1895,27,1291114938,1291114938,1,3,0
40742367@N04,1895,76,1291089012,1291089012,1,3,0
40977838@N00,1896,14,1298596454,1298596454,1,1,0
40977838@N00,1897,27,1303812609,1303812609,1,1,0
40999618@N05,1898,49,1371810173,1371810173,1,1,0
41132143@N00,1899,3,1219036706,1219036706,1,1,0
41132143@N00,1900,9,1230700566,1230700693,3,2,127
41132143@N00,1900,23,1230700758,1230700758,1,2,0
41132143@N00,1901,11,1230874878,1230874878,1,2,0
41132143@N00,1901,78,1230868352,1230868858,7,2,506
41174218@N00,1902,26,1285489500,1285489500,1,1,0
41289012@N03,1903,13,1301696416,1301696416,1,1,0
41307012@N08,1904,85,1311054603,1311054603,1,1,0
41312242@N00,1905,63,1200358110,1200382448,60,1,24338
41312242@N00,1906,0,1232866334,1232866338,2,4,4
41312242@N00,1906,25,1232867249,1232867253,2,4,4
41312242@N00,1906,44,1232865991,1232866251,13,4,260
41312242@N00,1906,81,1232865937,1232865967,3,4,30
41312242@N00,1907,16,1301873102,1301873102,1,1,0
41398827@N08,1908,82,1267155932,1267155932,1,1,0
41527867@N04,1909,71,1309391423,1309392008,3,1,585
41527867@N04,1910,9,1310708202,1310708202,1,1,0
41527867@N04,1911,33,1313803748,1313803748,1,1,0
41527867@N04,1912,71,1315023325,1315024190,3,1,865
41527867@N04,1913,82,1317871311,1317871311,1,1,0
41725486@N08,1914,15,1366308480,1366308480,1,4,0
41725486@N08,1914,71,1366298333,1366302564,2,4,4231
41725486@N08,1914,78,1366298019,1366298019,1,4,0
41725486@N08,1914,81,1366324938,1366324938,1,4,0
41725486@N08,1915,69,1366381504,1366381504,1,1,0
41725486@N08,1916,71,1366565393,1366565393,1,1,0
41765986@N02,1917,71,1378105194,1378105194,1,1,0
41894169655@N01,1918,41,1139835571,1139835571,1,3,0
41894169655@N01,1918,45,1139837287,1139837287,1,3,0
41894169655@N01,1918,84,1139839050,1139839050,1,3,0
41894169655@N01,1919,35,1139902921,1139902921,1,2,0
41894169655@N01,1919,45,1139907958,1139907958,1,2,0
41894169655@N01,1920,32,1295872956,1295872956,1,1,0
41894175689@N01,1921,32,1026526298,1026538792,3,4,12494
41894175689@N01,1921,35,1026520782,1026522720,2,4,1938
41894175689@N01,1921,41,1026520879,1026520879,1,4,0
41894175689@N01,1921,50,1026530548,1026530548,1,4,0
41894175689@N01,1922,8,1211506996,1211506996,1,1,0
41894175689@N01,1923,9,1211607115,1211607115,1,4,0
41894175689@N01,1923,31,1211603448,1211605939,6,4,2491
41894175689@N01,1923,37,1211611021,1211611021,1,4,0
41894175689@N01,1923,50,1211626908,1211626908,1,4,0
41894175689@N01,1924,15,1272407017,1272407017,1,1,0
41894181187@N01,1925,45,1324077020,1324077020,1,3,0
41894181187@N01,1925,71,1324064110,1324072861,82,3,8751
41894181187@N01,1925,82,1324072929,1324072929,1,3,0
42059681@N06,1926,27,1345520638,1345520638,1,1,0
42113857@N00,1927,22,1325066883,1325066924,3,2,41
42113857@N00,1927,68,1325075530,1325075530,1,2,0
42113857@N00,1928,11,1387684850,1387684850,1,1,0
42113857@N00,1929,11,1387991420,1387991420,1,1,0
42387290@N00,1930,35,1245717003,1245739979,15,2,22976
42387290@N00,1930,71,1245743177,1245744006,3,2,829
42387290@N00,1931,28,1245802735,1245822585,13,1,19850
42387290@N00,1932,28,1266844099,1266845336,2,1,1237
42509295@N00,1933,84,1374212657,1374212657,1,1,0
42509295@N00,1934,73,1374374364,1374374364,1,1,0
42583704@N00,1935,5,1262649949,1262649949,1,15,0
42583704@N00,1935,8,1262669360,1262669360,1,15,0
42583704@N00,1935,9,1262669920,1262674645,4,15,4725
42583704@N00,1935,14,1262668941,1262668962,3,15,21
42583704@N00,1935,23,1262669751,1262670398,3,15,647
42583704@N00,1935,25,1262679175,1262679570,5,15,395
42583704@N00,1935,27,1262687811,1262687811,1,15,0
42583704@N00,1935,32,1262671283,1262671283,1,15,0
42583704@N00,1935,44,1262677701,1262677701,1,15,0
42583704@N00,1935,45,1262650289,1262650289,1,15,0
42583704@N00,1935,50,1262656561,1262686352,5,15,29791
42583704@N00,1935,70,1262685281,1262685281,1,15,0
42583704@N00,1935,71,1262677274,1262677274,1,15,0
42583704@N00,1935,81,1262677412,1262677412,1,15,0
42583704@N00,1935,82,1262657313,1262686889,6,15,29576
42583704@N00,1936,21,1262770202,1262773167,18,4,2965
42583704@N00,1936,32,1262769217,1262769217,1,4,0
42583704@N00,1936,41,1262764592,1262764754,3,4,162
42583704@N00,1936,84,1262764800,1262764807,2,4,7
42583704@N00,1937,26,1262948805,1262949547,4,1,742
42583704@N00,1938,0,1263128783,1263128783,1,18,0
42583704@N00,1938,3,1263112436,1263116132,5,18,3696
42583704@N00,1938,24,1263119093,1263119126,2,18,33
42583704@N00,1938,25,1263124903,1263126070,5,18,1167
42583704@N00,1938,31,1263128900,1263129203,4,18,303
42583704@N00,1938,35,1263120771,1263120888,2,18,117
42583704@N00,1938,41,1263119597,1263119838,3,18,241
42583704@N00,1938,43,1263129821,1263129821,1,18,0
42583704@N00,1938,44,1263128220,1263128478,3,18,258
42583704@N00,1938,45,1263127413,1263127413,1,18,0
42583704@N00,1938,48,1263110362,1263111618,11,18,1256
42583704@N00,1938,50,1263122359,1263122359,1,18,0
42583704@N00,1938,51,1263106123,1263106954,10,18,831
42583704@N00,1938,69,1263110307,1263110381,2,18,74
42583704@N00,1938,70,1263121601,1263121981,3,18,380
42583704@N00,1938,71,1263122490,1263123542,6,18,1052
42583704@N00,1938,72,1263107927,1263108264,5,18,337
42583704@N00,1938,81,1263123762,1263123956,2,18,194
42583704@N00,1939,82,1263208815,1263208815,1,2,0
42583704@N00,1939,85,1263204745,1263205322,5,2,577
42583704@N00,1940,2,1263267961,1263267961,1,7,0
42583704@N00,1940,34,1263276764,1263278991,10,7,2227
42583704@N00,1940,35,1263292603,1263292622,2,7,19
42583704@N00,1940,40,1263268040,1263273391,32,7,5351
42583704@N00,1940,49,1263276931,1263277834,13,7,903
42583704@N00,1940,71,1263281762,1263281839,3,7,77
42583704@N00,1940,75,1263275523,1263281255,6,7,5732
42656687@N00,1941,9,1187938153,1187938312,8,3,159
42656687@N00,1941,32,1187927171,1187927507,2,3,336
42656687@N00,1941,42,1187927634,1187927634,1,3,0
42656687@N00,1942,41,1286414167,1286414167,1,1,0
42795492@N07,1943,35,1376285494,1376285494,1,1,0
42795492@N07,1944,13,1376468634,1376468634,1,1,0
43117091@N00,1945,40,1294964555,1294964555,1,1,0
43154752@N00,1946,13,1294904315,1294904315,1,1,0
43154752@N00,1947,71,1295880968,1295880968,1,1,0
43207518@N06,1948,22,1267782541,1267782541,1,1,0
43242837@N00,1949,45,1295431657,1295431657,1,1,0
43257106@N07,1950,49,1350174462,1350175144,3,1,682
43292020@N00,1951,85,1314778541,1314778541,1,1,0
43408458@N08,1952,9,1345296709,1345296968,11,2,259
43408458@N08,1952,32,1345299121,1345308143,2,2,9022
43408458@N08,1953,32,1345386271,1345386271,1,1,0
43408458@N08,1954,32,1345417243,1345419071,4,1,1828
43408458@N08,1955,32,1345757136,1345757151,2,1,15
43408458@N08,1956,32,1345837134,1345843173,21,3,6039
43408458@N08,1956,39,1345837349,1345846473,14,3,9124
43408458@N08,1956,70,1345846850,1345846850,1,3,0
43929620@N05,1957,78,1329268140,1329268140,1,1,0
43929620@N05,1958,9,1329344904,1329352632,4,2,7728
43929620@N05,1958,72,1329342147,1329342147,1,2,0
43929620@N05,1959,21,1331327774,1331327894,2,1,120
43929620@N05,1960,40,1331547762,1331547762,1,1,0
43929620@N05,1961,29,1332834073,1332834073,1,1,0
43929620@N05,1962,26,1333789964,1333789964,1,1,0
43929620@N05,1963,25,1335388576,1335388576,1,1,0
43929620@N05,1964,22,1336618125,1336618125,1,1,0
43929620@N05,1965,17,1337147870,1337147870,1,1,0
43929620@N05,1966,2,1339066457,1339066457,1,1,0
43929620@N05,1967,39,1340074219,1340074219,1,1,0
43929620@N05,1968,66,1341529829,1341529829,1,1,0
43929620@N05,1969,20,1341613608,1341616066,2,1,2458
43929620@N05,1970,3,1341651057,1341651057,1,1,0
43929620@N05,1971,85,1344731095,1344731095,1,1,0
43929620@N05,1972,20,1345248566,1345248566,1,1,0
43929620@N05,1973,67,1347403038,1347403038,1,1,0
43929620@N05,1974,9,1353977309,1353977309,1,2,0
43929620@N05,1974,42,1353969438,1353969438,1,2,0
43929620@N05,1975,19,1354500396,1354500396,1,1,0
43929620@N05,1976,35,1355286270,1355286270,1,1,0
43929620@N05,1977,19,1355368372,1355368372,1,2,0
43929620@N05,1977,32,1355365810,1355365810,1,2,0
43929620@N05,1978,72,1359090453,1359090453,1,1,0
43929620@N05,1979,42,1360184956,1360184956,1,1,0
43929620@N05,1980,19,1363299992,1363299992,1,1,0
43929620@N05,1981,35,1364985750,1364986010,4,1,260
43929620@N05,1982,39,1365229469,1365229751,3,3,282
43929620@N05,1982,72,1365229542,1365229542,1,3,0
43929620@N05,1982,78,1365229424,1365229424,1,3,0
43929620@N05,1983,2,1366071639,1366071639,1,2,0
43929620@N05,1983,44,1366085656,1366085685,2,2,29
43929620@N05,1984,35,1368082733,1368082733,1,4,0
43929620@N05,1984,40,1368069843,1368100384,2,4,30541
43929620@N05,1984,45,1368089767,1368089767,1,4,0
43929620@N05,1984,71,1368068290,1368068290,1,4,0
43929620@N05,1985,71,1368337028,1368337028,1,1,0
43929620@N05,1986,41,1369139905,1369139905,1,1,0
43929620@N05,1987,19,1369363966,1369363966,1,1,0
43929620@N05,1988,27,1369723512,1369723512,1,2,0
43929620@N05,1988,32,1369722942,1369723044,2,2,102
43929620@N05,1989,11,1370149892,1370149892,1,1,0
43929620@N05,1990,9,1370327834,1370327837,2,4,3
43929620@N05,1990,23,1370327911,1370327911,1,4,0
43929620@N05,1990,32,1370334387,1370334448,2,4,61
43929620@N05,1990,84,1370319545,1370319545,1,4,0
43929620@N05,1991,69,1370508679,1370508679,1,1,0
43929620@N05,1992,32,1371445235,1371445235,1,2,0
43929620@N05,1992,70,1371450185,1371450185,1,2,0
43929620@N05,1993,46,1371526045,1371526045,1,1,0
43929620@N05,1994,15,1371694412,1371694412,1,1,0
43929620@N05,1995,69,1373037602,1373038299,6,1,697
43929620@N05,1996,35,1373860222,1373860222,1,1,0
43929620@N05,1997,35,1374917270,1374917270,1,1,0
43929620@N05,1998,32,1375874792,1375875429,2,1,637
43929620@N05,1999,13,1376301929,1376303491,4,1,1562
43929620@N05,2000,71,1378015575,1378015575,1,1,0
43929620@N05,2001,71,1378179371,1378179371,1,1,0
43929620@N05,2002,69,1378289754,1378289754,1,1,0
43929620@N05,2003,32,1379035808,1379035808,1,1,0
43929620@N05,2004,69,1381825205,1381825205,1,1,0
43929620@N05,2005,32,1381880464,1381880464,1,3,0
43929620@N05,2005,41,1381893621,1381893621,1,3,0
43929620@N05,2005,71,1381899747,1381899747,1,3,0
43929620@N05,2006,19,1383173532,1383173532,1,1,0
43929620@N05,2007,32,1383638152,1383638152,1,1,0
43929620@N05,2008,22,1384321068,1384321068,1,1,0
43929620@N05,2009,27,1384820814,1384820891,2,1,77
43929620@N05,2010,19,1385001639,1385001639,1,1,0
43929620@N05,2011,32,1385500317,1385500317,1,1,0
43929620@N05,2012,26,1385719832,1385719832,1,1,0
43929620@N05,2013,32,1385815224,1385815224,1,1,0
43929620@N05,2014,32,1385890074,1385890074,1,1,0
43929620@N05,2015,19,1387361107,1387361107,1,2,0
43929620@N05,2015,32,1387336371,1387336371,1,2,0
43929620@N05,2016,30,1388105453,1388105453,1,1,0
43929620@N05,2017,41,1389583031,1389583031,1,1,0
43929620@N05,2018,9,1390381054,1390381054,1,1,0
43929620@N05,2019,40,1391332988,1391332988,1,1,0
43929620@N05,2020,21,1391814703,1391814703,1,1,0
43929620@N05,2021,32,1392846556,1392846556,1,2,0
43929620@N05,2021,45,1392846872,1392846872,1,2,0
43929620@N05,2022,45,1394150718,1394150718,1,1,0
43929620@N05,2023,21,1396750528,1396750528,1,1,0
43986842@N08,2024,68,1261190340,1261190340,1,1,0
43987500@N00,2025,35,1272613454,1272613454,1,1,0
44099059@N00,2026,26,1174308842,1174325086,36,1,16244
44124341325@N01,2027,35,1209471989,1209471989,1,1,0
44124341325@N01,2028,35,1209812880,1209812880,1,1,0
44124356338@N01,2029,75,1356349223,1356349223,1,1,0
44124401641@N01,2030,23,1364088043,1364088043,1,3,0
44124401641@N01,2030,26,1364103591,1364103591,1,3,0
44124401641@N01,2030,50,1364089511,1364089511,1,3,0
44124403817@N01,2031,41,1243401144,1243401144,1,1,0
44124450371@N01,2032,4,1266138350,1266138350,1,9,0
44124450371@N01,2032,22,1266126556,1266127128,2,9,572
44124450371@N01,2032,32,1266116144,1266116144,1,9,0
44124450371@N01,2032,36,1266138826,1266145217,6,9,6391
44124450371@N01,2032,40,1266119569,1266119569,1,9,0
44124450371@N01,2032,41,1266138234,1266138234,1,9,0
44124450371@N01,2032,51,1266120225,1266120555,5,9,330
44124450371@N01,2032,71,1266122462,1266133891,3,9,11429
44124450371@N01,2032,81,1266124886,1266137442,4,9,12556
44124450371@N01,2033,81,1266212812,1266212812,1,1,0
44124455505@N01,2034,57,1302861594,1302864872,2,1,3278
44124455505@N01,2035,12,1302907191,1302907191,1,1,0
44124455505@N01,2036,28,1363737722,1363744824,11,2,7102
44124455505@N01,2036,45,1363756178,1363756203,2,2,25
44124479801@N01,2037,46,1395464572,1395483324,3,1,18752
44124479801@N01,2038,25,1395565609,1395565609,1,1,0
44124479801@N01,2039,14,1395650410,1395650421,2,2,11
44124479801@N01,2039,25,1395649444,1395649444,1,2,0
44124479801@N01,2040,35,1395733856,1395733856,1,3,0
44124479801@N01,2040,81,1395733298,1395748825,2,3,15527
44124479801@N01,2040,85,1395709856,1395709856,1,3,0
44124479801@N01,2041,57,1395911467,1395911467,1,1,0
44124479801@N01,2042,26,1395971957,1395971957,1,4,0
44124479801@N01,2042,45,1395992287,1395992780,2,4,493
44124479801@N01,2042,71,1396002887,1396002887,1,4,0
44124479801@N01,2042,82,1395993691,1395993691,1,4,0
44125563@N00,2043,9,1308818929,1308818929,1,1,0
44125563@N00,2044,8,1331087704,1331087704,1,1,0
44125563@N00,2045,71,1338039533,1338039533,1,1,0
44125563@N00,2046,2,1369132395,1369132395,1,1,0
44125563@N00,2047,40,1369284021,1369284021,1,1,0
44125563@N00,2048,4,1369394508,1369394508,1,1,0
44125563@N00,2049,32,1392996350,1392996350,1,1,0
44175133@N00,2050,32,1330000402,1330000402,1,1,0
44175133@N00,2051,80,1353496357,1353496357,1,1,0
44175133@N00,2052,6,1354737114,1354737114,1,1,0
44175133@N00,2053,25,1374487149,1374487149,1,2,0
44175133@N00,2053,46,1374479040,1374479040,1,2,0
44175133@N00,2054,46,1374533420,1374533420,1,1,0
44175133@N00,2055,6,1380227456,1380227456,1,1,0
44175133@N00,2056,6,1384292344,1384292344,1,2,0
44175133@N00,2056,14,1384303092,1384303092,1,2,0
44175133@N00,2057,32,1394680675,1394680675,1,1,0
44175133@N00,2058,46,1394746810,1394746810,1,1,0
44204242@N04,2059,9,1349499272,1349499272,1,3,0
44204242@N04,2059,50,1349505592,1349505885,5,3,293
44204242@N04,2059,71,1349505868,1349506046,3,3,178
44204242@N04,2060,35,1349569508,1349569508,1,2,0
44204242@N04,2060,39,1349586317,1349587790,2,2,1473
44214673@N05,2061,35,1299611535,1299611535,1,1,0
44259454@N00,2062,63,1337515706,1337519926,12,1,4220
44259454@N00,2063,31,1343638051,1343640960,4,3,2909
44259454@N00,2063,44,1343639697,1343640344,3,3,647
44259454@N00,2063,75,1343638579,1343638579,1,3,0
44643500@N04,2064,25,1328344818,1328344818,1,2,0
44643500@N04,2064,71,1328342958,1328342958,1,2,0
44643500@N04,2065,0,1328396991,1328397002,2,1,11
44669264@N06,2066,63,1382435295,1382442094,12,3,6799
44669264@N06,2066,82,1382416884,1382416884,1,3,0
44669264@N06,2066,85,1382416498,1382416498,1,3,0
44669264@N06,2067,32,1382487956,1382487956,1,1,0
44680418@N04,2068,32,1254471702,1254471702,1,1,0
44680418@N04,2069,21,1258240810,1258240810,1,1,0
44680418@N04,2070,4,1259825873,1259825873,1,1,0
44690184@N07,2071,15,1268949043,1268949752,2,5,709
44690184@N07,2071,22,1268940122,1268940122,1,5,0
44690184@N07,2071,44,1268934322,1268948548,3,5,14226
44690184@N07,2071,81,1268949495,1268949495,1,5,0
44690184@N07,2071,82,1268935051,1268935051,1,5,0
44690184@N07,2072,68,1269017034,1269017230,3,2,196
44690184@N07,2072,84,1269009296,1269009431,2,2,135
44690184@N07,2073,68,1269075307,1269075307,1,1,0
44690184@N07,2074,84,1269133041,1269133041,1,1,0
44690184@N07,2075,15,1269248068,1269248844,2,3,776
44690184@N07,2075,44,1269247714,1269249135,3,3,1421
44690184@N07,2075,84,1269242114,1269242171,2,3,57
44892789@N00,2076,48,1098276909,1098276909,1,1,0
44925192@N00,2077,45,1284034627,1284034627,1,1,0
44925192@N00,2078,26,1284123343,1284126374,4,3,3031
44925192@N00,2078,29,1284104275,1284104275,1,3,0
44925192@N00,2078,81,1284097024,1284097024,1,3,0
44925192@N00,2079,8,1284165857,1284200864,2,11,35007
44925192@N00,2079,9,1284166232,1284168209,18,11,1977
44925192@N00,2079,13,1284164902,1284166166,2,11,1264
44925192@N00,2079,18,1284166060,1284166121,2,11,61
44925192@N00,2079,25,1284183153,1284183153,1,11,0
44925192@N00,2079,31,1284179042,1284179042,1,11,0
44925192@N00,2079,35,1284165780,1284165879,2,11,99
44925192@N00,2079,45,1284156862,1284159339,3,11,2477
44925192@N00,2079,50,1284165029,1284174079,10,11,9050
44925192@N00,2079,70,1284173458,1284173458,1,11,0
44925192@N00,2079,71,1284174295,1284206137,11,11,31842
44925192@N00,2080,11,1284265269,1284279419,2,2,14150
44925192@N00,2080,44,1284262160,1284263137,2,2,977
45173431@N00,2081,57,1180678392,1180678392,1,1,0
45316194@N00,2082,34,1115088240,1115088240,1,1,0
45316194@N00,2083,34,1156392842,1156392842,1,1,0
45316194@N00,2084,34,1157104418,1157104418,1,1,0
45316194@N00,2085,34,1157159803,1157159803,1,1,0
45316194@N00,2086,34,1157674438,1157674438,2,1,0
45316194@N00,2087,34,1160003649,1160003649,1,1,0
45316194@N00,2088,34,1197360185,1197360185,1,1,0
45316194@N00,2089,34,1201564806,1201564806,1,1,0
45316194@N00,2090,34,1202603054,1202603636,2,1,582
45316194@N00,2091,34,1214713163,1214713163,1,2,0
45316194@N00,2091,49,1214712682,1214713304,3,2,622
45316194@N00,2092,34,1215039261,1215039261,1,1,0
45316194@N00,2093,34,1215900984,1215900984,1,1,0
45316194@N00,2094,34,1216175142,1216175142,1,1,0
45316194@N00,2095,34,1243739530,1243739726,2,1,196
45423746@N00,2096,85,1184015834,1184015834,1,1,0
45423746@N00,2097,22,1187338487,1187338487,1,1,0
45431989@N03,2098,60,1300996247,1300996308,2,1,61
45676902@N00,2099,44,1328493095,1328493095,1,3,0
45676902@N00,2099,62,1328496951,1328496965,2,3,14
45676902@N00,2099,81,1328491926,1328491938,2,3,12
45676902@N00,2100,28,1328589847,1328592682,6,2,2835
45676902@N00,2100,39,1328574190,1328574190,2,2,0
45676902@N00,2101,21,1328697844,1328697862,2,4,18
45676902@N00,2101,27,1328680729,1328680752,4,4,23
45676902@N00,2101,68,1328659260,1328659413,4,4,153
45676902@N00,2101,73,1328683102,1328683113,3,4,11
45676902@N00,2102,40,1329009254,1329009254,2,1,0
45676902@N00,2103,46,1329275402,1329275402,1,1,0
45676902@N00,2104,53,1349991752,1350023332,5,1,31580
45676902@N00,2105,53,1350085440,1350109846,3,1,24406
45676902@N00,2106,53,1350549400,1350549400,1,1,0
45761217@N00,2107,35,1294561182,1294561182,1,1,0
45761217@N00,2108,53,1358233838,1358233838,1,1,0
45904697@N05,2109,23,1325889372,1325889372,1,3,0
45904697@N05,2109,32,1325895284,1325895284,1,3,0
45904697@N05,2109,85,1325891080,1325891080,1,3,0
45904697@N05,2110,45,1325991507,1325992415,4,2,908
45904697@N05,2110,48,1326000390,1326000390,1,2,0
45904697@N05,2111,26,1326095607,1326095607,1,3,0
45904697@N05,2111,35,1326088496,1326088496,1,3,0
45904697@N05,2111,71,1326086075,1326086075,1,3,0
45904697@N05,2112,57,1342840084,1342840084,1,1,0
45910028@N06,2113,49,1270187650,1270187650,1,1,0
45924393@N05,2114,71,1329015178,1329015178,1,1,0
45942274@N00,2115,49,1213668972,1213669289,2,1,317
45942274@N00,2116,31,1213767908,1213768609,2,1,701
46028459@N00,2117,25,1301709651,1301709651,1,1,0
46083104@N02,2118,2,1347020156,1347020156,1,1,0
46083104@N02,2119,11,1347711063,1347711063,1,1,0
46083104@N02,2120,2,1352534745,1352534745,1,1,0
46083104@N02,2121,82,1354328751,1354328751,1,1,0
46083104@N02,2122,25,1358522057,1358522057,1,1,0
46083104@N02,2123,57,1365319367,1365319367,1,1,0
46083104@N02,2124,35,1397122139,1397122139,1,1,0
46421193@N07,2125,74,1188099692,1188099692,1,1,0
46421193@N07,2126,71,1191634892,1191635318,4,3,426
46421193@N07,2126,74,1191638624,1191642896,8,3,4272
46421193@N07,2126,81,1191635510,1191644802,4,3,9292
46421193@N07,2127,74,1197153073,1197161906,20,1,8833
46421193@N07,2128,27,1198367022,1198367022,1,1,0
46421193@N07,2129,28,1200181810,1200186310,6,1,4500
46421193@N07,2130,27,1201394922,1201394922,1,1,0
46421193@N07,2131,74,1206309632,1206315080,3,1,5448
46421193@N07,2132,74,1208650853,1208652285,2,1,1432
46421193@N07,2133,81,1211080449,1211080449,1,1,0
46421193@N07,2134,74,1215315682,1215319431,6,1,3749
46421193@N07,2135,28,1216172973,1216181857,10,1,8884
46486754@N00,2136,71,1084516439,1084516766,4,1,327
46664938@N00,2137,71,1235897992,1235902704,11,1,4712
46701705@N00,2138,48,1367560465,1367560465,1,1,0
46743608@N00,2139,23,1173245569,1173245569,1,1,0
46743608@N00,2140,31,1176265419,1176265581,4,1,162
46778425@N00,2141,55,1142403106,1142403106,1,1,0
46778425@N00,2142,53,1142565701,1142587110,4,1,21409
46778425@N00,2143,18,1264895892,1264895915,2,1,23
46778425@N00,2144,35,1358306585,1358306585,1,4,0
46778425@N00,2144,44,1358300248,1358300248,1,4,0
46778425@N00,2144,71,1358306105,1358306105,1,4,0
46778425@N00,2144,80,1358303561,1358303561,1,4,0
46778425@N00,2145,8,1358388147,1358388147,1,2,0
46778425@N00,2145,17,1358388482,1358388482,1,2,0
46981459@N00,2146,70,1193373173,1193373173,1,2,0
46981459@N00,2146,85,1193392342,1193392342,1,2,0
46998573@N00,2147,4,1354089469,1354089469,1,1,0
46998573@N00,2148,31,1362204187,1362204376,2,1,189
47108349@N07,2149,40,1266908775,1266910640,6,1,1865
47108349@N07,2150,8,1274952439,1274952439,1,1,0
47108349@N07,2151,35,1288476539,1288476539,1,1,0
47108349@N07,2152,35,1288519620,1288525533,7,1,5913
47108349@N07,2153,63,1292409746,1292413060,10,1,3314
47108349@N07,2154,21,1296214978,1296215673,3,1,695
47108349@N07,2155,14,1297222667,1297222806,2,2,139
47108349@N07,2155,15,1297222265,1297222265,1,2,0
47108349@N07,2156,71,1298600370,1298601851,19,1,1481
47108349@N07,2157,8,1301024846,1301024846,1,1,0
47108349@N07,2158,63,1303640365,1303650059,16,1,9694
47108349@N07,2159,71,1323339609,1323342510,2,1,2901
47108349@N07,2160,34,1324633541,1324633541,1,1,0
47108349@N07,2161,35,1375492751,1375492751,1,1,0
47312601@N06,2162,11,1297419292,1297419292,1,1,0
47312601@N06,2163,71,1317381752,1317381752,1,1,0
47312601@N06,2164,2,1343049835,1343049835,1,1,0
47322737@N00,2165,17,1183782899,1183782899,1,2,0
47322737@N00,2165,71,1183773089,1183773612,2,2,523
47322737@N00,2166,48,1185077223,1185077408,3,1,185
47322737@N00,2167,28,1194827565,1194838787,7,1,11222
47322737@N00,2168,71,1207964223,1207965041,4,1,818
47322737@N00,2169,35,1221736952,1221736952,1,1,0
47322737@N00,2170,26,1248587393,1248587393,1,1,0
47322737@N00,2171,85,1260579107,1260579435,2,1,328
47322737@N00,2172,85,1260764099,1260764099,1,1,0
47322737@N00,2173,31,1284859528,1284859528,1,1,0
47322737@N00,2174,59,1373248922,1373248922,1,1,0
47322737@N00,2175,27,1392512955,1392519867,24,1,6912
47322737@N00,2176,44,1396038158,1396038158,1,1,0
47334482@N00,2177,21,1171939498,1171939600,2,7,102
47334482@N00,2177,32,1171942584,1171942595,2,7,11
47334482@N00,2177,45,1171946308,1171948876,3,7,2568
47334482@N00,2177,50,1171936924,1171936924,1,7,0
47334482@N00,2177,71,1171932950,1171932950,1,7,0
47334482@N00,2177,72,1171951649,1171951649,1,7,0
47334482@N00,2177,82,1171932627,1171932627,1,7,0
47365129@N07,2178,53,1391694264,1391694264,1,1,0
47439204@N00,2179,84,1334290562,1334290574,2,1,12
47742278@N00,2180,28,1176090601,1176090601,1,1,0
47848054@N04,2181,41,1349769735,1349769735,1,1,0
47848054@N04,2182,78,1369391049,1369391049,1,1,0
47956885@N07,2183,0,1287657104,1287657104,1,1,0
47980775@N02,2184,44,1343447076,1343447076,1,1,0
47980775@N02,2185,19,1347684691,1347686584,4,3,1893
47980775@N02,2185,55,1347691712,1347691712,1,3,0
47980775@N02,2185,68,1347691961,1347692037,2,3,76
47980775@N02,2186,71,1361836883,1361836883,1,1,0
47980775@N02,2187,25,1362297227,1362297227,1,1,0
47980775@N02,2188,32,1364612693,1364613799,2,1,1106
47980775@N02,2189,14,1364807650,1364807650,1,1,0
47980775@N02,2190,32,1367313525,1367313525,1,1,0
47980775@N02,2191,25,1369137123,1369137123,1,1,0
47980775@N02,2192,18,1369467200,1369467200,1,2,0
47980775@N02,2192,31,1369462494,1369462494,1,2,0
47980775@N02,2193,71,1370077578,1370077578,1,1,0
47980775@N02,2194,25,1370171784,1370175875,2,1,4091
47980775@N02,2195,25,1370522396,1370522396,1,1,0
47980775@N02,2196,12,1373021058,1373021058,1,1,0
47980775@N02,2197,32,1373529985,1373529985,1,1,0
47980775@N02,2198,22,1374226994,1374226994,1,1,0
47980775@N02,2199,12,1374378397,1374378397,1,1,0
47980775@N02,2200,22,1374830727,1374830727,1,1,0
47980775@N02,2201,14,1374898497,1374898497,1,2,0
47980775@N02,2201,44,1374894386,1374894386,1,2,0
47980775@N02,2202,47,1374985232,1374985232,1,1,0
47980775@N02,2203,32,1375505556,1375505556,1,1,0
47980775@N02,2204,18,1376108740,1376108740,1,1,0
47980775@N02,2205,25,1376206203,1376206203,1,1,0
47980775@N02,2206,84,1377403328,1377403328,1,1,0
47980775@N02,2207,25,1378885282,1378885282,1,2,0
47980775@N02,2207,26,1378869781,1378870268,2,2,487
47980775@N02,2208,14,1380884788,1380884788,1,1,0
47980775@N02,2209,27,1382696707,1382704294,2,1,7587
47980775@N02,2210,25,1383738079,1383738079,1,1,0
47980775@N02,2211,27,1384059458,1384059458,1,1,0
47980775@N02,2212,9,1384501060,1384501139,2,1,79
47980775@N02,2213,25,1386327972,1386327972,1,1,0
47980775@N02,2214,25,1389610726,1389610726,1,1,0
47980775@N02,2215,56,1389931319,1389931319,1,1,0
47980775@N02,2216,25,1390030284,1390030284,1,2,0
47980775@N02,2216,63,1390011777,1390011777,1,2,0
47980775@N02,2217,14,1390624961,1390624961,1,1,0
47980775@N02,2218,25,1391504888,1391504888,1,1,0
47980775@N02,2219,35,1393066184,1393066184,1,2,0
47980775@N02,2219,50,1393071137,1393071137,1,2,0
47988174@N04,2220,9,1361658417,1361658417,2,4,0
47988174@N04,2220,25,1361667092,1361667092,1,4,0
47988174@N04,2220,82,1361659442,1361659442,2,4,0
47988174@N04,2220,85,1361668530,1361668734,2,4,204
48213112@N00,2221,49,1302425628,1302425783,2,1,155
48213112@N00,2222,71,1327636918,1327636918,1,1,0
48213112@N00,2223,9,1363407239,1363407239,1,3,0
48213112@N00,2223,40,1363408495,1363408495,1,3,0
48213112@N00,2223,41,1363403615,1363408260,6,3,4645
48264126@N00,2224,27,1287873062,1287878032,30,1,4970
48264126@N00,2225,26,1288402989,1288403408,4,3,419
48264126@N00,2225,81,1288408429,1288408645,2,3,216
48264126@N00,2225,82,1288408135,1288408369,4,3,234
48292998@N00,2226,15,1217217596,1217217596,1,1,0
48292998@N00,2227,14,1217462905,1217462905,1,1,0
48292998@N00,2228,50,1228444964,1228444964,1,2,0
48292998@N00,2228,71,1228444521,1228444951,3,2,430
48292998@N00,2229,3,1264846147,1264846217,3,1,70
48292998@N00,2230,37,1265246826,1265246826,1,1,0
48292998@N00,2231,68,1298173545,1298173545,1,2,0
48292998@N00,2231,81,1298177533,1298177533,1,2,0
48292998@N00,2232,22,1304044964,1304044964,1,1,0
48292998@N00,2233,82,1314492690,1314492690,1,1,0
48292998@N00,2234,16,1353811645,1353814097,3,1,2452
48292998@N00,2235,68,1361614558,1361614558,1,2,0
48292998@N00,2235,71,1361614238,1361617757,3,2,3519
48296674@N04,2236,53,1296639839,1296639839,1,1,0
48296674@N04,2237,32,1324777899,1324777899,1,1,0
48394145@N00,2238,67,1223096217,1223100161,5,1,3944
48394145@N00,2239,45,1329202817,1329213998,3,1,11181
48453097@N00,2240,15,1268522356,1268522356,1,4,0
48453097@N00,2240,21,1268517254,1268520182,5,4,2928
48453097@N00,2240,22,1268539763,1268539763,1,4,0
48453097@N00,2240,82,1268522618,1268522618,1,4,0
48453097@N00,2241,22,1269039515,1269039515,1,3,0
48453097@N00,2241,26,1269045853,1269045853,1,3,0
48453097@N00,2241,49,1269064332,1269064864,4,3,532
48453097@N00,2242,17,1269250096,1269250096,1,3,0
48453097@N00,2242,71,1269248190,1269249110,3,3,920
48453097@N00,2242,81,1269249485,1269249485,1,3,0
48453097@N00,2243,67,1269422487,1269423093,5,3,606
48453097@N00,2243,68,1269425256,1269425729,3,3,473
48453097@N00,2243,81,1269422067,1269422118,2,3,51
48453097@N00,2244,57,1269587266,1269603297,15,1,16031
48453097@N00,2245,58,1269734502,1269761769,10,2,27267
48453097@N00,2245,59,1269735382,1269736214,2,2,832
48453097@N00,2246,53,1270175512,1270175512,1,1,0
48453097@N00,2247,85,1270294016,1270294016,1,1,0
48453097@N00,2248,28,1270344360,1270353477,2,1,9117
48453097@N00,2249,26,1271467813,1271467813,1,1,0
48453097@N00,2250,26,1271499099,1271499099,1,1,0
48453097@N00,2251,21,1273290893,1273291066,2,1,173
48453097@N00,2252,12,1275702803,1275702803,1,1,0
48453097@N00,2253,32,1275984180,1275985076,3,1,896
48453097@N00,2254,2,1276574787,1276575127,2,3,340
48453097@N00,2254,40,1276575446,1276575446,1,3,0
48453097@N00,2254,71,1276576622,1276577685,3,3,1063
48453097@N00,2255,2,1276681335,1276681457,2,3,122
48453097@N00,2255,9,1276658386,1276658734,2,3,348
48453097@N00,2255,41,1276647339,1276647339,1,3,0
48453097@N00,2256,32,1300175171,1300175171,1,1,0
48453097@N00,2257,32,1300259238,1300259238,1,1,0
48453097@N00,2258,19,1300693640,1300693640,1,1,0
48453097@N00,2259,19,1312423261,1312423261,1,1,0
48453097@N00,2260,16,1312513233,1312513233,1,1,0
48453097@N00,2261,19,1312791268,1312791268,1,1,0
48453097@N00,2262,19,1314067908,1314067931,2,1,23
48453097@N00,2263,19,1314238414,1314238414,1,2,0
48453097@N00,2263,41,1314265770,1314265770,1,2,0
48453097@N00,2264,22,1314357255,1314357255,1,1,0
48453097@N00,2265,21,1335060538,1335060538,1,1,0
48453097@N00,2266,19,1335753981,1335753981,1,1,0
48485434@N03,2267,12,1329258936,1329258936,1,2,0
48485434@N03,2267,84,1329249781,1329249781,1,2,0
48583839@N07,2268,9,1377478543,1377478710,2,8,167
48583839@N07,2268,15,1377480289,1377480309,2,8,20
48583839@N07,2268,23,1377478107,1377478387,5,8,280
48583839@N07,2268,35,1377478586,1377479026,5,8,440
48583839@N07,2268,50,1377479175,1377480123,4,8,948
48583839@N07,2268,61,1377482246,1377482246,1,8,0
48583839@N07,2268,71,1377479320,1377479810,15,8,490
48583839@N07,2268,82,1377479157,1377480366,7,8,1209
48583839@N07,2269,1,1377849325,1377854799,5,1,5474
48583839@N07,2270,71,1385845014,1385846291,61,1,1277
48583839@N07,2271,11,1387663906,1387664698,8,1,792
48600085265@N01,2272,17,1395977812,1395977812,1,1,0
48600085265@N01,2273,9,1396073167,1396073167,1,1,0
48600098055@N01,2274,0,1239324362,1239324446,2,1,84
48685559@N03,2275,15,1358026949,1358026949,1,1,0
48693740@N00,2276,18,1308185084,1308185084,1,1,0
48695981@N00,2277,32,1285886365,1285886365,1,1,0
48695981@N00,2278,57,1295129778,1295129778,1,1,0
48737213@N00,2279,51,1163340455,1163340455,1,1,0
48737213@N00,2280,40,1166003421,1166003421,1,2,0
48737213@N00,2280,51,1166010975,1166010975,1,2,0
48737213@N00,2281,51,1181044231,1181044231,1,1,0
48737213@N00,2282,29,1182502108,1182502108,1,3,0
48737213@N00,2282,31,1182502591,1182502591,1,3,0
48737213@N00,2282,44,1182502951,1182502951,1,3,0
48737213@N00,2283,76,1196000179,1196000179,1,1,0
48737213@N00,2284,9,1226676394,1226676402,3,1,8
48886983@N00,2285,32,1193270877,1193270877,1,1,0
48886983@N00,2286,26,1199588270,1199588270,1,1,0
48889087714@N01,2287,50,1301233152,1301233152,1,2,0
48889087714@N01,2287,82,1301233341,1301233341,1,2,0
48889087714@N01,2288,26,1301559742,1301559742,1,1,0
48889122860@N01,2289,13,1323314590,1323314634,4,7,44
48889122860@N01,2289,15,1323314410,1323314410,1,7,0
48889122860@N01,2289,17,1323314345,1323314569,8,7,224
48889122860@N01,2289,42,1323315927,1323315948,3,7,21
48889122860@N01,2289,50,1323312381,1323318968,19,7,6587
48889122860@N01,2289,71,1323307955,1323314026,74,7,6071
48889122860@N01,2289,82,1323314213,1323314213,1,7,0
48894056@N00,2290,13,1318132423,1318132423,1,1,0
49021451@N00,2291,15,1232763002,1232763002,1,1,0
49096025@N00,2292,13,1323044380,1323044453,2,1,73
49096025@N00,2293,57,1354175245,1354175426,2,1,181
49222642@N03,2294,37,1359099194,1359099680,2,1,486
49333775@N00,2295,8,1308385121,1308385121,1,1,0
49344711@N00,2296,35,1280043190,1280043190,1,1,0
49344711@N00,2297,24,1301544116,1301544116,1,1,0
49456569@N06,2298,23,1325817287,1325817287,1,2,0
49456569@N06,2298,81,1325833959,1325833959,1,2,0
49456569@N06,2299,35,1326176629,1326176629,1,2,0
49456569@N06,2299,82,1326177248,1326177305,2,2,57
49456569@N06,2300,15,1326316034,1326316034,1,1,0
49456569@N06,2301,9,1328158687,1328158687,1,4,0
49456569@N06,2301,50,1328163494,1328163494,1,4,0
49456569@N06,2301,70,1328162839,1328163167,2,4,328
49456569@N06,2301,82,1328130420,1328163816,2,4,33396
49456569@N06,2302,9,1328242221,1328242221,1,3,0
49456569@N06,2302,50,1328260363,1328260380,2,3,17
49456569@N06,2302,70,1328260145,1328260236,2,3,91
49456569@N06,2303,9,1328676419,1328676419,1,2,0
49456569@N06,2303,18,1328666656,1328666656,1,2,0
49456569@N06,2304,9,1328854280,1328854280,1,1,0
49456569@N06,2305,73,1329465344,1329465344,1,1,0
49456569@N06,2306,35,1329805285,1329805285,1,1,0
49456569@N06,2307,35,1329981367,1329981367,2,1,0
49456569@N06,2308,68,1331275400,1331275400,1,1,0
49456569@N06,2309,9,1342055355,1342055355,1,2,0
49456569@N06,2309,35,1342055191,1342055191,1,2,0
49456569@N06,2310,32,1345195746,1345195762,2,1,16
49456569@N06,2311,71,1349043161,1349043161,1,1,0
49456569@N06,2312,35,1350606587,1350606587,1,2,0
49456569@N06,2312,70,1350627194,1350627445,2,2,251
49456569@N06,2313,82,1351108727,1351108727,1,1,0
49456569@N06,2314,71,1351746821,1351746821,1,1,0
49456569@N06,2315,2,1353663636,1353663742,3,1,106
49456569@N06,2316,70,1354600305,1354600305,1,1,0
49456569@N06,2317,35,1355486291,1355486291,1,1,0
49456569@N06,2318,15,1358803004,1358803004,1,1,0
49456569@N06,2319,21,1358925652,1358925652,1,1,0
49456569@N06,2320,70,1359526076,1359526076,1,1,0
49456569@N06,2321,50,1361410353,1361410353,1,2,0
49456569@N06,2321,71,1361410122,1361410122,1,2,0
49462309@N04,2322,49,1200767510,1200767510,1,1,0
49462309@N04,2323,49,1303522367,1303522916,2,3,549
49462309@N04,2323,68,1303536130,1303536130,1,3,0
49462309@N04,2323,81,1303524097,1303524097,1,3,0
49462309@N04,2324,26,1303693496,1303693496,1,1,0
49502995023@N01,2325,71,1255175077,1255175077,1,1,0
49502995023@N01,2326,81,1255230187,1255230187,1,1,0
49502995023@N01,2327,30,1255421005,1255421005,1,1,0
49502995023@N01,2328,3,1255680392,1255680392,1,1,0
49502995023@N01,2329,1,1255750843,1255750843,1,2,0
49502995023@N01,2329,17,1255744270,1255745565,2,2,1295
49502995023@N01,2330,17,1255829337,1255830147,2,1,810
49502995023@N01,2331,7,1261462780,1261463175,2,1,395
49502995023@N01,2332,40,1261644311,1261644311,1,1,0
49502995023@N01,2333,3,1262060663,1262060663,1,2,0
49502995023@N01,2333,17,1262066660,1262066954,3,2,294
49502995023@N01,2334,63,1264209922,1264209922,1,1,0
49503156729@N01,2335,48,1364004854,1364004854,1,1,0
49503156729@N01,2336,22,1364168057,1364168057,1,1,0
49503156729@N01,2337,71,1364258974,1364258974,1,1,0
49503156729@N01,2338,22,1364366240,1364366240,1,3,0
49503156729@N01,2338,36,1364345891,1364347160,3,3,1269
49503156729@N01,2338,37,1364345239,1364379513,3,3,34274
49503156729@N01,2339,37,1364410687,1364410687,1,1,0
49503207397@N01,2340,9,1006820435,1006820435,1,4,0
49503207397@N01,2340,35,1006805129,1006805151,2,4,22
49503207397@N01,2340,40,1006801914,1006801914,1,4,0
49503207397@N01,2340,71,1006803152,1006803611,3,4,459
49503207397@N01,2341,1,1050290695,1050290897,2,3,202
49503207397@N01,2341,48,1050284236,1050284236,1,3,0
49503207397@N01,2341,53,1050291194,1050291283,3,3,89
49503207397@N01,2342,71,1125261798,1125262678,5,1,880
49787588@N00,2343,15,1229065534,1229076507,37,1,10973
49787588@N00,2344,42,1229477256,1229477990,5,1,734
49787588@N00,2345,9,1357177259,1357181500,4,8,4241
49787588@N00,2345,35,1357181746,1357181847,2,8,101
49787588@N00,2345,41,1357170861,1357176618,3,8,5757
49787588@N00,2345,50,1357182172,1357182172,1,8,0
49787588@N00,2345,70,1357182062,1357182062,1,8,0
49787588@N00,2345,71,1357182384,1357182384,1,8,0
49787588@N00,2345,82,1357182469,1357182617,3,8,148
49787588@N00,2345,84,1357171226,1357173869,3,8,2643
49787588@N00,2346,85,1357799551,1357799551,1,1,0
49787588@N00,2347,68,1358043282,1358043282,1,1,0
49787588@N00,2348,71,1358659696,1358659696,1,1,0
49787588@N00,2349,20,1359165913,1359165913,1,1,0
49787588@N00,2350,3,1359277389,1359277389,1,1,0
49813768@N00,2351,44,1385501010,1385501010,1,2,0
49813768@N00,2351,49,1385493935,1385494362,3,2,427
49975776@N07,2352,2,1354200688,1354200688,1,11,0
49975776@N07,2352,9,1354204988,1354204988,1,11,0
49975776@N07,2352,22,1354204426,1354204426,1,11,0
49975776@N07,2352,34,1354222863,1354222863,1,11,0
49975776@N07,2352,35,1354198927,1354198952,2,11,25
49975776@N07,2352,45,1354195306,1354195332,2,11,26
49975776@N07,2352,50,1354198584,1354210461,2,11,11877
49975776@N07,2352,68,1354219797,1354219973,2,11,176
49975776@N07,2352,71,1354210664,1354210711,2,11,47
49975776@N07,2352,72,1354217257,1354217257,1,11,0
49975776@N07,2352,82,1354223797,1354223797,1,11,0
49988540@N04,2353,41,1388727372,1388727372,1,2,0
49988540@N04,2353,84,1388723055,1388723055,1,2,0
49992082@N08,2354,9,1374931409,1374931409,1,4,0
49992082@N08,2354,22,1374933411,1374936762,2,4,3351
49992082@N08,2354,35,1374923777,1374926958,5,4,3181
49992082@N08,2354,41,1374935288,1374935288,1,4,0
50001938@N00,2355,67,1299917944,1299917944,1,2,0
50001938@N00,2355,81,1299918905,1299918905,1,2,0
50001938@N00,2356,71,1301100773,1301100773,1,2,0
50001938@N00,2356,81,1301100773,1301100773,1,2,0
50001938@N00,2357,17,1305013759,1305013759,1,1,0
50001938@N00,2358,15,1305619149,1305619149,1,2,0
50001938@N00,2358,17,1305619260,1305619260,1,2,0
50001938@N00,2359,8,1305947795,1305947795,1,2,0
50001938@N00,2359,18,1305950342,1305950342,1,2,0
50001938@N00,2360,13,1306221549,1306221549,1,1,0
50001938@N00,2361,23,1308195776,1308195776,1,1,0
50092654@N00,2362,85,1246487841,1246487841,1,1,0
50148267@N00,2363,40,1212847985,1212847985,1,1,0
50148267@N00,2364,85,1214642822,1214642822,1,1,0
50148267@N00,2365,22,1216370390,1216370390,1,1,0
50148267@N00,2366,85,1220169712,1220170256,6,1,544
50148267@N00,2367,22,1224334019,1224334205,4,1,186
50148267@N00,2368,40,1224415164,1224415239,2,1,75
50148267@N00,2369,13,1232054279,1232054279,1,1,0
50148267@N00,2370,53,1246181874,1246181874,1,2,0
50148267@N00,2370,85,1246180726,1246180726,1,2,0
50148267@N00,2371,71,1284871083,1284871083,1,1,0
50216172@N00,2372,56,1106314458,1106329134,8,1,14676
50216172@N00,2373,57,1116650768,1116656482,5,1,5714
50216172@N00,2374,57,1119069182,1119076510,8,1,7328
50216172@N00,2375,57,1127558612,1127577800,38,1,19188
50216172@N00,2376,57,1130532862,1130537580,21,1,4718
50236645@N04,2377,67,1366865571,1366866656,3,1,1085
50357943@N08,2378,7,1342681535,1342681535,1,1,0
50556076@N00,2379,50,1331509963,1331509963,1,3,0
50556076@N00,2379,70,1331507958,1331507958,1,3,0
50556076@N00,2379,71,1331511494,1331514674,3,3,3180
50599874@N00,2380,11,1341050159,1341050159,1,1,0
50612202@N00,2381,71,1349402280,1349402280,1,1,0
50614028@N00,2382,17,1305514489,1305514489,1,2,0
50614028@N00,2382,82,1305527629,1305528371,2,2,742
50614028@N00,2383,57,1305584351,1305619591,3,1,35240
50614028@N00,2384,57,1305692039,1305703950,2,1,11911
50614028@N00,2385,71,1305755267,1305755267,1,1,0
50811284@N00,2386,44,1156561335,1156561335,1,1,0
50811284@N00,2387,46,1156637396,1156637396,1,1,0
50811284@N00,2388,46,1157156840,1157156840,1,1,0
50813059@N02,2389,85,1301190815,1301190815,1,1,0
50813059@N02,2390,85,1318026678,1318026678,1,1,0
50813059@N02,2391,85,1332472656,1332472656,1,1,0
50813059@N02,2392,82,1333000934,1333000934,1,1,0
50813059@N02,2393,82,1333058070,1333058070,1,1,0
50999605@N00,2394,40,1271840823,1271840931,4,1,108
50999605@N00,2395,20,1278670221,1278670221,1,1,0
50999605@N00,2396,71,1281007340,1281007340,1,1,0
50999605@N00,2397,71,1287386726,1287390752,3,1,4026
50999605@N00,2398,84,1303200791,1303200791,1,1,0
50999605@N00,2399,84,1307762333,1307762333,1,1,0
50999605@N00,2400,25,1319970210,1319970329,2,2,119
50999605@N00,2400,82,1319952740,1319952740,1,2,0
50999605@N00,2401,11,1379390220,1379390220,1,1,0
50999605@N00,2402,15,1379481792,1379481792,1,1,0
50999605@N00,2403,11,1380430237,1380430237,1,1,0
50999605@N00,2404,11,1385104437,1385104437,1,1,0
50999605@N00,2405,82,1385266618,1385266618,1,1,0
51035552668@N01,2406,26,1183865542,1183865542,1,1,0
51035601351@N01,2407,71,1134268390,1134268914,3,1,524
51035603197@N01,2408,44,1232958342,1232961940,2,3,3598
51035603197@N01,2408,50,1232966228,1232966228,1,3,0
51035603197@N01,2408,82,1232973642,1232973665,2,3,23
51035636154@N01,2409,28,1246063867,1246079501,152,1,15634
51260961@N05,2410,26,1365305244,1365305244,1,1,0
51260961@N05,2411,26,1365744321,1365745909,7,1,1588
51260961@N05,2412,31,1367047886,1367047930,2,2,44
51260961@N05,2412,43,1367048915,1367048915,1,2,0
51260961@N05,2413,4,1368251837,1368251837,1,1,0
51260961@N05,2414,31,1376805998,1376807048,3,1,1050
51272979@N00,2415,21,1322642970,1322642970,1,1,0
51272979@N00,2416,82,1322816915,1322816915,1,1,0
51272979@N00,2417,21,1328693069,1328693069,1,1,0
51272979@N00,2418,21,1329289224,1329289224,1,1,0
51272979@N00,2419,21,1329892604,1329892604,1,1,0
51272979@N00,2420,8,1330060018,1330060018,1,1,0
51272979@N00,2421,8,1334709197,1334709197,1,1,0
51272979@N00,2422,32,1334783353,1334784213,2,1,860
51272979@N00,2423,76,1338079498,1338079498,1,1,0
51272979@N00,2424,8,1338535191,1338535191,1,1,0
51434218@N00,2425,68,1212806196,1212806196,1,1,0
51493471@N02,2426,11,1379255560,1379255560,1,1,0
51739228@N00,2427,45,1356682375,1356682493,2,1,118
51928417@N00,2428,45,1230735913,1230735913,1,2,0
51928417@N00,2428,55,1230715531,1230715531,1,2,0
51928417@N00,2429,22,1230826080,1230826080,1,1,0
51928417@N00,2430,31,1252110951,1252110951,1,4,0
51928417@N00,2430,32,1252113999,1252113999,1,4,0
51928417@N00,2430,75,1252112705,1252112705,1,4,0
51928417@N00,2430,81,1252113276,1252113276,1,4,0
51928417@N00,2431,81,1254796456,1254796456,1,1,0
51928417@N00,2432,68,1258254428,1258254428,1,1,0
51928417@N00,2433,25,1258675248,1258675248,1,1,0
51928417@N00,2434,81,1264496490,1264498510,4,1,2020
51928417@N00,2435,44,1267930118,1267956052,2,2,25934
51928417@N00,2435,68,1267928981,1267928981,1,2,0
51928417@N00,2436,48,1273908809,1273909164,2,1,355
51928417@N00,2437,14,1279594163,1279594722,3,2,559
51928417@N00,2437,25,1279613922,1279613922,1,2,0
51928417@N00,2438,44,1279792716,1279792716,1,1,0
51928417@N00,2439,29,1287652426,1287652426,1,1,0
51928417@N00,2440,7,1288756999,1288756999,1,1,0
51928417@N00,2441,82,1313207008,1313207008,1,1,0
51928417@N00,2442,44,1314087586,1314087586,1,2,0
51928417@N00,2442,48,1314069629,1314069629,1,2,0
51928417@N00,2443,25,1324712654,1324712654,1,1,0
51928417@N00,2444,13,1356135923,1356135923,1,2,0
51928417@N00,2444,45,1356133273,1356134026,2,2,753
51928417@N00,2445,82,1356222806,1356222806,1,1,0
51928417@N00,2446,70,1358284920,1358284920,1,1,0
51928417@N00,2447,15,1362001256,1362001256,1,1,0
51928417@N00,2448,13,1370749263,1370749263,1,1,0
51928417@N00,2449,48,1370925777,1370925777,1,1,0
51928417@N00,2450,22,1376378330,1376378330,1,1,0
51928417@N00,2451,69,1379556781,1379556781,1,1,0
51928417@N00,2452,69,1380101180,1380101180,1,1,0
51928417@N00,2453,57,1380352404,1380352404,1,1,0
51928417@N00,2454,41,1393620149,1393620149,1,1,0
51986774@N00,2455,35,1263951486,1263957115,4,3,5629
51986774@N00,2455,42,1263947085,1263947085,1,3,0
51986774@N00,2455,70,1263951507,1263954188,22,3,2681
52273785@N02,2456,38,1331762951,1331762951,1,1,0
52273785@N02,2457,71,1332019521,1332045207,2,1,25686
52350632@N06,2458,13,1393063007,1393063007,2,1,0
52350632@N06,2459,13,1393129711,1393129711,1,2,0
52350632@N06,2459,84,1393124474,1393124474,1,2,0
52618473@N02,2460,84,1346224734,1346224734,1,1,0
52618473@N02,2461,84,1346602409,1346602409,1,1,0
52618473@N02,2462,85,1350593583,1350593583,1,1,0
52618473@N02,2463,21,1356610274,1356610274,1,1,0
52618473@N02,2464,21,1361696078,1361696078,1,1,0
52618473@N02,2465,71,1362297056,1362297056,1,1,0
52618473@N02,2466,9,1362612815,1362612815,1,1,0
52618473@N02,2467,30,1363247697,1363247697,1,1,0
52618473@N02,2468,71,1364014790,1364014790,1,1,0
52618473@N02,2469,15,1364114146,1364114156,2,3,10
52618473@N02,2469,82,1364114137,1364114185,4,3,48
52618473@N02,2469,85,1364114073,1364114073,1,3,0
52618473@N02,2470,3,1364376776,1364376776,1,1,0
52618473@N02,2471,66,1364736135,1364736135,1,1,0
52618473@N02,2472,36,1364985189,1364985189,1,1,0
52618473@N02,2473,36,1365169002,1365169002,1,1,0
52618473@N02,2474,21,1365832565,1365832565,1,1,0
52618473@N02,2475,21,1366348578,1366348578,1,1,0
52618473@N02,2476,7,1370998589,1370998589,1,1,0
52618473@N02,2477,84,1371451326,1371451326,1,1,0
52618473@N02,2478,8,1378390790,1378390790,1,1,0
52618473@N02,2479,18,1378960241,1378960241,1,1,0
52618473@N02,2480,22,1381209240,1381209240,1,1,0
52618473@N02,2481,30,1383896961,1383896961,1,1,0
52618473@N02,2482,48,1384382465,1384382465,1,1,0
52618473@N02,2483,71,1384424630,1384426718,2,1,2088
52618473@N02,2484,48,1386317734,1386322176,3,1,4442
52618473@N02,2485,70,1386930388,1386930388,1,1,0
52618473@N02,2486,30,1387155828,1387155828,1,1,0
52618473@N02,2487,48,1388365559,1388371380,3,1,5821
52618473@N02,2488,27,1388903366,1388903366,1,1,0
52618473@N02,2489,31,1393077770,1393077770,1,2,0
52618473@N02,2489,41,1393069034,1393069034,1,2,0
52618473@N02,2490,26,1394702769,1394711337,6,1,8568
52618473@N02,2491,36,1394783203,1394783203,1,1,0
52618473@N02,2492,31,1395958742,1395959040,3,1,298
52618473@N02,2493,31,1396012253,1396012253,1,1,0
52618473@N02,2494,11,1397193077,1397198405,2,1,5328
52618473@N02,2495,41,1397365113,1397365113,1,3,0
52618473@N02,2495,45,1397372915,1397372915,1,3,0
52618473@N02,2495,81,1397368349,1397368349,1,3,0
52618473@N02,2496,32,1397437175,1397437175,1,1,0
52645327@N08,2497,4,1270869781,1270869885,2,1,104
52652609@N06,2498,3,1357284139,1357287160,50,2,3021
52652609@N06,2498,30,1357284924,1357286203,2,2,1279
52846207@N04,2499,5,1316919489,1316919489,1,1,0
52952793@N00,2500,82,1100085623,1100085910,3,2,287
52952793@N00,2500,85,1100066851,1100067917,16,2,1066
52952793@N00,2501,85,1102489376,1102490006,5,1,630
52952793@N00,2502,85,1108162249,1108164890,12,1,2641
52952793@N00,2503,32,1128480139,1128480139,1,1,0
52952793@N00,2504,8,1128566711,1128566711,1,2,0
52952793@N00,2504,14,1128565850,1128565850,1,2,0
52952793@N00,2505,15,1158380250,1158380250,1,5,0
52952793@N00,2505,44,1158378832,1158378832,1,5,0
52952793@N00,2505,45,1158379257,1158379505,5,5,248
52952793@N00,2505,71,1158377060,1158378290,6,5,1230
52952793@N00,2505,81,1158378680,1158379105,4,5,425
52952793@N00,2506,21,1171445729,1171447937,4,1,2208
52952793@N00,2507,35,1210760699,1210764220,9,2,3521
52952793@N00,2507,71,1210754337,1210758331,6,2,3994
52952793@N00,2508,84,1210842139,1210850826,13,1,8687
52952793@N00,2509,71,1213173546,1213184373,10,1,10827
52952793@N00,2510,71,1218619224,1218625342,11,1,6118
52952793@N00,2511,9,1219824062,1219830722,22,1,6660
52952793@N00,2512,1,1226996213,1226996313,2,1,100
52952793@N00,2513,71,1231918210,1231918210,1,2,0
52952793@N00,2513,81,1231932119,1231932119,1,2,0
52952793@N00,2514,2,1234734944,1234746398,26,1,11454
52952793@N00,2515,1,1235277372,1235279532,12,5,2160
52952793@N00,2515,25,1235285105,1235285284,5,5,179
52952793@N00,2515,46,1235283709,1235284011,5,5,302
52952793@N00,2515,53,1235277149,1235277272,2,5,123
52952793@N00,2515,85,1235276894,1235276894,1,5,0
52952793@N00,2516,2,1242772372,1242788382,22,1,16010
52952793@N00,2517,29,1247984128,1247984148,2,8,20
52952793@N00,2517,43,1247984841,1247984841,1,8,0
52952793@N00,2517,44,1247981457,1247981679,4,8,222
52952793@N00,2517,45,1247981882,1247983524,10,8,1642
52952793@N00,2517,49,1247985314,1247985956,12,8,642
52952793@N00,2517,67,1247987589,1247988534,5,8,945
52952793@N00,2517,68,1247992484,1247992484,1,8,0
52952793@N00,2517,81,1247980708,1247980708,1,8,0
52952793@N00,2518,2,1248043003,1248055389,20,1,12386
52952793@N00,2519,8,1249188465,1249188465,1,6,0
52952793@N00,2519,9,1249178615,1249178615,1,6,0
52952793@N00,2519,18,1249186751,1249186751,1,6,0
52952793@N00,2519,23,1249185496,1249185963,5,6,467
52952793@N00,2519,32,1249179381,1249180175,9,6,794
52952793@N00,2519,71,1249165315,1249165357,2,6,42
52952793@N00,2520,71,1252447321,1252453901,13,1,6580
52952793@N00,2521,49,1253106118,1253106118,1,1,0
52952793@N00,2522,71,1257931724,1257937280,13,1,5556
52952793@N00,2523,28,1280016460,1280024875,2,1,8415
52952793@N00,2524,68,1285328997,1285328997,1,1,0
52952793@N00,2525,26,1301811113,1301814770,10,1,3657
52952793@N00,2526,1,1350088894,1350091077,4,5,2183
52952793@N00,2526,2,1350106902,1350106902,1,5,0
52952793@N00,2526,39,1350103618,1350106253,3,5,2635
52952793@N00,2526,40,1350107408,1350107408,2,5,0
52952793@N00,2526,70,1350100901,1350100901,1,5,0
52952793@N00,2527,25,1357898704,1357899833,3,5,1129
52952793@N00,2527,45,1357897311,1357897311,1,5,0
52952793@N00,2527,71,1357893307,1357893489,2,5,182
52952793@N00,2527,81,1357894552,1357894552,1,5,0
52952793@N00,2527,82,1357894966,1357896037,4,5,1071
52952793@N00,2528,70,1366361380,1366361380,1,1,0
52952793@N00,2529,49,1372487422,1372487422,1,1,0
52952793@N00,2530,50,1384668511,1384668511,1,1,0
52959414@N02,2531,2,1207369725,1207369725,1,1,0
52959414@N02,2532,69,1289856814,1289856814,1,1,0
53242241@N00,2533,3,1193611202,1193612463,8,2,1261
53242241@N00,2533,71,1193616431,1193617575,7,2,1144
53443516@N00,2534,55,1232406362,1232450655,186,1,44293
53493629@N00,2535,50,1193116138,1193116138,1,2,0
53493629@N00,2535,71,1193113341,1193115959,4,2,2618
53538244@N00,2536,9,1242558161,1242558161,1,1,0
53649124@N00,2537,41,1361618425,1361618425,1,1,0
53678425@N00,2538,11,1218596408,1218600993,13,1,4585
53678425@N00,2539,26,1218852009,1218852116,2,1,107
53682558@N06,2540,15,1328836873,1328836873,1,1,0
53682558@N06,2541,44,1328914531,1328914531,1,1,0
53682558@N06,2542,81,1330471714,1330471714,1,1,0
53701455@N00,2543,30,1106274372,1106274372,1,1,0
53701455@N00,2544,68,1136024408,1136024408,1,1,0
53701455@N00,2545,68,1136092458,1136092486,7,1,28
53701455@N00,2546,30,1146531218,1146531218,1,1,0
53701455@N00,2547,30,1186626259,1186626259,1,1,0
53701455@N00,2548,85,1186874554,1186875249,2,1,695
53701455@N00,2549,30,1191927640,1191927640,1,1,0
53701455@N00,2550,30,1196741165,1196741165,1,1,0
53701455@N00,2551,30,1196810473,1196810473,1,1,0
53701455@N00,2552,7,1196926567,1196926567,1,1,0
53701455@N00,2553,7,1197018147,1197018229,2,2,82
53701455@N00,2553,30,1196992048,1196998490,2,2,6442
53701455@N00,2554,7,1206601534,1206601534,1,1,0
53701455@N00,2555,30,1217216829,1217216829,1,1,0
53701455@N00,2556,2,1231039855,1231039855,1,3,0
53701455@N00,2556,48,1231037921,1231038371,2,3,450
53701455@N00,2556,67,1231044863,1231044863,1,3,0
53701455@N00,2557,47,1231295356,1231296832,15,1,1476
53836246@N00,2558,76,1162098034,1162098034,1,1,0
53836246@N00,2559,0,1164176975,1164176975,1,2,0
53836246@N00,2559,71,1164168394,1164168402,2,2,8
53836246@N00,2560,71,1164510653,1164512618,3,2,1965
53836246@N00,2560,81,1164522208,1164522226,2,2,18
53836246@N00,2561,2,1164694421,1164694421,1,8,0
53836246@N00,2561,9,1164689948,1164689948,1,8,0
53836246@N00,2561,23,1164689139,1164689139,1,8,0
53836246@N00,2561,32,1164683222,1164684829,3,8,1607
53836246@N00,2561,35,1164686434,1164686434,1,8,0
53836246@N00,2561,40,1164693731,1164693731,1,8,0
53836246@N00,2561,50,1164687390,1164687390,1,8,0
53836246@N00,2561,82,1164678386,1164678386,1,8,0
53840569@N07,2562,40,1338085029,1338085029,1,1,0
53840569@N07,2563,71,1345273096,1345273296,2,1,200
53840569@N07,2564,17,1352951089,1352951089,1,2,0
53840569@N07,2564,31,1352954929,1352954929,1,2,0
53840569@N07,2565,71,1353132629,1353132629,1,1,0
53840569@N07,2566,19,1373243881,1373243881,1,3,0
53840569@N07,2566,22,1373268293,1373268293,1,3,0
53840569@N07,2566,84,1373259595,1373259595,1,3,0
53840569@N07,2567,0,1373426886,1373426886,1,3,0
53840569@N07,2567,31,1373428511,1373428511,1,3,0
53840569@N07,2567,81,1373435659,1373435659,1,3,0
53840569@N07,2568,13,1382501526,1382501526,1,1,0
53840569@N07,2569,31,1382758351,1382758351,1,1,0
53891062@N00,2570,25,1196206408,1196206408,1,1,0
54086610@N00,2571,25,1331800468,1331800490,3,2,22
54086610@N00,2571,58,1331782566,1331782734,10,2,168
54086610@N00,2572,25,1331887404,1331887404,1,4,0
54086610@N00,2572,58,1331874766,1331874766,1,4,0
54086610@N00,2572,66,1331874608,1331874697,5,4,89
54086610@N00,2572,82,1331874569,1331874569,1,4,0
54086610@N00,2573,66,1331966247,1331966247,1,1,0
54086610@N00,2574,25,1332067746,1332067760,2,2,14
54086610@N00,2574,59,1332058119,1332058142,3,2,23
54086610@N00,2575,45,1332205301,1332211365,7,5,6064
54086610@N00,2575,50,1332211464,1332211464,1,5,0
54086610@N00,2575,68,1332211434,1332211434,1,5,0
54086610@N00,2575,71,1332205213,1332211448,5,5,6235
54086610@N00,2575,81,1332211378,1332211391,2,5,13
54169140@N00,2576,11,1311301704,1311318519,4,2,16815
54169140@N00,2576,31,1311299851,1311299851,1,2,0
54169140@N00,2577,46,1311404416,1311404554,2,1,138
54169140@N00,2578,67,1311639787,1311639787,1,1,0
54169140@N00,2579,67,1311839227,1311839724,2,1,497
54300266@N05,2580,67,1125081069,1125081069,1,1,0
54329815@N00,2581,52,1030047615,1030047615,1,1,0
54343663@N00,2582,8,1319147516,1319147516,1,1,0
54343663@N00,2583,48,1333063566,1333063566,1,1,0
54343663@N00,2584,41,1334320963,1334320963,1,1,0
54343663@N00,2585,55,1358121853,1358121853,1,2,0
54343663@N00,2585,84,1358113815,1358113815,1,2,0
54352459@N03,2586,72,1286262798,1286263300,2,1,502
54352459@N03,2587,79,1286349778,1286349778,1,1,0
54352459@N03,2588,32,1286416285,1286416285,1,1,0
54352459@N03,2589,27,1286591148,1286591148,1,1,0
54352459@N03,2590,68,1286955801,1286955801,1,2,0
54352459@N03,2590,82,1286959428,1286959428,1,2,0
54352459@N03,2591,15,1287459153,1287459153,1,1,0
54352459@N03,2592,15,1287524934,1287524934,1,1,0
54352459@N03,2593,41,1288303158,1288303158,1,1,0
54352459@N03,2594,84,1289900359,1289900525,2,1,166
54352459@N03,2595,45,1290068251,1290068251,1,1,0
54352459@N03,2596,71,1290160757,1290160757,1,1,0
54352459@N03,2597,22,1290209158,1290209330,2,2,172
54352459@N03,2597,41,1290207505,1290235626,36,2,28121
54352459@N03,2598,9,1290764626,1290764626,1,3,0
54352459@N03,2598,71,1290762276,1290762967,3,3,691
54352459@N03,2598,81,1290761764,1290761764,1,3,0
54352459@N03,2599,68,1291112151,1291113905,2,2,1754
54352459@N03,2599,71,1291115343,1291115343,1,2,0
54352459@N03,2600,49,1291801164,1291801164,1,2,0
54352459@N03,2600,84,1291805675,1291805675,1,2,0
54352459@N03,2601,48,1292742344,1292742344,1,1,0
54352459@N03,2602,78,1294121328,1294121713,2,1,385
54352459@N03,2603,50,1294298401,1294298401,1,2,0
54352459@N03,2603,70,1294298775,1294298775,1,2,0
54352459@N03,2604,9,1304744849,1304744849,1,2,0
54352459@N03,2604,48,1304739069,1304739232,2,2,163
54352459@N03,2605,41,1304927705,1304927705,1,1,0
54352459@N03,2606,66,1308379210,1308379213,2,1,3
54352459@N03,2607,9,1311140917,1311140917,1,1,0
54352459@N03,2608,19,1311997741,1311997741,1,3,0
54352459@N03,2608,35,1312003942,1312004542,3,3,600
54352459@N03,2608,38,1311996096,1311996250,2,3,154
54352459@N03,2609,68,1326022633,1326022633,1,1,0
54386413@N07,2610,15,1386564229,1386568855,5,2,4626
54386413@N07,2610,45,1386563615,1386567329,5,2,3714
54386413@N07,2611,15,1386717133,1386717133,1,1,0
54511827@N00,2612,31,1311372444,1311372444,1,1,0
54549576@N00,2613,41,1269740484,1269740484,1,1,0
54549576@N00,2614,22,1269819668,1269819671,3,1,3
54549576@N00,2615,48,1271203334,1271203363,6,1,29
54549576@N00,2616,31,1271379600,1271379624,6,1,24
54549576@N00,2617,31,1271723517,1271723529,3,1,12
54549576@N00,2618,31,1271808548,1271808558,3,1,10
54783527@N00,2619,32,1205973303,1205975043,12,1,1740
54783527@N00,2620,32,1206055530,1206074644,10,1,19114
54783527@N00,2621,32,1206149978,1206149978,1,1,0
54879137@N00,2622,4,1355523911,1355523911,1,1,0
54913798@N00,2623,35,1314247696,1314247696,1,1,0
54932439@N04,2624,13,1392420934,1392420934,2,1,0
54967923@N00,2625,22,1291533367,1291533367,1,1,0
55015384@N06,2626,0,1291073024,1291073024,1,1,0
55015384@N06,2627,35,1349001950,1349001950,1,1,0
55236434@N00,2628,15,1268132684,1268132684,1,1,0
55236434@N00,2629,40,1299288066,1299291316,25,1,3250
55236434@N00,2630,82,1321007070,1321007070,1,1,0
55236434@N00,2631,31,1388905167,1388905167,1,1,0
55236434@N00,2632,11,1394950519,1394950519,1,1,0
55349731@N00,2633,31,1388384463,1388384463,1,1,0
55349731@N00,2634,28,1388896691,1388896691,1,1,0
55458436@N05,2635,24,1375304998,1375304998,1,1,0
55477312@N04,2636,27,1373499132,1373499132,1,1,0
55477312@N04,2637,9,1376087334,1376087334,1,2,0
55477312@N04,2637,16,1376085495,1376085495,1,2,0
55477312@N04,2638,50,1377353521,1377353521,1,1,0
55579714@N00,2639,30,1332699035,1332699035,1,1,0
55579714@N00,2640,50,1332786804,1332786804,1,1,0
55579714@N00,2641,24,1332836949,1332836949,1,1,0
55579714@N00,2642,15,1336594733,1336594741,2,2,8
55579714@N00,2642,68,1336594743,1336594743,1,2,0
55579714@N00,2643,68,1336655902,1336655904,2,1,2
55579714@N00,2644,19,1336692744,1336692744,1,2,0
55579714@N00,2644,41,1336692839,1336694243,7,2,1404
55579714@N00,2645,50,1336772055,1336772055,1,1,0
55579714@N00,2646,22,1336844011,1336844011,1,4,0
55579714@N00,2646,32,1336803374,1336803589,4,4,215
55579714@N00,2646,71,1336803829,1336824947,4,4,21118
55579714@N00,2646,84,1336855841,1336856013,2,4,172
55579714@N00,2647,82,1337045801,1337045801,1,1,0
55579714@N00,2648,16,1337164345,1337164345,1,2,0
55579714@N00,2648,84,1337163676,1337163676,1,2,0
55579714@N00,2649,24,1337500202,1337500202,1,2,0
55579714@N00,2649,32,1337505707,1337505707,1,2,0
55615037@N02,2650,71,1327721420,1327721420,1,1,0
55634419@N00,2651,51,1159419999,1159419999,1,1,0
55634419@N00,2652,16,1299947075,1299947075,1,1,0
55634419@N00,2653,21,1311386656,1311386656,1,1,0
55691706@N06,2654,49,1384439422,1384439422,1,1,0
55706193@N00,2655,35,1247980884,1247980884,1,2,0
55706193@N00,2655,50,1247984465,1247985150,5,2,685
55706193@N00,2656,27,1257988676,1257999104,14,1,10428
55706193@N00,2657,82,1264587687,1264587756,8,1,69
55706193@N00,2658,27,1274211832,1274215380,7,1,3548
55706193@N00,2659,27,1295063086,1295069951,32,1,6865
55827319@N08,2660,22,1346358098,1346361662,53,1,3564
55902742@N05,2661,8,1343530999,1343530999,1,2,0
55902742@N05,2661,81,1343540239,1343540239,1,2,0
55902742@N05,2662,25,1350123630,1350123630,1,1,0
55902742@N05,2663,49,1372482352,1372482352,1,1,0
55932465@N00,2664,0,1358766135,1358766135,1,1,0
55932465@N00,2665,38,1358936443,1358936443,1,1,0
56109783@N05,2666,9,1282254238,1282254238,1,1,0
56109783@N05,2667,15,1299295855,1299295855,1,1,0
56111544@N00,2668,20,1282835903,1282848298,16,1,12395
56111544@N00,2669,29,1283537259,1283538989,8,1,1730
56140378@N07,2670,18,1251520950,1251520950,1,1,0
56140378@N07,2671,22,1251616809,1251616809,1,3,0
56140378@N07,2671,36,1251611096,1251611096,1,3,0
56140378@N07,2671,84,1251603146,1251603146,1,3,0
56140378@N07,2672,2,1251680144,1251680144,1,4,0
56140378@N07,2672,39,1251678175,1251678175,1,4,0
56140378@N07,2672,41,1251688097,1251688097,1,4,0
56140378@N07,2672,50,1251678883,1251688146,2,4,9263
56384399@N00,2673,37,1168068785,1168068785,1,6,0
56384399@N00,2673,52,1168073196,1168073361,5,6,165
56384399@N00,2673,62,1168071598,1168071598,1,6,0
56384399@N00,2673,68,1168070949,1168070949,1,6,0
56384399@N00,2673,71,1168070363,1168070583,2,6,220
56384399@N00,2673,82,1168070193,1168070193,1,6,0
56604312@N07,2674,12,1332102119,1332102798,2,1,679
56685562@N00,2675,82,1095051416,1095051416,1,1,0
56779003@N00,2676,9,1268003732,1268006205,13,1,2473
56935359@N00,2677,14,1136516249,1136562391,31,1,46142
56935359@N00,2678,3,1136627766,1136633235,8,3,5469
56935359@N00,2678,14,1136605308,1136644251,17,3,38943
56935359@N00,2678,26,1136636683,1136638979,8,3,2296
56935359@N00,2679,14,1136682718,1136682944,10,2,226
56935359@N00,2679,26,1136683760,1136697160,22,2,13400
56935359@N00,2680,16,1183515656,1183515656,1,3,0
56935359@N00,2680,18,1183531280,1183532568,2,3,1288
56935359@N00,2680,82,1183522100,1183529330,2,3,7230
57111660@N00,2681,15,1214717939,1214718145,3,1,206
57541585@N05,2682,50,1364092994,1364092994,1,1,0
57541585@N05,2683,48,1364279341,1364279346,2,1,5
57563293@N00,2684,32,1332793057,1332838411,38,1,45354
57563293@N00,2685,32,1332873479,1332873761,5,1,282
57563293@N00,2686,32,1332905387,1332911256,5,1,5869
57563293@N00,2687,32,1333005546,1333016312,54,1,10766
57563293@N00,2688,32,1333045362,1333089661,9,1,44299
57563293@N00,2689,2,1333438598,1333439523,3,1,925
57608438@N08,2690,0,1346524463,1346524957,2,4,494
57608438@N08,2690,35,1346521566,1346521566,1,4,0
57608438@N08,2690,81,1346524526,1346524526,1,4,0
57608438@N08,2690,82,1346522261,1346522261,1,4,0
57608438@N08,2691,25,1346605996,1346606256,2,5,260
57608438@N08,2691,27,1346606292,1346606292,1,5,0
57608438@N08,2691,44,1346613548,1346613548,1,5,0
57608438@N08,2691,50,1346613280,1346613280,1,5,0
57608438@N08,2691,68,1346613570,1346614389,2,5,819
57608438@N08,2692,48,1347033188,1347040130,4,1,6942
57608438@N08,2693,36,1347119514,1347122360,5,1,2846
57608438@N08,2694,8,1347645218,1347645218,1,2,0
57608438@N08,2694,38,1347641293,1347641293,1,2,0
57608438@N08,2695,71,1347725348,1347725348,1,2,0
57608438@N08,2695,84,1347739225,1347739634,2,2,409
57608438@N08,2696,81,1369326770,1369326770,1,1,0
57608438@N08,2697,48,1370020315,1370029847,9,1,9532
57681635@N05,2698,45,1310022084,1310022084,1,1,0
57768536@N05,2699,48,1338198854,1338198854,1,1,0
57768536@N05,2700,2,1338270691,1338270691,1,7,0
57768536@N05,2700,9,1338267647,1338267739,2,7,92
57768536@N05,2700,13,1338265135,1338265135,1,7,0
57768536@N05,2700,14,1338260945,1338260945,1,7,0
57768536@N05,2700,39,1338268681,1338268785,2,7,104
57768536@N05,2700,40,1338270449,1338270449,1,7,0
57768536@N05,2700,71,1338266187,1338266334,3,7,147
57768536@N05,2701,9,1338344392,1338344392,1,2,0
57768536@N05,2701,35,1338345386,1338345386,1,2,0
57794886@N00,2702,39,1223010020,1223010020,1,1,0
57794886@N00,2703,17,1223249888,1223249888,1,2,0
57794886@N00,2703,44,1223251037,1223251037,1,2,0
57794886@N00,2704,40,1293610854,1293610854,1,1,0
57794886@N00,2705,81,1293800931,1293800931,1,1,0
57794886@N00,2706,11,1349941967,1349941967,1,2,0
57794886@N00,2706,13,1349923508,1349923508,1,2,0
57794886@N00,2707,11,1350035735,1350035735,1,1,0
57794886@N00,2708,32,1351741448,1351741448,1,1,0
57794886@N00,2709,15,1352344203,1352344203,1,1,0
57794886@N00,2710,4,1354013067,1354013067,1,1,0
57794886@N00,2711,11,1362369343,1362369343,1,1,0
57794886@N00,2712,4,1362476449,1362476449,1,1,0
57794886@N00,2713,32,1362612095,1362612095,1,1,0
57794886@N00,2714,17,1363412860,1363412860,1,1,0
57794886@N00,2715,11,1364970368,1364970368,1,1,0
57794886@N00,2716,40,1365226499,1365226499,1,1,0
57794886@N00,2717,36,1365761093,1365761093,1,1,0
57794886@N00,2718,11,1370568205,1370568205,1,1,0
57794886@N00,2719,11,1373005286,1373005286,1,1,0
57794886@N00,2720,57,1373625726,1373625726,1,1,0
57794886@N00,2721,23,1374205073,1374205073,1,1,0
57794886@N00,2722,23,1376724116,1376724116,1,2,0
57794886@N00,2722,71,1376720828,1376720828,1,2,0
57794886@N00,2723,3,1379627225,1379667091,2,2,39866
57794886@N00,2723,11,1379655692,1379655755,2,2,63
57804725@N08,2724,68,1392387786,1392387786,1,1,0
57841116@N03,2725,6,1314946842,1314946842,1,1,0
57841116@N03,2726,50,1316767505,1316767505,1,1,0
57841116@N03,2727,42,1318300382,1318300382,1,1,0
57841116@N03,2728,84,1320665939,1320666057,2,1,118
57841116@N03,2729,40,1320979076,1320979076,1,1,0
57841116@N03,2730,14,1321603251,1321603251,1,1,0
57841116@N03,2731,71,1321956789,1321956789,1,1,0
57841116@N03,2732,15,1323683795,1323683795,1,2,0
57841116@N03,2732,18,1323677610,1323678052,2,2,442
57841116@N03,2733,15,1324682564,1324682564,1,3,0
57841116@N03,2733,35,1324684246,1324684327,2,3,81
57841116@N03,2733,71,1324685355,1324685447,2,3,92
57841116@N03,2734,55,1326785933,1326785964,2,2,31
57841116@N03,2734,56,1326760844,1326773492,2,2,12648
57841116@N03,2735,55,1327448957,1327448957,1,3,0
57841116@N03,2735,56,1327459165,1327471749,3,3,12584
57841116@N03,2735,63,1327449402,1327463782,3,3,14380
57841116@N03,2736,85,1327543492,1327543492,1,1,0
57841116@N03,2737,46,1328582556,1328582556,1,1,0
57841116@N03,2738,25,1328778810,1328778810,1,1,0
57841116@N03,2739,71,1329030915,1329034702,4,1,3787
57841116@N03,2740,15,1329466978,1329466978,1,1,0
57841116@N03,2741,49,1329814331,1329817104,5,1,2773
57841116@N03,2742,47,1329863140,1329863140,1,1,0
57841116@N03,2743,0,1330425258,1330425258,1,2,0
57841116@N03,2743,31,1330421260,1330421260,1,2,0
57841116@N03,2744,18,1330487947,1330487947,1,1,0
57841116@N03,2745,35,1330676354,1330684557,2,2,8203
57841116@N03,2745,71,1330685003,1330685003,1,2,0
57841116@N03,2746,53,1331808428,1331808428,1,1,0
57841116@N03,2747,42,1332128084,1332128311,2,3,227
57841116@N03,2747,51,1332120622,1332120657,2,3,35
57841116@N03,2747,73,1332128131,1332136486,5,3,8355
57841116@N03,2748,40,1333252246,1333252246,1,1,0
57841116@N03,2749,14,1333428398,1333428398,1,1,0
57841116@N03,2750,57,1333952651,1333952651,1,1,0
57841116@N03,2751,61,1334378190,1334378190,1,1,0
57841116@N03,2752,1,1334468515,1334468525,2,2,10
57841116@N03,2752,15,1334468161,1334468161,1,2,0
57841116@N03,2753,63,1336110060,1336110105,3,1,45
57841116@N03,2754,47,1337231781,1337231781,1,1,0
57841116@N03,2755,51,1337310447,1337310476,2,2,29
57841116@N03,2755,78,1337311440,1337311440,1,2,0
57841116@N03,2756,32,1337758596,1337758596,1,1,0
57841116@N03,2757,4,1337852776,1337852854,2,2,78
57841116@N03,2757,41,1337845229,1337845229,1,2,0
57841116@N03,2758,39,1338179802,1338179802,1,1,0
57841116@N03,2759,53,1339156948,1339156948,1,2,0
57841116@N03,2759,85,1339138407,1339138407,1,2,0
57841116@N03,2760,85,1340349447,1340349447,1,1,0
57841116@N03,2761,9,1341372228,1341372228,1,2,0
57841116@N03,2761,13,1341385407,1341385407,1,2,0
57841116@N03,2762,50,1341720679,1341720721,2,2,42
57841116@N03,2762,71,1341713797,1341713797,1,2,0
57841116@N03,2763,82,1342171443,1342171443,1,1,0
57841116@N03,2764,8,1342498434,1342498434,1,1,0
57841116@N03,2765,71,1342836914,1342837488,2,1,574
57841116@N03,2766,57,1344000060,1344000060,1,1,0
57841116@N03,2767,53,1345197141,1345197141,1,1,0
57841116@N03,2768,57,1347090938,1347090938,1,1,0
57841116@N03,2769,8,1347942718,1347942718,1,1,0
57841116@N03,2770,44,1349678354,1349686652,3,1,8298
57841116@N03,2771,13,1349769250,1349769250,1,3,0
57841116@N03,2771,70,1349767007,1349767007,1,3,0
57841116@N03,2771,81,1349767106,1349772751,4,3,5645
57841116@N03,2772,76,1351306051,1351306400,2,1,349
57841116@N03,2773,71,1351841201,1351841201,1,1,0
57841116@N03,2774,45,1352968011,1352968011,1,1,0
57841116@N03,2775,35,1353056291,1353056291,1,1,0
57841116@N03,2776,31,1354264072,1354264072,1,1,0
57841116@N03,2777,82,1354876421,1354876421,1,1,0
57841116@N03,2778,36,1355210803,1355210803,1,1,0
57841116@N03,2779,17,1355468702,1355468702,1,2,0
57841116@N03,2779,31,1355470163,1355471519,2,2,1356
57841116@N03,2780,51,1356340732,1356340732,1,1,0
57841116@N03,2781,57,1356493825,1356493825,1,1,0
57841116@N03,2782,57,1356664446,1356664446,1,1,0
57841116@N03,2783,19,1358412629,1358414989,3,1,2360
57841116@N03,2784,42,1360289153,1360289153,1,1,0
57841116@N03,2785,14,1361954272,1361954272,1,1,0
57841116@N03,2786,57,1364789152,1364799296,2,1,10144
57841116@N03,2787,53,1365311645,1365314301,2,2,2656
57841116@N03,2787,85,1365316187,1365316187,1,2,0
57841116@N03,2788,53,1365845593,1365845593,1,1,0
57841116@N03,2789,14,1366185635,1366185635,1,3,0
57841116@N03,2789,15,1366185425,1366185425,1,3,0
57841116@N03,2789,85,1366186962,1366196626,2,3,9664
57841116@N03,2790,57,1367660012,1367660012,1,1,0
57841116@N03,2791,6,1368862665,1368862665,1,1,0
57841116@N03,2792,40,1369730564,1369730564,1,1,0
57841116@N03,2793,14,1371623795,1371623795,1,1,0
57841116@N03,2794,1,1371796291,1371796291,1,1,0
57841116@N03,2795,32,1373011125,1373011125,1,1,0
57841116@N03,2796,57,1373108436,1373110367,2,1,1931
57841116@N03,2797,14,1374046510,1374047390,2,1,880
57841116@N03,2798,14,1374649314,1374649314,1,1,0
57841116@N03,2799,46,1379055534,1379055534,1,2,0
57841116@N03,2799,57,1379072796,1379072796,1,2,0
57841116@N03,2800,57,1379656000,1379669752,4,1,13752
57841116@N03,2801,53,1379822858,1379822858,1,1,0
57841116@N03,2802,44,1383029608,1383029608,1,1,0
57841116@N03,2803,31,1383101315,1383103028,2,1,1713
57841116@N03,2804,3,1383960108,1383960108,1,2,0
57841116@N03,2804,48,1383960265,1383966092,4,2,5827
57841116@N03,2805,81,1384601708,1384601708,1,1,0
57841116@N03,2806,19,1385539645,1385539645,1,1,0
57841116@N03,2807,81,1387443644,1387443644,1,1,0
57841116@N03,2808,39,1387877124,1387877124,1,3,0
57841116@N03,2808,40,1387876641,1387876641,1,3,0
57841116@N03,2808,51,1387882823,1387882823,1,3,0
57841116@N03,2809,57,1388188290,1388188290,1,1,0
57841116@N03,2810,16,1388450733,1388450733,1,1,0
57841116@N03,2811,55,1389589932,1389589932,1,2,0
57841116@N03,2811,56,1389570492,1389581015,2,2,10523
57841116@N03,2812,22,1392344855,1392344855,1,1,0
57841116@N03,2813,35,1393368023,1393368023,1,1,0
57841116@N03,2814,34,1393921961,1393921961,1,1,0
57841116@N03,2815,57,1398057176,1398057176,1,1,0
57841116@N03,2816,14,1398324306,1398324306,1,1,0
57990672@N04,2817,27,1301720435,1301720435,1,1,0
57990672@N04,2818,44,1305967737,1305967737,1,5,0
57990672@N04,2818,50,1305969381,1305970319,3,5,938
57990672@N04,2818,68,1305971358,1305971358,1,5,0
57990672@N04,2818,71,1305973237,1305973237,1,5,0
57990672@N04,2818,81,1305974687,1305974687,1,5,0
58085609@N00,2819,82,1206156865,1206160447,2,1,3582
58085609@N00,2820,28,1206231899,1206240463,50,1,8564
58085609@N00,2821,2,1206410520,1206410520,1,2,0
58085609@N00,2821,32,1206391424,1206391424,1,2,0
58085609@N00,2822,11,1206597729,1206603881,3,1,6152
58085609@N00,2823,84,1206666146,1206670954,2,1,4808
58085609@N00,2824,50,1206940468,1206940468,1,3,0
58085609@N00,2824,75,1206942402,1206942402,1,3,0
58085609@N00,2824,81,1206941263,1206941263,1,3,0
58085609@N00,2825,26,1207028133,1207028190,2,1,57
58085609@N00,2826,21,1207618357,1207618357,1,4,0
58085609@N00,2826,45,1207628335,1207628335,1,4,0
58085609@N00,2826,49,1207632086,1207632973,3,4,887
58085609@N00,2826,76,1207636272,1207636272,1,4,0
58085609@N00,2827,26,1208662372,1208672688,5,1,10316
58085609@N00,2828,37,1208845014,1208845014,1,1,0
58085609@N00,2829,22,1210839820,1210839820,1,2,0
58085609@N00,2829,41,1210831370,1210831370,1,2,0
58085609@N00,2830,1,1210935953,1210940066,2,1,4113
58085609@N00,2831,71,1211077892,1211077892,1,1,0
58085609@N00,2832,30,1212372090,1212372090,1,1,0
58085609@N00,2833,70,1223691336,1223691336,1,1,0
58187332@N00,2834,45,1296205062,1296207293,4,1,2231
58196392@N00,2835,22,1158302523,1158302523,1,2,0
58196392@N00,2835,84,1158310154,1158310154,1,2,0
58196392@N00,2836,82,1190899439,1190899439,1,1,0
58196392@N00,2837,82,1222768310,1222768310,1,1,0
58196392@N00,2838,63,1232947385,1232963131,8,1,15746
58196392@N00,2839,41,1237710300,1237710300,1,3,0
58196392@N00,2839,82,1237695293,1237695293,1,3,0
58196392@N00,2839,84,1237706214,1237706214,1,3,0
58196392@N00,2840,15,1255833480,1255833480,1,1,0
58196392@N00,2841,63,1263701435,1263702250,2,1,815
58197244@N07,2842,85,1294566695,1294566695,1,1,0
58255533@N03,2843,50,1295656537,1295656537,1,1,0
58301516@N00,2844,41,1259385386,1259385386,1,1,0
58301516@N00,2845,11,1259414189,1259421942,7,2,7753
58301516@N00,2845,41,1259415025,1259420282,102,2,5257
58301516@N00,2846,9,1259595713,1259595761,4,5,48
58301516@N00,2846,11,1259590692,1259590730,4,5,38
58301516@N00,2846,35,1259591604,1259591604,1,5,0
58301516@N00,2846,40,1259594043,1259594057,3,5,14
58301516@N00,2846,70,1259591567,1259591584,4,5,17
58301516@N00,2847,26,1260144791,1260144968,4,1,177
58301516@N00,2848,11,1260233742,1260233985,16,2,243
58301516@N00,2848,51,1260233541,1260233541,1,2,0
58314390@N08,2849,35,1373878107,1373878107,1,1,0
58554451@N00,2850,52,1370748043,1370748043,1,3,0
58554451@N00,2850,68,1370747609,1370747609,1,3,0
58554451@N00,2850,71,1370746450,1370746450,1,3,0
58589111@N04,2851,82,1351782296,1351782296,1,1,0
58589111@N04,2852,41,1351905855,1351913178,4,3,7323
58589111@N04,2852,67,1351913924,1351914492,3,3,568
58589111@N04,2852,68,1351913300,1351913300,1,3,0
58589111@N04,2853,82,1352017647,1352018515,4,1,868
58589111@N04,2854,81,1352074066,1352074858,3,1,792
58628203@N04,2855,68,1324540999,1324540999,1,1,0
58628203@N04,2856,32,1341547094,1341547094,1,1,0
58673657@N07,2857,9,1339297759,1339297759,1,3,0
58673657@N07,2857,18,1339297867,1339297867,1,3,0
58673657@N07,2857,23,1339297632,1339297737,3,3,105
58876504@N02,2858,71,1150020932,1150020932,1,1,0
58876504@N02,2859,82,1338946141,1338946141,1,1,0
58876504@N02,2860,48,1396656329,1396656629,2,1,300
59002344@N00,2861,17,1298882983,1298882983,1,1,0
59009185@N08,2862,32,1307162725,1307171570,8,1,8845
59009185@N08,2863,28,1307690129,1307690129,1,2,0
59009185@N08,2863,32,1307669504,1307691244,15,2,21740
59009185@N08,2864,28,1307745612,1307745612,1,1,0
59009185@N08,2865,32,1307780321,1307783285,6,1,2964
59009185@N08,2866,32,1307832876,1307832923,2,1,47
59009185@N08,2867,32,1307872091,1307872605,3,1,514
59009185@N08,2868,32,1308001230,1308001230,1,1,0
59009185@N08,2869,32,1308364370,1308379660,21,1,15290
59009185@N08,2870,32,1308449374,1308450465,5,1,1091
59009185@N08,2871,28,1308972637,1308984904,94,2,12267
59009185@N08,2871,32,1308971454,1308987844,2,2,16390
59099750@N00,2872,17,1342564704,1342564704,1,1,0
59099750@N00,2873,24,1342931432,1342931432,1,1,0
59142238@N02,2874,84,1304134849,1304134849,1,1,0
59149365@N06,2875,32,1296520291,1296520291,1,1,0
59299893@N00,2876,71,1258127520,1258127520,1,1,0
59335517@N02,2877,20,1306635846,1306637494,8,1,1648
59335517@N02,2878,17,1376988425,1376988425,1,1,0
59335517@N02,2879,15,1377931411,1377931448,2,2,37
59335517@N02,2879,71,1377917879,1377933631,46,2,15752
59335517@N02,2880,17,1380170123,1380170123,1,1,0
59335517@N02,2881,13,1385347688,1385347753,4,1,65
59335517@N02,2882,13,1385782062,1385782062,1,1,0
59335517@N02,2883,13,1391226237,1391226237,1,1,0
59335517@N02,2884,71,1392433120,1392433471,10,1,351
59477099@N02,2885,32,1311329177,1311329177,1,1,0
59477099@N02,2886,22,1332075188,1332075193,2,1,5
59477099@N02,2887,35,1333853977,1333853977,1,1,0
59477099@N02,2888,2,1386325421,1386325421,1,2,0
59477099@N02,2888,9,1386324771,1386324771,1,2,0
59551944@N00,2889,44,1237094526,1237094560,3,2,34
59551944@N00,2889,81,1237094581,1237094581,1,2,0
59551944@N00,2890,85,1243384716,1243385056,2,1,340
59551944@N00,2891,15,1244766536,1244766536,1,2,0
59551944@N00,2891,82,1244766273,1244766785,3,2,512
59551944@N00,2892,85,1256257298,1256257768,3,1,470
59551944@N00,2893,57,1257754514,1257754514,1,3,0
59551944@N00,2893,68,1257754537,1257754537,1,3,0
59551944@N00,2893,82,1257755161,1257755631,3,3,470
59551944@N00,2894,28,1266361473,1266361633,4,1,160
59551944@N00,2895,85,1291865589,1291866298,2,1,709
59551944@N00,2896,85,1320806742,1320806929,2,1,187
59551944@N00,2897,85,1361065379,1361065661,3,1,282
59736166@N00,2898,45,1223289185,1223289264,3,1,79
59914680@N00,2899,18,1394409578,1394420492,3,1,10914
59914680@N00,2900,18,1394566773,1394599131,11,1,32358
59914680@N00,2901,18,1396148388,1396148388,1,1,0
59914680@N00,2902,18,1396661970,1396664173,4,1,2203
60111909@N00,2903,21,1377146449,1377146449,1,8,0
60111909@N00,2903,41,1377154343,1377154371,2,8,28
60111909@N00,2903,44,1377158615,1377158615,1,8,0
60111909@N00,2903,45,1377160376,1377167756,11,8,7380
60111909@N00,2903,71,1377155981,1377158143,4,8,2162
60111909@N00,2903,73,1377175649,1377175907,7,8,258
60111909@N00,2903,81,1377158328,1377158468,2,8,140
60111909@N00,2903,84,1377150013,1377150790,2,8,777
60111909@N00,2904,44,1377237982,1377238047,2,7,65
60111909@N00,2904,47,1377226759,1377226759,1,7,0
60111909@N00,2904,50,1377238741,1377239546,2,7,805
60111909@N00,2904,53,1377232248,1377232248,1,7,0
60111909@N00,2904,71,1377238574,1377238574,1,7,0
60111909@N00,2904,73,1377254479,1377254479,1,7,0
60111909@N00,2904,81,1377238263,1377238365,4,7,102
60422641@N04,2905,39,1306555200,1306555214,3,3,14
60422641@N04,2905,41,1306555211,1306555213,2,3,2
60422641@N04,2905,78,1306555208,1306555208,1,3,0
60444977@N00,2906,45,1191160800,1191160800,1,2,0
60444977@N00,2906,82,1191160800,1191160800,1,2,0
60444977@N00,2907,0,1191788471,1191788471,1,10,0
60444977@N00,2907,9,1191771945,1191771970,2,10,25
60444977@N00,2907,13,1191774089,1191774089,1,10,0
60444977@N00,2907,17,1191774676,1191774676,1,10,0
60444977@N00,2907,35,1191780865,1191780865,1,10,0
60444977@N00,2907,36,1191777811,1191779240,4,10,1429
60444977@N00,2907,41,1191775940,1191775940,1,10,0
60444977@N00,2907,44,1191788532,1191788532,1,10,0
60444977@N00,2907,68,1191785805,1191785805,1,10,0
60444977@N00,2907,71,1191783199,1191792838,4,10,9639
60444977@N00,2908,1,1191870432,1191871597,4,9,1165
60444977@N00,2908,9,1191879162,1191879270,6,9,108
60444977@N00,2908,13,1191878412,1191878412,1,9,0
60444977@N00,2908,45,1191859230,1191891600,5,9,32370
60444977@N00,2908,50,1191877683,1191877942,7,9,259
60444977@N00,2908,70,1191878083,1191878083,1,9,0
60444977@N00,2908,71,1191877609,1191882358,3,9,4749
60444977@N00,2908,82,1191862287,1191862832,2,9,545
60444977@N00,2908,84,1191864836,1191865024,2,9,188
60444977@N00,2909,50,1192046952,1192047000,2,3,48
60444977@N00,2909,71,1192017918,1192042962,3,3,25044
60444977@N00,2909,82,1192073424,1192073424,1,3,0
60451415@N00,2910,49,1154718162,1154718877,11,1,715
60451415@N00,2911,2,1154772331,1154772545,6,2,214
60451415@N00,2911,41,1154774325,1154774597,7,2,272
60451415@N00,2912,40,1155386357,1155386357,1,4,0
60451415@N00,2912,57,1155391372,1155391419,2,4,47
60451415@N00,2912,68,1155390544,1155390544,1,4,0
60451415@N00,2912,71,1155387584,1155387584,1,4,0
60514480@N00,2913,4,1355215577,1355229478,2,1,13901
60761620@N03,2914,82,1324526321,1324527879,16,1,1558
60779535@N03,2915,31,1390369377,1390369377,1,1,0
60784457@N00,2916,27,1267577055,1267579171,6,2,2116
60784457@N00,2916,32,1267569458,1267576953,3,2,7495
60797928@N08,2917,3,1336614791,1336614791,1,1,0
60797928@N08,2918,41,1339099010,1339099010,1,1,0
60797928@N08,2919,9,1340310982,1340310982,1,1,0
60797928@N08,2920,40,1340944071,1340944071,1,1,0
60889911@N00,2921,72,1135148308,1135148508,4,1,200
60889911@N00,2922,72,1168738490,1168739067,4,2,577
60889911@N00,2922,78,1168740869,1168740869,1,2,0
60889911@N00,2923,48,1170407775,1170407799,6,1,24
60889911@N00,2924,44,1171442472,1171442472,1,1,0
60889911@N00,2925,82,1171765778,1171765811,2,1,33
60889911@N00,2926,79,1173341564,1173341741,3,1,177
60889911@N00,2927,34,1184391411,1184391561,3,1,150
60889911@N00,2928,68,1195821108,1195821568,2,1,460
60889911@N00,2929,63,1200852080,1200852080,1,1,0
60889911@N00,2930,63,1200882355,1200882355,1,1,0
60889911@N00,2931,39,1285036594,1285036594,1,1,0
60889911@N00,2932,29,1285583327,1285583327,1,1,0
60889911@N00,2933,71,1292053928,1292054559,9,1,631
60889911@N00,2934,35,1302562271,1302562271,1,1,0
60889911@N00,2935,11,1334922618,1334925296,18,1,2678
60889911@N00,2936,0,1336037999,1336037999,1,1,0
60889911@N00,2937,20,1348316170,1348316342,4,1,172
60889911@N00,2938,20,1348405880,1348410538,42,1,4658
60889911@N00,2939,20,1350822234,1350822234,1,1,0
60889911@N00,2940,20,1351840901,1351863794,51,1,22893
60889911@N00,2941,20,1351928476,1351934040,63,1,5564
60889911@N00,2942,11,1388837642,1388842055,5,1,4413
60949919@N08,2943,36,1366256605,1366256605,1,2,0
60949919@N08,2943,69,1366262651,1366262912,2,2,261
60949919@N08,2944,81,1366450470,1366451211,2,1,741
60949919@N08,2945,23,1366507636,1366507636,1,2,0
60949919@N08,2945,50,1366505390,1366505390,1,2,0
61048402@N08,2946,2,1311645879,1311645879,1,1,0
61077563@N00,2947,26,1184136798,1184136798,1,1,0
61077563@N00,2948,26,1185171721,1185172077,5,1,356
61077563@N00,2949,26,1185247943,1185251565,4,1,3622
61077563@N00,2950,50,1371603414,1371606365,17,1,2951
61077563@N00,2951,35,1376876592,1376877901,8,1,1309
61077563@N00,2952,22,1381189397,1381194242,29,1,4845
61104031@N02,2953,39,1301104800,1301104803,4,2,3
61104031@N02,2953,41,1301104807,1301104808,2,2,1
61327673@N05,2954,70,1314505874,1314505874,1,1,0
61533954@N00,2955,50,1323217434,1323217434,1,2,0
61533954@N00,2955,71,1323217040,1323217040,1,2,0
61579728@N05,2956,5,1370155214,1370155225,3,5,11
61579728@N05,2956,29,1370156288,1370156855,44,5,567
61579728@N05,2956,31,1370156984,1370157219,26,5,235
61579728@N05,2956,35,1370161934,1370161934,1,5,0
61579728@N05,2956,85,1370157895,1370159092,25,5,1197
61579728@N05,2957,21,1390379346,1390380669,45,2,1323
61579728@N05,2957,42,1390374030,1390374137,5,2,107
61663261@N00,2958,25,1149264448,1149264448,1,1,0
61705015@N00,2959,32,1284185268,1284185273,2,1,5
61705015@N00,2960,71,1296642764,1296643804,4,1,1040
61705015@N00,2961,70,1303277363,1303278009,3,1,646
61705015@N00,2962,70,1305957379,1305957379,1,1,0
61705015@N00,2963,35,1310768140,1310768227,6,1,87
61705015@N00,2964,37,1325476369,1325480213,4,1,3844
61705015@N00,2965,23,1334378975,1334378975,1,1,0
61705015@N00,2966,15,1339738977,1339747663,3,2,8686
61705015@N00,2966,32,1339738983,1339738993,4,2,10
61705015@N00,2967,44,1339843857,1339843857,1,1,0
61705015@N00,2968,13,1356767894,1356767894,1,2,0
61705015@N00,2968,32,1356761114,1356763537,2,2,2423
61828331@N00,2969,41,1232055096,1232055096,1,1,0
61993185@N00,2970,31,1117097590,1117098260,2,1,670
61993185@N00,2971,31,1117275134,1117291131,10,1,15997
61993185@N00,2972,31,1117367411,1117377308,3,1,9897
61993185@N00,2973,31,1117449070,1117449070,1,1,0
61993185@N00,2974,31,1117630725,1117646958,3,1,16233
61993185@N00,2975,31,1117693622,1117709591,13,1,15969
61993185@N00,2976,31,1117780433,1117780433,1,1,0
61993185@N00,2977,31,1118136583,1118186165,10,1,49582
61993185@N00,2978,31,1118227477,1118227477,1,1,0
61993185@N00,2979,31,1134691526,1134695646,40,1,4120
62003631@N00,2980,68,1288160743,1288160743,1,1,0
62003934@N05,2981,26,1323057693,1323064358,9,1,6665
62306794@N05,2982,63,1294984811,1294984811,1,1,0
62308216@N00,2983,26,1156568606,1156568606,1,1,0
62308216@N00,2984,14,1343314322,1343314322,1,2,0
62308216@N00,2984,15,1343314620,1343314620,1,2,0
62318115@N00,2985,9,1312611529,1312611529,1,1,0
62318115@N00,2986,21,1312677168,1312677168,1,1,0
62406264@N00,2987,81,1225597954,1225597954,1,1,0
62433076@N00,2988,55,1264377485,1264377485,1,2,0
62433076@N00,2988,63,1264390176,1264415234,7,2,25058
62569532@N00,2989,45,1333082602,1333082602,1,1,0
62569532@N00,2990,28,1334112435,1334112435,1,1,0
62606667@N04,2991,20,1297850874,1297850874,1,1,0
62606667@N04,2992,32,1304745916,1304745916,1,1,0
62606667@N04,2993,31,1309675831,1309675831,1,1,0
62606667@N04,2994,82,1315036836,1315036836,1,1,0
62606667@N04,2995,50,1318742258,1318743838,4,2,1580
62606667@N04,2995,71,1318742807,1318743510,8,2,703
62606667@N04,2996,71,1320465533,1320467261,3,1,1728
62606667@N04,2997,25,1324700326,1324702438,4,1,2112
62606667@N04,2998,49,1324946376,1324946814,2,2,438
62606667@N04,2998,74,1324951155,1324951512,3,2,357
62608648@N05,2999,71,1307943930,1307943930,1,1,0
62628278@N00,3000,28,1348159661,1348191231,10,1,31570
62628278@N00,3001,27,1377923139,1377923139,1,1,0
62744044@N00,3002,26,1368604166,1368604166,1,3,0
62744044@N00,3002,35,1368589906,1368589906,1,3,0
62744044@N00,3002,84,1368591778,1368598261,2,3,6483
62744044@N00,3003,8,1368669986,1368671803,2,2,1817
62744044@N00,3003,50,1368673369,1368673369,1,2,0
62744044@N00,3004,9,1368754916,1368754916,1,4,0
62744044@N00,3004,32,1368771093,1368771093,1,4,0
62744044@N00,3004,71,1368775100,1368775100,1,4,0
62744044@N00,3004,82,1368756268,1368756268,1,4,0
62811324@N02,3005,49,1334187978,1334188057,3,1,79
62948807@N00,3006,17,1395878953,1395878953,1,1,0
62948807@N00,3007,17,1396250488,1396250488,1,3,0
62948807@N00,3007,32,1396247448,1396247448,1,3,0
62948807@N00,3007,82,1396243520,1396243520,1,3,0
62975981@N05,3008,41,1348323580,1348323580,1,1,0
62975981@N05,3009,86,1349409663,1349410096,2,1,433
62994633@N00,3010,42,1252033273,1252033273,1,1,0
62994633@N00,3011,38,1252482357,1252482357,1,1,0
62994633@N00,3012,32,1253245554,1253245554,1,1,0
62994633@N00,3013,32,1253335499,1253335499,1,1,0
62994633@N00,3014,15,1253675274,1253675274,1,2,0
62994633@N00,3014,17,1253677066,1253677066,1,2,0
62994633@N00,3015,38,1254273526,1254273526,1,1,0
62994633@N00,3016,53,1258716499,1258716499,1,1,0
63022030@N00,3017,2,1310451677,1310451677,1,4,0
63022030@N00,3017,3,1310451338,1310451338,1,4,0
63022030@N00,3017,69,1310448192,1310448192,1,4,0
63022030@N00,3017,82,1310451249,1310451249,1,4,0
63086363@N00,3018,12,1244262714,1244262714,1,2,0
63086363@N00,3018,20,1244254671,1244256558,2,2,1887
63086363@N00,3019,2,1325122762,1325123210,2,2,448
63086363@N00,3019,3,1325129677,1325130359,3,2,682
63086363@N00,3020,2,1325239093,1325239093,1,2,0
63086363@N00,3020,40,1325241625,1325241625,1,2,0
63086363@N00,3021,3,1332553860,1332553860,1,1,0
63086363@N00,3022,39,1338500830,1338500830,1,1,0
63086363@N00,3023,2,1338681355,1338681355,1,1,0
63183225@N03,3024,71,1279850458,1279850458,1,1,0
63183225@N03,3025,27,1309320630,1309320630,1,1,0
63183225@N03,3026,14,1310192020,1310192020,1,1,0
63183225@N03,3027,14,1310521615,1310521615,1,1,0
63183225@N03,3028,68,1311558110,1311578767,2,1,20657
63183225@N03,3029,45,1314949750,1314961937,3,1,12187
63183225@N03,3030,46,1319257008,1319257008,1,1,0
63183225@N03,3031,46,1319290418,1319290418,1,1,0
63183225@N03,3032,25,1319608906,1319608906,1,1,0
63183225@N03,3033,19,1321563129,1321563500,3,1,371
63238390@N00,3034,25,1363036680,1363036680,1,3,0
63238390@N00,3034,71,1363034471,1363044878,3,3,10407
63238390@N00,3034,82,1363044732,1363044732,1,3,0
63238390@N00,3035,58,1363472980,1363506946,3,1,33966
63238390@N00,3036,27,1363564830,1363564868,2,1,38
63238390@N00,3037,28,1363656601,1363656607,2,1,6
63238390@N00,3038,71,1371988566,1371988566,1,1,0
63238390@N00,3039,81,1372070635,1372070635,1,1,0
63287673@N00,3040,9,1246502943,1246502943,1,1,0
63287673@N00,3041,82,1247048893,1247048893,1,1,0
63287673@N00,3042,0,1247967922,1247967922,1,3,0
63287673@N00,3042,78,1247974303,1247974303,1,3,0
63287673@N00,3042,81,1247966894,1247966894,1,3,0
63287673@N00,3043,82,1248087145,1248087145,1,1,0
63287673@N00,3044,9,1249468811,1249468811,1,1,0
63287673@N00,3045,84,1261108108,1261108108,1,1,0
63287673@N00,3046,32,1263357025,1263357025,1,1,0
63287673@N00,3047,70,1264300131,1264300131,1,3,0
63287673@N00,3047,71,1264298227,1264298293,2,3,66
63287673@N00,3047,82,1264295152,1264295152,1,3,0
63287673@N00,3048,35,1348207802,1348207802,1,1,0
63287673@N00,3049,82,1349155649,1349155649,2,1,0
63287673@N00,3050,63,1353145161,1353145161,1,1,0
63287673@N00,3051,47,1356070034,1356070034,1,1,0
63287673@N00,3052,4,1358122966,1358122966,1,1,0
63287673@N00,3053,4,1361261383,1361261383,1,1,0
63287673@N00,3054,24,1361325308,1361325308,1,1,0
63287673@N00,3055,22,1361597379,1361597379,1,1,0
63287673@N00,3056,14,1363928053,1363928053,1,1,0
63287673@N00,3057,32,1367375733,1367375733,1,1,0
63287673@N00,3058,9,1371093427,1371093427,1,1,0
63287673@N00,3059,47,1377734660,1377734660,1,1,0
63287673@N00,3060,8,1380778327,1380778327,1,1,0
63287673@N00,3061,71,1385262180,1385262180,1,1,0
63287673@N00,3062,0,1387593237,1387593237,1,3,0
63287673@N00,3062,31,1387594440,1387594440,1,3,0
63287673@N00,3062,71,1387597495,1387601428,2,3,3933
63287673@N00,3063,13,1392081553,1392081553,1,1,0
63287673@N00,3064,24,1394700705,1394700705,1,2,0
63287673@N00,3064,84,1394706007,1394706007,1,2,0
63357531@N00,3065,11,1166584889,1166588458,13,1,3569
63357531@N00,3066,11,1168823887,1168824163,3,2,276
63357531@N00,3066,13,1168828005,1168828105,6,2,100
63357531@N00,3067,50,1177421182,1177423779,2,1,2597
63357531@N00,3068,22,1187848984,1187849013,2,2,29
63357531@N00,3068,50,1187850181,1187850557,12,2,376
63357531@N00,3069,11,1191082248,1191082248,1,1,0
63357531@N00,3070,41,1193004025,1193004025,1,1,0
63357531@N00,3071,71,1194227808,1194227808,1,1,0
63357531@N00,3072,13,1194315339,1194315794,11,6,455
63357531@N00,3072,37,1194310810,1194310813,4,6,3
63357531@N00,3072,50,1194313601,1194314094,16,6,493
63357531@N00,3072,70,1194316482,1194316536,2,6,54
63357531@N00,3072,71,1194313752,1194317657,16,6,3905
63357531@N00,3072,82,1194316943,1194317116,2,6,173
63357531@N00,3073,9,1195873970,1195874123,7,1,153
63357531@N00,3074,30,1195971665,1195971665,1,1,0
63357531@N00,3075,17,1198326224,1198330344,2,1,4120
63357531@N00,3076,68,1199169040,1199183583,10,1,14543
63357531@N00,3077,9,1200288708,1200289212,10,2,504
63357531@N00,3077,84,1200284789,1200286013,6,2,1224
63357531@N00,3078,40,1200663249,1200672547,10,1,9298
63357531@N00,3079,19,1203986504,1203986859,22,1,355
63357531@N00,3080,41,1204084245,1204084245,1,1,0
63357531@N00,3081,3,1204437918,1204437918,1,2,0
63357531@N00,3081,11,1204431311,1204433439,12,2,2128
63357531@N00,3082,11,1205990430,1205990518,2,1,88
63357531@N00,3083,40,1207917316,1207932852,21,1,15536
63357531@N00,3084,9,1207975203,1207975217,2,3,14
63357531@N00,3084,35,1207975746,1207975746,1,3,0
63357531@N00,3084,71,1207978514,1207984758,9,3,6244
63357531@N00,3085,9,1208072203,1208072689,5,1,486
63357531@N00,3086,71,1209275473,1209275473,1,1,0
63357531@N00,3087,18,1212936843,1212947812,11,1,10969
63357531@N00,3088,81,1213373541,1213373541,1,1,0
63357531@N00,3089,69,1213414306,1213415187,7,2,881
63357531@N00,3089,81,1213418197,1213418634,6,2,437
63357531@N00,3090,13,1213507621,1213507621,1,1,0
63357531@N00,3091,9,1213934742,1213934742,1,4,0
63357531@N00,3091,18,1213942518,1213942518,1,4,0
63357531@N00,3091,22,1213934200,1213934288,5,4,88
63357531@N00,3091,50,1213943429,1213943794,10,4,365
63357531@N00,3092,50,1216529701,1216530384,15,3,683
63357531@N00,3092,70,1216530660,1216530660,1,3,0
63357531@N00,3092,71,1216529573,1216529657,3,3,84
63357531@N00,3093,11,1218082386,1218082424,3,1,38
63357531@N00,3094,9,1233622461,1233622461,1,3,0
63357531@N00,3094,18,1233630972,1233631294,4,3,322
63357531@N00,3094,32,1233627810,1233628963,2,3,1153
63357531@N00,3095,11,1246079113,1246079113,1,1,0
63467359@N00,3096,49,1241323076,1241354316,14,1,31240
63467359@N00,3097,7,1243988215,1243988273,2,2,58
63467359@N00,3097,30,1243988094,1243988094,1,2,0
63467359@N00,3098,30,1245294545,1245294554,2,1,9
63467359@N00,3099,30,1245329784,1245329784,1,1,0
63467359@N00,3100,50,1246233206,1246233206,1,1,0
63467359@N00,3101,41,1269501695,1269501695,1,1,0
63467359@N00,3102,41,1281656184,1281656184,1,1,0
63467359@N00,3103,71,1320970601,1320970603,2,1,2
63467359@N00,3104,46,1328341857,1328348294,2,1,6437
63467359@N00,3105,71,1336879871,1336879898,2,1,27
63467359@N00,3106,50,1349177163,1349177170,3,1,7
63467359@N00,3107,26,1350789594,1350789594,1,1,0
63467359@N00,3108,22,1386629659,1386629878,6,1,219
63806164@N03,3109,41,1371469930,1371469930,1,2,0
63806164@N03,3109,81,1371473644,1371473644,1,2,0
63897193@N00,3110,32,1295612317,1295612317,1,2,0
63897193@N00,3110,63,1295637003,1295637003,1,2,0
63906808@N00,3111,49,1146929238,1146929238,2,1,0
63906808@N00,3112,25,1285370284,1285370284,1,1,0
63906808@N00,3113,57,1285993207,1285993207,1,1,0
63906808@N00,3114,31,1330476402,1330476402,1,1,0
63906808@N00,3115,71,1337429676,1337434754,5,1,5078
63906808@N00,3116,14,1370600915,1370611801,7,1,10886
64015960@N00,3117,32,1138243789,1138243789,1,1,0
64015960@N00,3118,27,1142677613,1142677613,1,1,0
64015960@N00,3119,57,1142733403,1142733403,1,1,0
64015960@N00,3120,68,1143282969,1143282969,1,1,0
64015960@N00,3121,35,1147558070,1147558070,1,1,0
64015960@N00,3122,26,1149244378,1149247098,3,1,2720
64015960@N00,3123,49,1149318828,1149318828,1,1,0
64015960@N00,3124,72,1152422429,1152422429,1,2,0
64015960@N00,3124,78,1152421416,1152421416,1,2,0
64015960@N00,3125,45,1152880843,1152880843,1,1,0
64015960@N00,3126,8,1152964093,1152964093,1,1,0
64015960@N00,3127,39,1154821094,1154821094,1,6,0
64015960@N00,3127,40,1154821483,1154822017,2,6,534
64015960@N00,3127,48,1154824330,1154824330,1,6,0
64015960@N00,3127,49,1154834275,1154834634,3,6,359
64015960@N00,3127,50,1154817656,1154817656,1,6,0
64015960@N00,3127,70,1154818218,1154818218,1,6,0
64015960@N00,3128,19,1159053763,1159053763,1,3,0
64015960@N00,3128,32,1159062743,1159062743,1,3,0
64015960@N00,3128,35,1159060742,1159060742,1,3,0
64015960@N00,3129,49,1169770111,1169770967,2,1,856
64015960@N00,3130,35,1177478013,1177478013,1,1,0
64015960@N00,3131,81,1177589402,1177589402,1,1,0
64015960@N00,3132,68,1178881016,1178882980,3,1,1964
64015960@N00,3133,21,1178921036,1178923092,6,1,2056
64015960@N00,3134,14,1182560221,1182560221,1,3,0
64015960@N00,3134,32,1182554948,1182554948,1,3,0
64015960@N00,3134,68,1182563578,1182563700,2,3,122
64015960@N00,3135,82,1191734068,1191734068,1,1,0
64105330@N08,3136,50,1316915062,1316915062,1,1,0
64292684@N00,3137,53,1369470043,1369470043,1,1,0
64323230@N00,3138,2,1217489042,1217493402,3,1,4360
64332066@N00,3139,15,1089780075,1089780075,1,2,0
64332066@N00,3139,45,1089779958,1089779958,1,2,0
64332066@N00,3140,33,1089862582,1089862582,1,2,0
64332066@N00,3140,49,1089857886,1089858262,3,2,376
64665189@N00,3141,39,1205661557,1205661557,1,1,0
64665189@N00,3142,19,1275619513,1275619599,2,2,86
64665189@N00,3142,32,1275623646,1275623985,12,2,339
64665189@N00,3143,39,1299237221,1299237221,1,1,0
64665189@N00,3144,35,1301905100,1301905100,1,1,0
64665189@N00,3145,2,1311774436,1311774436,1,1,0
64665189@N00,3146,68,1314931519,1314931519,1,1,0
64759385@N00,3147,2,1331681077,1331681077,1,1,0
64778219@N00,3148,28,1388543304,1388549448,2,1,6144
64778219@N00,3149,70,1391864307,1391864307,1,1,0
64885532@N00,3150,84,1171163824,1171163824,1,1,0
64885532@N00,3151,32,1176106572,1176106671,5,1,99
64885532@N00,3152,14,1200547322,1200547337,2,2,15
64885532@N00,3152,40,1200559797,1200559804,2,2,7
64885532@N00,3153,76,1201316801,1201316806,2,1,5
64885532@N00,3154,70,1203510129,1203510302,2,1,173
64885532@N00,3155,30,1203564740,1203583100,11,2,18360
64885532@N00,3155,49,1203586335,1203586335,1,2,0
64885532@N00,3156,32,1204272047,1204272047,1,1,0
64885532@N00,3157,84,1244362072,1244362344,16,1,272
64885532@N00,3158,70,1349512336,1349512336,1,1,0
64885532@N00,3159,23,1349586763,1349586763,1,1,0
64890465@N05,3160,41,1350727480,1350727480,1,1,0
64890465@N05,3161,71,1361623269,1361623269,1,1,0
65029273@N00,3162,29,1355728257,1355728257,1,1,0
65029273@N00,3163,82,1356679047,1356679047,1,1,0
65029273@N00,3164,29,1357111343,1357111343,1,1,0
65029273@N00,3165,11,1360717715,1360717715,1,1,0
65029273@N00,3166,84,1365645162,1365645162,1,1,0
65029273@N00,3167,35,1366362829,1366362829,1,1,0
65032901@N00,3168,85,1216193254,1216193254,1,1,0
65032901@N00,3169,27,1246334574,1246334574,1,1,0
65032901@N00,3170,27,1246509196,1246509196,1,1,0
65032901@N00,3171,23,1246614699,1246614699,1,2,0
65032901@N00,3171,32,1246613989,1246614133,2,2,144
65032901@N00,3172,51,1246697396,1246697396,1,1,0
65032901@N00,3173,85,1249614050,1249614050,1,1,0
65032901@N00,3174,35,1250829442,1250829442,1,1,0
65032901@N00,3175,85,1256002854,1256002854,1,1,0
65032901@N00,3176,32,1266057134,1266057134,1,1,0
65032901@N00,3177,85,1276832707,1276832707,1,1,0
65032901@N00,3178,1,1291379324,1291379324,1,1,0
65072601@N00,3179,20,1242963318,1242963917,2,1,599
65181764@N07,3180,82,1344735184,1344735184,1,1,0
65181764@N07,3181,82,1345275855,1345275855,1,1,0
65194286@N04,3182,68,1380533597,1380533597,1,1,0
65194286@N04,3183,41,1380633643,1380633643,1,1,0
65238296@N06,3184,71,1386406087,1386406087,1,1,0
65578066@N00,3185,50,1342840765,1342840765,1,1,0
65638600@N05,3186,28,1347335292,1347336091,2,1,799
65638600@N05,3187,2,1347414138,1347414138,1,3,0
65638600@N05,3187,47,1347421893,1347422976,2,3,1083
65638600@N05,3187,48,1347414570,1347416656,3,3,2086
65638600@N05,3188,73,1347525192,1347525192,1,1,0
65638600@N05,3189,71,1347581847,1347581847,1,1,0
65638600@N05,3190,28,1348684626,1348684626,1,1,0
65638600@N05,3191,28,1349089397,1349089397,1,1,0
65646846@N07,3192,21,1350272790,1350272790,1,1,0
65646846@N07,3193,45,1350367559,1350367662,2,1,103
65646846@N07,3194,45,1350432440,1350432440,1,1,0
65749227@N00,3195,4,1339536678,1339536678,1,1,0
65749227@N00,3196,82,1360575702,1360575702,1,1,0
65749227@N00,3197,18,1360651756,1360651756,1,1,0
65749227@N00,3198,0,1365541980,1365541980,1,1,0
65779544@N00,3199,44,1140421893,1140421925,2,1,32
65779544@N00,3200,32,1143964315,1143964547,3,1,232
65779544@N00,3201,9,1144669469,1144669469,1,3,0
65779544@N00,3201,23,1144655784,1144657572,5,3,1788
65779544@N00,3201,32,1144656629,1144656670,2,3,41
65779544@N00,3202,44,1151909074,1151909074,1,1,0
65779544@N00,3203,31,1152439310,1152439783,4,1,473
65779544@N00,3204,50,1152513217,1152513217,1,1,0
65779544@N00,3205,71,1152851800,1152851849,2,1,49
65779544@N00,3206,70,1156670852,1156670852,1,1,0
65779544@N00,3207,32,1156924987,1156924987,1,1,0
65779544@N00,3208,20,1159510184,1159510184,1,1,0
65779544@N00,3209,85,1214982076,1214982076,1,1,0
65779544@N00,3210,9,1215072776,1215072776,1,2,0
65779544@N00,3210,35,1215079324,1215079324,1,2,0
65779544@N00,3211,20,1260351136,1260351136,1,1,0
65779544@N00,3212,20,1260594842,1260594842,1,1,0
65779544@N00,3213,26,1260783468,1260783468,1,1,0
65779544@N00,3214,22,1261104046,1261104046,1,1,0
65779544@N00,3215,71,1262937130,1262937641,2,1,511
65779544@N00,3216,29,1263092047,1263092058,2,2,11
65779544@N00,3216,75,1263092040,1263092040,1,2,0
65779544@N00,3217,22,1263363221,1263363221,1,1,0
65779544@N00,3218,22,1263438099,1263438107,2,2,8
65779544@N00,3218,35,1263449318,1263449318,1,2,0
65779544@N00,3219,22,1263519415,1263519450,2,2,35
65779544@N00,3219,37,1263519486,1263519495,2,2,9
65779544@N00,3220,22,1264729362,1264729362,1,1,0
65779544@N00,3221,23,1265354349,1265354349,1,2,0
65779544@N00,3221,84,1265353388,1265353388,1,2,0
65779544@N00,3222,22,1265922449,1265922449,1,1,0
65779544@N00,3223,11,1266042040,1266044373,2,1,2333
65779544@N00,3224,31,1266122241,1266122241,1,1,0
65779544@N00,3225,82,1266481730,1266481730,1,1,0
65779544@N00,3226,22,1266899919,1266899919,1,1,0
65779544@N00,3227,35,1267079644,1267079644,1,1,0
65779544@N00,3228,8,1268542792,1268542865,4,1,73
65779544@N00,3229,8,1269754259,1269754815,5,1,556
65779544@N00,3230,31,1270967557,1270967715,2,1,158
65779544@N00,3231,51,1271498799,1271498799,1,1,0
65779544@N00,3232,20,1272695493,1272695493,1,1,0
65779544@N00,3233,8,1273386158,1273386178,3,2,20
65779544@N00,3233,32,1273387940,1273387940,1,2,0
65779544@N00,3234,22,1273554076,1273554076,1,1,0
65779544@N00,3235,22,1274828855,1274828855,1,1,0
65779544@N00,3236,71,1276157454,1276172266,2,1,14812
65987590@N00,3237,32,1167032184,1167032184,1,1,0
65987590@N00,3238,82,1179658687,1179658687,1,1,0
65987590@N00,3239,19,1195691790,1195691790,1,1,0
65987590@N00,3240,9,1217603667,1217603667,1,1,0
65987590@N00,3241,39,1221033000,1221033000,1,1,0
65987590@N00,3242,82,1234599039,1234599039,1,1,0
65999620@N00,3243,86,1329038577,1329038577,1,1,0
66099107@N00,3244,39,1326060794,1326060794,1,1,0
66108444@N00,3245,26,1151630678,1151633377,2,1,2699
66108444@N00,3246,14,1312089959,1312090035,2,1,76
66108444@N00,3247,35,1372004385,1372004385,1,1,0
66172503@N00,3248,0,1387839894,1387839894,1,13,0
66172503@N00,3248,4,1387841513,1387849668,2,13,8155
66172503@N00,3248,21,1387849755,1387849836,2,13,81
66172503@N00,3248,31,1387839975,1387839975,1,13,0
66172503@N00,3248,32,1387841406,1387841406,1,13,0
66172503@N00,3248,35,1387841282,1387841282,1,13,0
66172503@N00,3248,40,1387849904,1387849904,1,13,0
66172503@N00,3248,41,1387849525,1387849525,1,13,0
66172503@N00,3248,50,1387840583,1387840856,2,13,273
66172503@N00,3248,70,1387841168,1387841168,1,13,0
66172503@N00,3248,71,1387840924,1387841058,2,13,134
66172503@N00,3248,81,1387839508,1387839754,2,13,246
66172503@N00,3248,82,1387840328,1387840787,3,13,459
66441426@N00,3249,14,1161144684,1161144684,1,1,0
66441426@N00,3250,14,1162780643,1162780643,1,1,0
66441426@N00,3251,14,1163407116,1163407250,2,1,134
66441426@N00,3252,14,1163558092,1163558092,1,1,0
66441426@N00,3253,0,1163779002,1163779002,1,1,0
66441426@N00,3254,53,1163930549,1163932093,2,1,1544
66441426@N00,3255,14,1164179191,1164179191,1,1,0
66441426@N00,3256,14,1164258683,1164258683,1,1,0
66441426@N00,3257,14,1164335298,1164335298,1,1,0
66441426@N00,3258,2,1164877643,1164885816,3,1,8173
66441426@N00,3259,13,1241127509,1241127509,1,1,0
66441426@N00,3260,35,1243410445,1243410445,1,1,0
66441426@N00,3261,57,1243757804,1243757804,1,2,0
66441426@N00,3261,68,1243736100,1243736100,1,2,0
66441426@N00,3262,38,1381280168,1381280168,1,2,0
66441426@N00,3262,73,1381280037,1381280037,1,2,0
66545005@N00,3263,22,1297637775,1297637775,1,1,0
66545005@N00,3264,28,1300781175,1300781175,1,1,0
66545005@N00,3265,85,1301126519,1301126727,2,1,208
66545005@N00,3266,9,1314069020,1314069020,1,1,0
66545005@N00,3267,86,1315122295,1315122295,1,1,0
66545005@N00,3268,57,1317447316,1317447316,1,1,0
66545005@N00,3269,22,1335166975,1335166975,1,1,0
66598853@N00,3270,68,1232169813,1232170861,5,1,1048
66647015@N06,3271,35,1366531397,1366531397,1,4,0
66647015@N06,3271,43,1366510311,1366510311,1,4,0
66647015@N06,3271,72,1366514012,1366514012,1,4,0
66647015@N06,3271,81,1366506332,1366511559,3,4,5227
66847065@N00,3272,57,1023627129,1023631981,2,1,4852
66883888@N00,3273,25,1369902781,1369915684,2,1,12903
66883888@N00,3274,21,1370124247,1370126978,4,3,2731
66883888@N00,3274,22,1370117698,1370119151,3,3,1453
66883888@N00,3274,49,1370142884,1370142960,2,3,76
66883888@N00,3275,82,1370345685,1370346136,2,1,451
66903660@N00,3276,0,1247102510,1247102510,1,2,0
66903660@N00,3276,71,1247102831,1247103523,7,2,692
66917829@N03,3277,8,1340245686,1340245686,1,1,0
66917829@N03,3278,4,1379399381,1379399381,1,1,0
66917829@N03,3279,41,1381981839,1381981839,1,1,0
66917829@N03,3280,14,1385362381,1385362398,2,1,17
66917829@N03,3281,63,1393536871,1393536893,2,1,22
67008765@N00,3282,34,1198017651,1198017709,2,2,58
67008765@N00,3282,49,1198017630,1198026766,8,2,9136
67008765@N00,3283,81,1198103463,1198103471,2,1,8
67008765@N00,3284,26,1198985717,1198985717,1,1,0
67008765@N00,3285,48,1199328065,1199328074,2,1,9
67008765@N00,3286,81,1203622910,1203623459,16,1,549
67072963@N00,3287,26,1394703340,1394748505,6,2,45165
67072963@N00,3287,66,1394714851,1394723862,2,2,9011
67072963@N00,3288,28,1394889397,1394892672,23,2,3275
67072963@N00,3288,58,1394883266,1394883675,34,2,409
67148357@N00,3289,24,1126791171,1126791171,1,1,0
67148357@N00,3290,68,1214838108,1214838108,1,1,0
67148357@N00,3291,68,1214913603,1214913615,2,2,12
67148357@N00,3291,86,1214918836,1214918836,1,2,0
67320365@N05,3292,23,1360464648,1360464648,1,1,0
67320365@N05,3293,22,1364363452,1364363452,1,2,0
67320365@N05,3293,41,1364363098,1364363667,2,2,569
67387391@N00,3294,28,1147491389,1147500560,9,1,9171
67400170@N05,3295,8,1382693770,1382693981,7,1,211
67407461@N00,3296,26,1342263356,1342263356,1,2,0
67407461@N00,3296,52,1342249706,1342249706,1,2,0
67594876@N08,3297,49,1321058522,1321058522,1,1,0
67663596@N03,3298,68,1376052434,1376052434,1,2,0
67663596@N03,3298,71,1376035298,1376035298,1,2,0
67774014@N00,3299,13,1321322690,1321322690,1,2,0
67774014@N00,3299,50,1321306454,1321306454,1,2,0
67774014@N00,3300,15,1322276198,1322276198,1,1,0
67774014@N00,3301,2,1345272817,1345274508,3,1,1691
67774014@N00,3302,50,1345503784,1345503784,1,1,0
67774014@N00,3303,18,1345710720,1345710720,1,1,0
67774014@N00,3304,9,1348973335,1348973335,1,2,0
67774014@N00,3304,41,1348973074,1348973284,2,2,210
67774014@N00,3305,41,1349507652,1349507652,1,1,0
67774014@N00,3306,11,1349569127,1349569127,1,1,0
67774014@N00,3307,8,1357348870,1357348926,2,1,56
67774014@N00,3308,18,1358213916,1358213916,1,2,0
67774014@N00,3308,50,1358217661,1358217661,1,2,0
67774014@N00,3309,85,1358300367,1358302112,2,1,1745
67774014@N00,3310,18,1358836684,1358836684,1,1,0
67774014@N00,3311,70,1359059493,1359059493,1,1,0
67774014@N00,3312,8,1359156700,1359156700,1,1,0
67774014@N00,3313,82,1359494731,1359494731,1,1,0
67774014@N00,3314,70,1359923655,1359923741,2,1,86
67774014@N00,3315,85,1362186029,1362186029,1,1,0
67774014@N00,3316,4,1363902592,1363902592,1,2,0
67774014@N00,3316,84,1363926486,1363926486,1,2,0
67774014@N00,3317,32,1365212074,1365212074,1,1,0
67774014@N00,3318,50,1365295461,1365295461,1,1,0
67774014@N00,3319,35,1365373557,1365373557,1,1,0
67774014@N00,3320,2,1367565703,1367565703,1,1,0
67774014@N00,3321,35,1367713323,1367713323,1,1,0
67774014@N00,3322,71,1368690262,1368690262,1,1,0
67774014@N00,3323,70,1368777019,1368777019,1,1,0
67774014@N00,3324,70,1369036189,1369036189,1,1,0
67774014@N00,3325,50,1369252723,1369252723,1,2,0
67774014@N00,3325,70,1369261528,1369261528,1,2,0
67774014@N00,3326,13,1369730533,1369730533,1,1,0
67774014@N00,3327,13,1369786397,1369786397,1,1,0
67774014@N00,3328,13,1370136770,1370136770,1,1,0
67774014@N00,3329,45,1370507976,1370507976,1,1,0
67774014@N00,3330,22,1376980352,1376980352,1,1,0
67774014@N00,3331,22,1377066799,1377066799,1,1,0
67774014@N00,3332,82,1377160583,1377160583,1,1,0
67774014@N00,3333,8,1377408461,1377408461,1,1,0
67774014@N00,3334,35,1379320801,1379320801,1,1,0
67774014@N00,3335,85,1388730840,1388730840,1,1,0
67774014@N00,3336,17,1390368754,1390368754,1,1,0
67774014@N00,3337,70,1390514539,1390514539,1,1,0
67774014@N00,3338,17,1390628457,1390628457,1,3,0
67774014@N00,3338,35,1390627764,1390627764,1,3,0
67774014@N00,3338,70,1390628022,1390628022,1,3,0
67774014@N00,3339,85,1390980008,1390980008,1,1,0
67774014@N00,3340,70,1391031585,1391031585,1,1,0
67774014@N00,3341,23,1392091286,1392091286,1,1,0
67774014@N00,3342,84,1392160151,1392160151,1,1,0
67774014@N00,3343,17,1392316754,1392316754,1,1,0
67774014@N00,3344,13,1396911331,1396911331,1,1,0
67774014@N00,3345,13,1396992304,1396992304,1,1,0
68132273@N00,3346,73,1255647235,1255647235,1,1,0
68132273@N00,3347,23,1322693574,1322693574,1,2,0
68132273@N00,3347,25,1322711694,1322711694,1,2,0
68132273@N00,3348,22,1322826495,1322826495,1,1,0
68132273@N00,3349,46,1384994285,1384994285,2,1,0
68147738@N00,3350,85,1246594715,1246594715,1,1,0
68151423@N00,3351,28,1016181157,1016194486,7,1,13329
68183366@N05,3352,82,1397753388,1397753388,1,1,0
68183366@N05,3353,35,1397836732,1397836732,1,2,0
68183366@N05,3353,81,1397832542,1397832542,1,2,0
68183366@N05,3354,4,1398019482,1398019482,1,3,0
68183366@N05,3354,24,1398019023,1398019023,1,3,0
68183366@N05,3354,84,1398019106,1398019106,1,3,0
68408691@N07,3355,26,1357977583,1357977583,1,1,0
68408691@N07,3356,71,1358382913,1358382913,1,1,0
68408691@N07,3357,11,1360224800,1360224800,1,1,0
68408691@N07,3358,22,1360306604,1360306604,1,1,0
68408691@N07,3359,82,1361331896,1361331896,1,1,0
68408691@N07,3360,31,1362117022,1362117022,1,1,0
68408691@N07,3361,40,1363325752,1363325752,1,1,0
68408691@N07,3362,0,1363398571,1363398571,1,1,0
68408691@N07,3363,11,1363671821,1363671821,1,1,0
68408691@N07,3364,22,1364608282,1364608282,1,1,0
68408691@N07,3365,10,1365142301,1365142301,1,1,0
68408691@N07,3366,32,1365677153,1365677153,1,1,0
68408691@N07,3367,44,1366942780,1366942780,1,1,0
68529605@N00,3368,25,1142272811,1142272811,1,5,0
68529605@N00,3368,35,1142275287,1142275287,1,5,0
68529605@N00,3368,45,1142272480,1142272699,2,5,219
68529605@N00,3368,71,1142274396,1142274396,1,5,0
68529605@N00,3368,82,1142273616,1142273828,2,5,212
68529605@N00,3369,1,1142543295,1142543295,1,1,0
68529605@N00,3370,8,1143485573,1143485573,1,3,0
68529605@N00,3370,17,1143484068,1143484327,2,3,259
68529605@N00,3370,85,1143489244,1143489244,1,3,0
68555735@N00,3371,75,1136333518,1136333518,1,1,0
68688301@N00,3372,68,1313124386,1313124386,1,2,0
68688301@N00,3372,71,1313117339,1313118717,3,2,1378
68688301@N00,3373,11,1317035842,1317035842,1,1,0
68688301@N00,3374,45,1321150962,1321150962,1,1,0
68688301@N00,3375,39,1322548512,1322548512,1,2,0
68688301@N00,3375,72,1322548100,1322548100,1,2,0
68688301@N00,3376,11,1323209660,1323209660,1,1,0
68688301@N00,3377,71,1327733585,1327733585,1,1,0
68688301@N00,3378,19,1329810861,1329810861,1,1,0
68688301@N00,3379,56,1333702435,1333702435,1,1,0
68688301@N00,3380,34,1338943883,1338956880,8,1,12997
68688301@N00,3381,85,1348820409,1348820409,1,1,0
68688301@N00,3382,22,1350356884,1350359208,2,1,2324
68688301@N00,3383,22,1356076128,1356076128,1,1,0
68766104@N00,3384,21,1348280941,1348280941,1,1,0
68821750@N00,3385,85,1347488321,1347488321,1,1,0
68860772@N02,3386,71,1323551234,1323557451,2,1,6217
68892129@N00,3387,31,1183004222,1183004222,1,5,0
68892129@N00,3387,33,1183007522,1183007522,1,5,0
68892129@N00,3387,49,1183005057,1183005057,1,5,0
68892129@N00,3387,50,1183001854,1183001854,1,5,0
68892129@N00,3387,71,1183003238,1183003238,1,5,0
68892129@N00,3388,49,1183789652,1183789652,1,1,0
68892129@N00,3389,50,1184341538,1184341540,4,1,2
68892129@N00,3390,0,1184770248,1184770248,1,1,0
68892129@N00,3391,31,1255842591,1255842591,1,3,0
68892129@N00,3391,50,1255844224,1255844224,1,3,0
68892129@N00,3391,81,1255843707,1255843717,2,3,10
68892129@N00,3392,44,1256983223,1256983223,1,1,0
68892129@N00,3393,49,1307110266,1307110266,1,1,0
68892129@N00,3394,13,1307542505,1307542505,1,1,0
69041444@N00,3395,0,1109387887,1109387887,1,3,0
69041444@N00,3395,44,1109387552,1109387552,1,3,0
69041444@N00,3395,71,1109401223,1109401223,1,3,0
69041444@N00,3396,55,1137547400,1137547400,1,2,0
69041444@N00,3396,63,1137561304,1137561304,1,2,0
69041444@N00,3397,71,1152412588,1152412588,1,1,0
69539023@N00,3398,1,1235798065,1235815476,12,6,17411
69539023@N00,3398,13,1235835320,1235835320,1,6,0
69539023@N00,3398,18,1235776382,1235776755,2,6,373
69539023@N00,3398,23,1235781404,1235836495,10,6,55091
69539023@N00,3398,50,1235778309,1235778309,1,6,0
69539023@N00,3398,71,1235778490,1235835984,10,6,57494
69539023@N00,3399,26,1235866177,1235866403,4,1,226
69539023@N00,3400,56,1333685765,1333715784,16,1,30019
69539023@N00,3401,56,1333774628,1333805032,35,1,30404
69539023@N00,3402,56,1333876221,1333885207,10,1,8986
69596918@N00,3403,82,1099227600,1099227600,1,1,0
69596918@N00,3404,32,1109595600,1109595600,1,1,0
69596918@N00,3405,50,1114869600,1114869600,1,2,0
69596918@N00,3405,70,1114869600,1114869600,1,2,0
69596918@N00,3406,21,1122818400,1122818400,1,2,0
69596918@N00,3406,39,1122818400,1122818400,1,2,0
69596918@N00,3407,35,1151676000,1151676000,2,1,0
69931111@N00,3408,9,1266630142,1266630142,1,4,0
69931111@N00,3408,32,1266630681,1266630681,1,4,0
69931111@N00,3408,38,1266624888,1266625245,3,4,357
69931111@N00,3408,73,1266622731,1266636939,5,4,14208
69931111@N00,3409,26,1315370402,1315370402,1,1,0
69961849@N00,3410,32,1153407387,1153407387,1,2,0
69961849@N00,3410,71,1153405104,1153407169,2,2,2065
70198160@N00,3411,22,1233469839,1233470165,13,2,326
70198160@N00,3411,41,1233470145,1233478820,2,2,8675
70317059@N00,3412,12,1137054798,1137054798,1,1,0
70317059@N00,3413,22,1141868377,1141868468,2,1,91
70317059@N00,3414,43,1154926731,1154926731,1,2,0
70317059@N00,3414,49,1154924364,1154925249,4,2,885
70329477@N00,3415,25,1319169742,1319169742,1,2,0
70329477@N00,3415,45,1319178392,1319178392,1,2,0
70932315@N02,3416,1,1327637928,1327637928,1,1,0
70995385@N00,3417,45,1307961233,1307961233,1,3,0
70995385@N00,3417,71,1307961419,1307961834,10,3,415
70995385@N00,3417,82,1307961244,1307961250,2,3,6
70995385@N00,3418,2,1308027340,1308027340,1,1,0
70995385@N00,3419,40,1308130679,1308130684,3,1,5
71082171@N00,3420,2,1300655024,1300655024,1,1,0
71082171@N00,3421,39,1358303011,1358303011,1,1,0
71082171@N00,3422,2,1358455845,1358455845,1,1,0
71082171@N00,3423,42,1359523527,1359523527,1,1,0
71088002@N00,3424,35,1101819600,1101819600,2,1,0
71088002@N00,3425,41,1128600846,1128600846,1,2,0
71088002@N00,3425,70,1128601247,1128601247,1,2,0
71088002@N00,3426,35,1135989208,1135989208,1,1,0
71088002@N00,3427,35,1137532506,1137532543,2,1,37
71088002@N00,3428,35,1142322932,1142322932,1,1,0
71088002@N00,3429,8,1143183497,1143183497,1,1,0
71088002@N00,3430,35,1143438772,1143438772,1,1,0
71088002@N00,3431,35,1143600078,1143600078,1,1,0
71088002@N00,3432,71,1143867910,1143867910,1,1,0
71088002@N00,3433,35,1144212909,1144212909,1,1,0
71088002@N00,3434,35,1144817331,1144817331,1,2,0
71088002@N00,3434,71,1144800222,1144800222,1,2,0
71088002@N00,3435,35,1145775308,1145775308,1,1,0
71088002@N00,3436,9,1146804892,1146804892,1,1,0
71088002@N00,3437,35,1147005587,1147005587,1,1,0
71088002@N00,3438,35,1150026259,1150026368,2,1,109
71088002@N00,3439,71,1150157235,1150166826,18,1,9591
71088002@N00,3440,35,1150589229,1150589229,1,1,0
71088002@N00,3441,70,1152537755,1152537755,1,1,0
71088002@N00,3442,8,1152724383,1152724383,1,1,0
71088002@N00,3443,8,1152899198,1152899198,1,1,0
71088002@N00,3444,9,1155052367,1155052367,1,1,0
71088002@N00,3445,8,1157022402,1157049469,2,1,27067
71088002@N00,3446,35,1158749132,1158749132,1,1,0
71088002@N00,3447,35,1159615683,1159615683,1,1,0
71088002@N00,3448,35,1159649117,1159649117,1,1,0
71088002@N00,3449,35,1161276458,1161276458,1,1,0
71088002@N00,3450,9,1163157248,1163157248,1,1,0
71088002@N00,3451,16,1164884208,1164884208,1,1,0
71088002@N00,3452,17,1170332385,1170332385,1,1,0
71088002@N00,3453,35,1172069290,1172069290,1,1,0
71088002@N00,3454,22,1174861266,1174861266,1,1,0
71088002@N00,3455,35,1178129985,1178129985,1,1,0
71088002@N00,3456,35,1179309311,1179309317,2,2,6
71088002@N00,3456,71,1179334960,1179334960,1,2,0
71088002@N00,3457,35,1179745451,1179745451,1,1,0
71088002@N00,3458,9,1180449118,1180449118,1,1,0
71088002@N00,3459,70,1181405107,1181405107,1,1,0
71088002@N00,3460,35,1183987423,1183987578,3,1,155
71088002@N00,3461,35,1197461012,1197461012,1,1,0
71088002@N00,3462,35,1199517962,1199517962,1,1,0
71088002@N00,3463,35,1199584051,1199584051,1,1,0
71088002@N00,3464,35,1200214655,1200214655,1,1,0
71088002@N00,3465,67,1209011633,1209012075,5,1,442
71088526@N00,3466,84,1385848952,1385848952,1,1,0
71088526@N00,3467,35,1385936599,1385936599,1,7,0
71088526@N00,3467,41,1385958570,1385958570,1,7,0
71088526@N00,3467,57,1385938974,1385939466,6,7,492
71088526@N00,3467,68,1385938200,1385938581,6,7,381
71088526@N00,3467,71,1385937144,1385937914,3,7,770
71088526@N00,3467,79,1385940434,1385940950,3,7,516
71088526@N00,3467,82,1385936836,1385937123,4,7,287
71088526@N00,3468,2,1386022928,1386023760,3,7,832
71088526@N00,3468,13,1386027602,1386028263,3,7,661
71088526@N00,3468,15,1386026153,1386026153,1,7,0
71088526@N00,3468,32,1386028756,1386028918,2,7,162
71088526@N00,3468,49,1386042727,1386053142,4,7,10415
71088526@N00,3468,50,1386025546,1386025751,6,7,205
71088526@N00,3468,70,1386025344,1386025344,1,7,0
71088526@N00,3469,71,1386205871,1386205871,1,1,0
71088526@N00,3470,25,1386284797,1386285637,2,6,840
71088526@N00,3470,44,1386284207,1386284207,1,6,0
71088526@N00,3470,45,1386284391,1386308520,10,6,24129
71088526@N00,3470,46,1386286450,1386286500,2,6,50
71088526@N00,3470,72,1386293438,1386293438,1,6,0
71088526@N00,3470,81,1386283586,1386283586,1,6,0
71156563@N00,3471,40,1338350145,1338350145,1,1,0
71156563@N00,3472,22,1340447438,1340447438,1,1,0
71156563@N00,3473,72,1372890935,1372890935,1,1,0
7170162@N02,3474,48,1285488128,1285489473,3,1,1345
7170162@N02,3475,55,1285553939,1285553939,1,1,0
72115425@N00,3476,35,1292055517,1292055517,1,2,0
72115425@N00,3476,40,1292053198,1292053198,1,2,0
72327345@N00,3477,39,1341533308,1341561167,2,3,27859
72327345@N00,3477,50,1341546939,1341546939,1,3,0
72327345@N00,3477,70,1341545647,1341545647,1,3,0
72562013@N06,3478,45,1361645821,1361646010,2,3,189
72562013@N06,3478,50,1361625247,1361625611,3,3,364
72562013@N06,3478,81,1361612425,1361612425,1,3,0
72562013@N06,3479,63,1362825152,1362825152,1,2,0
72562013@N06,3479,68,1362826409,1362826409,1,2,0
72562013@N06,3480,67,1362907876,1362907876,1,1,0
72562013@N06,3481,43,1362960787,1362963146,30,1,2359
72562013@N06,3482,48,1364082621,1364090211,2,1,7590
72562013@N06,3483,48,1368924485,1368940382,6,1,15897
72562013@N06,3484,50,1370685177,1370685177,1,1,0
72562013@N06,3485,68,1371972642,1371972642,1,1,0
72562013@N06,3486,1,1373619953,1373620501,11,1,548
72562013@N06,3487,80,1374888672,1374888681,2,1,9
72562013@N06,3488,48,1382748785,1382764915,39,1,16130
72562013@N06,3489,70,1386414143,1386414143,1,1,0
72562013@N06,3490,52,1387012817,1387021909,26,1,9092
72562013@N06,3491,35,1387279429,1387279429,1,1,0
72562013@N06,3492,9,1387451322,1387451322,1,1,0
72562013@N06,3493,47,1387627448,1387628020,2,1,572
72562013@N06,3494,52,1389433288,1389442401,42,1,9113
72562013@N06,3495,48,1390609461,1390625501,26,1,16040
72562013@N06,3496,71,1394327838,1394330506,3,1,2668
72562013@N06,3497,43,1394410920,1394412894,22,1,1974
72562013@N06,3498,71,1395541539,1395558788,39,1,17249
72562013@N06,3499,22,1396753231,1396767923,21,1,14692
72633384@N00,3500,49,1346467827,1346467827,1,2,0
72633384@N00,3500,76,1346479014,1346479014,1,2,0
72659440@N00,3501,26,1389896325,1389896325,1,1,0
7266456@N05,3502,27,1325825554,1325828035,18,2,2481
7266456@N05,3502,45,1325823531,1325839895,2,2,16364
7266456@N05,3503,45,1327979948,1327983886,3,1,3938
7266456@N05,3504,45,1328240316,1328243342,21,1,3026
72744226@N00,3505,25,1360316835,1360316835,1,4,0
72744226@N00,3505,27,1360322053,1360322053,1,4,0
72744226@N00,3505,71,1360325124,1360325124,1,4,0
72744226@N00,3505,81,1360323246,1360323246,1,4,0
72744226@N00,3506,9,1360460920,1360460920,1,3,0
72744226@N00,3506,23,1360461039,1360461329,3,3,290
72744226@N00,3506,32,1360460367,1360460367,1,3,0
72744226@N00,3507,2,1360496811,1360496811,1,1,0
72803573@N00,3508,26,1178431490,1178431490,1,1,0
7281383@N08,3509,57,1329266402,1329266402,1,1,0
7281383@N08,3510,49,1329452473,1329452473,1,1,0
73014677@N05,3511,82,1270269731,1270269731,1,1,0
73014677@N05,3512,49,1272866500,1272866500,1,1,0
73014677@N05,3513,37,1296450457,1296450457,1,3,0
73014677@N05,3513,50,1296442242,1296442367,4,3,125
73014677@N05,3513,71,1296441094,1296442171,2,3,1077
73014677@N05,3514,49,1296615302,1296615302,1,1,0
73014677@N05,3515,0,1296955771,1296955771,1,2,0
73014677@N05,3515,82,1296975640,1296975640,1,2,0
73014677@N05,3516,21,1297231026,1297231026,1,1,0
73014677@N05,3517,31,1298768754,1298772481,2,1,3727
73041688@N00,3518,82,1345186797,1345186797,1,1,0
73227899@N05,3519,23,1374373777,1374373777,1,1,0
73227899@N05,3520,85,1378707105,1378707105,1,1,0
73227899@N05,3521,22,1388285012,1388285012,1,1,0
73357159@N00,3522,68,1385261219,1385261219,1,2,0
73357159@N00,3522,71,1385261343,1385261343,1,2,0
73384102@N00,3523,85,1373993645,1373993645,1,1,0
73589829@N00,3524,40,1274517600,1274517892,3,1,292
73589829@N00,3525,22,1274605009,1274605009,1,1,0
73589829@N00,3526,22,1274765706,1274766047,3,1,341
74015914@N00,3527,14,1280201693,1280201693,1,1,0
74015914@N00,3528,14,1281779465,1281779600,4,1,135
74015914@N00,3529,14,1283576507,1283576507,1,1,0
74046046@N00,3530,69,1383974910,1383974910,1,1,0
74088933@N00,3531,65,1138505141,1138530786,20,1,25645
74101223@N00,3532,32,1322936305,1322936305,1,2,0
74101223@N00,3532,82,1322938399,1322938399,1,2,0
7414413@N05,3533,68,1388319153,1388319267,2,1,114
7414413@N05,3534,23,1388374123,1388374123,1,3,0
7414413@N05,3534,74,1388404863,1388404863,1,3,0
7414413@N05,3534,82,1388376641,1388376641,1,3,0
7414413@N05,3535,82,1388722834,1388722834,1,1,0
74184948@N00,3536,11,1388403376,1388403376,1,1,0
74215745@N00,3537,26,1230114293,1230114293,1,1,0
74215745@N00,3538,26,1230313185,1230313185,1,1,0
74215745@N00,3539,26,1231170555,1231170555,1,1,0
74215745@N00,3540,26,1231390422,1231419470,41,1,29048
74215745@N00,3541,26,1231500421,1231532441,184,1,32020
74215745@N00,3542,26,1232698846,1232720775,19,1,21929
7423586@N08,3543,5,1327710190,1327710190,1,1,0
7423586@N08,3544,50,1328068245,1328068373,2,2,128
7423586@N08,3544,71,1328067895,1328068065,2,2,170
7423586@N08,3545,52,1328345290,1328345290,1,1,0
74279471@N00,3546,57,1272704481,1272714348,7,1,9867
74279471@N00,3547,63,1298363439,1298373414,2,1,9975
74279471@N00,3548,46,1310181907,1310181907,1,1,0
74279471@N00,3549,57,1369473807,1369473807,1,1,0
74279471@N00,3550,57,1384649320,1384654182,14,1,4862
74657501@N00,3551,27,1291428359,1291429326,2,1,967
74657501@N00,3552,51,1308458257,1308458257,1,1,0
74693095@N00,3553,59,1132466850,1132466850,1,1,0
74693095@N00,3554,28,1142029567,1142039784,5,1,10217
74693095@N00,3555,28,1142217484,1142218922,2,1,1438
74693095@N00,3556,28,1142643271,1142652767,7,1,9496
74693095@N00,3557,28,1148090610,1148092052,5,1,1442
74693095@N00,3558,28,1148182858,1148182943,2,1,85
74693095@N00,3559,66,1150610984,1150610984,1,1,0
74693095@N00,3560,28,1151285389,1151296420,3,1,11031
74693095@N00,3561,66,1153016190,1153016774,2,1,584
74693095@N00,3562,28,1153537623,1153542396,12,1,4773
74693095@N00,3563,59,1153813904,1153813919,2,1,15
74693095@N00,3564,28,1154221665,1154228767,7,1,7102
74693095@N00,3565,20,1155374718,1155374718,1,1,0
74693095@N00,3566,43,1155419065,1155419462,2,1,397
74693095@N00,3567,28,1155948320,1155949565,9,1,1245
74693095@N00,3568,9,1156325231,1156325632,2,3,401
74693095@N00,3568,28,1156328347,1156328347,1,3,0
74693095@N00,3568,32,1156323318,1156323318,1,3,0
74693095@N00,3569,28,1156556176,1156592211,14,1,36035
74693095@N00,3570,49,1157008692,1157009961,5,1,1269
74693095@N00,3571,49,1157114860,1157114860,1,1,0
74693095@N00,3572,28,1157167789,1157172257,4,1,4468
74693095@N00,3573,49,1162281356,1162281823,3,1,467
74693095@N00,3574,76,1167277333,1167287146,72,1,9813
74693095@N00,3575,76,1167716756,1167717799,9,1,1043
74693095@N00,3576,76,1167901090,1167901864,2,1,774
74693095@N00,3577,76,1168148419,1168148419,1,1,0
74693095@N00,3578,76,1168253030,1168253030,1,1,0
74693095@N00,3579,76,1168734535,1168734535,1,1,0
74693095@N00,3580,76,1169106397,1169106397,1,1,0
74693095@N00,3581,70,1169889483,1169889484,2,1,1
74693095@N00,3582,20,1170228879,1170228880,3,1,1
74693095@N00,3583,20,1170317285,1170317285,1,1,0
74693095@N00,3584,28,1171665109,1171672100,4,1,6991
74693095@N00,3585,28,1174788692,1174800394,6,1,11702
74693095@N00,3586,76,1176606503,1176607282,7,1,779
74693095@N00,3587,28,1177211956,1177211956,1,1,0
74693095@N00,3588,22,1193557234,1193557234,1,1,0
74693095@N00,3589,22,1193731688,1193731688,1,1,0
74693095@N00,3590,22,1193904305,1193904305,1,1,0
74693095@N00,3591,22,1194512116,1194512116,1,1,0
74693095@N00,3592,22,1196668296,1196668296,1,1,0
74693095@N00,3593,31,1197025875,1197025875,1,2,0
74693095@N00,3593,71,1197015067,1197015067,1,2,0
74693095@N00,3594,9,1197320959,1197320959,1,1,0
74778737@N07,3595,48,1358464311,1358464311,1,1,0
74778737@N07,3596,48,1358547309,1358559140,4,1,11831
74799514@N00,3597,23,1199395367,1199395367,1,1,0
7500884@N07,3598,19,1279872265,1279872265,1,1,0
7519521@N06,3599,4,1345267762,1345268153,2,1,391
75286866@N00,3600,3,1390377818,1390377818,1,3,0
75286866@N00,3600,11,1390387114,1390387114,1,3,0
75286866@N00,3600,31,1390353121,1390353121,1,3,0
75286866@N00,3601,20,1390457473,1390457473,1,2,0
75286866@N00,3601,57,1390438237,1390438237,1,2,0
75483054@N00,3602,31,1196223039,1196223039,1,2,0
75483054@N00,3602,50,1196220071,1196220071,1,2,0
75546495@N03,3603,67,1142739660,1142745121,8,1,5461
75546495@N03,3604,57,1143102788,1143111667,2,2,8879
75546495@N03,3604,67,1143112582,1143114357,5,2,1775
75546495@N03,3605,81,1143599527,1143599527,1,1,0
75546495@N03,3606,84,1162523750,1162523750,1,1,0
75546495@N03,3607,8,1337833010,1337833848,2,3,838
75546495@N03,3607,9,1337832854,1337832854,1,3,0
75546495@N03,3607,13,1337833893,1337833893,1,3,0
75546495@N03,3608,31,1392979375,1392979375,1,1,0
75546495@N03,3609,9,1393068843,1393068843,1,8,0
75546495@N03,3609,36,1393071510,1393071510,1,8,0
75546495@N03,3609,50,1393065467,1393066028,5,8,561
75546495@N03,3609,67,1393062874,1393063610,7,8,736
75546495@N03,3609,71,1393065010,1393065282,2,8,272
75546495@N03,3609,75,1393061880,1393062782,9,8,902
75546495@N03,3609,81,1393063808,1393064414,6,8,606
75546495@N03,3609,82,1393065971,1393073502,3,8,7531
75546495@N03,3610,84,1395267523,1395267523,1,1,0
75558478@N00,3611,74,1337569657,1337569657,1,1,0
75558478@N00,3612,28,1374413362,1374413362,1,1,0
75574893@N00,3613,37,1131229835,1131229835,1,1,0
7571326@N06,3614,8,1374648389,1374648389,1,1,0
7571326@N06,3615,18,1374718830,1374718830,1,2,0
7571326@N06,3615,32,1374719064,1374720335,2,2,1271
7571326@N06,3616,22,1388815491,1388815491,1,1,0
7571326@N06,3617,22,1388899502,1388899502,1,1,0
7571326@N06,3618,11,1393721256,1393721256,1,1,0
75749741@N00,3619,84,1300710435,1300710435,1,1,0
75749741@N00,3620,80,1301888614,1301895830,2,1,7216
75749741@N00,3621,84,1305604522,1305604539,3,1,17
75749741@N00,3622,84,1316500545,1316500550,2,1,5
7576572@N07,3623,57,1358165702,1358165702,1,1,0
7576572@N07,3624,27,1358248461,1358249073,4,1,612
75815807@N00,3625,31,1386118067,1386128954,17,1,10887
75873727@N00,3626,32,1324696954,1324696960,2,5,6
75873727@N00,3626,45,1324691631,1324691631,1,5,0
75873727@N00,3626,50,1324702817,1324702817,1,5,0
75873727@N00,3626,71,1324690258,1324690478,4,5,220
75873727@N00,3626,81,1324690663,1324691115,3,5,452
75873727@N00,3627,57,1324957496,1324961385,3,1,3889
7587786@N05,3628,71,1298102198,1298102198,1,1,0
7587786@N05,3629,71,1298183162,1298183585,4,1,423
7587786@N05,3630,45,1298276220,1298278224,6,1,2004
76045605@N00,3631,19,1290654431,1290654431,1,1,0
76045605@N00,3632,82,1291884201,1291884201,1,1,0
76045605@N00,3633,19,1292297971,1292297971,1,1,0
76045605@N00,3634,32,1294709322,1294709322,1,1,0
76045605@N00,3635,14,1294819304,1294819304,1,1,0
76045605@N00,3636,32,1299739936,1299739936,1,1,0
76045605@N00,3637,2,1301471850,1301471850,1,1,0
76045605@N00,3638,32,1307413367,1307413367,1,1,0
76045605@N00,3639,81,1313115873,1313115873,1,1,0
7616875@N04,3640,26,1391984701,1391984803,3,1,102
7616875@N04,3641,38,1392045137,1392045927,22,1,790
7616875@N04,3642,38,1392098259,1392113535,4,1,15276
7616875@N04,3643,38,1395752312,1395752315,2,1,3
76196395@N00,3644,11,1225004232,1225004945,2,1,713
76196395@N00,3645,11,1233432581,1233438787,8,1,6206
76196395@N00,3646,9,1238551917,1238551917,1,1,0
76196395@N00,3647,9,1240341196,1240341516,3,1,320
76196395@N00,3648,11,1240709501,1240709501,1,1,0
76196395@N00,3649,41,1250176588,1250204649,7,1,28061
76196395@N00,3650,41,1250265689,1250285187,14,1,19498
76196395@N00,3651,41,1250740632,1250740632,1,1,0
76196395@N00,3652,41,1281717841,1281742221,17,1,24380
76196395@N00,3653,41,1281813208,1281823962,7,1,10754
76196395@N00,3654,41,1281924448,1281924448,1,1,0
76196395@N00,3655,20,1290553488,1290553496,2,1,8
76196395@N00,3656,25,1303009538,1303009565,2,1,27
76196395@N00,3657,20,1303863146,1303863146,1,1,0
76225887@N00,3658,68,1258997141,1258997463,3,2,322
76225887@N00,3658,71,1258996937,1258997663,3,2,726
76225887@N00,3659,45,1259090967,1259090967,1,4,0
76225887@N00,3659,71,1259059050,1259092411,3,4,33361
76225887@N00,3659,81,1259082983,1259083186,3,4,203
76225887@N00,3659,82,1259082931,1259082931,1,4,0
76384935@N00,3660,45,1230889469,1230891927,8,1,2458
76384935@N00,3661,56,1232930358,1232975480,62,2,45122
76384935@N00,3661,63,1232965121,1232977493,10,2,12372
76384935@N00,3662,63,1233326057,1233356975,67,1,30918
76384935@N00,3663,63,1233436930,1233456341,60,1,19411
76395609@N00,3664,18,1302608341,1302608341,1,1,0
76395609@N00,3665,2,1302771746,1302771748,2,3,2
76395609@N00,3665,40,1302783153,1302783375,2,3,222
76395609@N00,3665,71,1302763770,1302763770,1,3,0
7640968@N02,3666,85,1293146093,1293146093,1,1,0
7640968@N02,3667,31,1300250769,1300250769,1,1,0
7640968@N02,3668,9,1315459869,1315459869,1,5,0
7640968@N02,3668,17,1315440988,1315440988,1,5,0
7640968@N02,3668,39,1315478119,1315478119,1,5,0
7640968@N02,3668,40,1315483356,1315483356,1,5,0
7640968@N02,3668,82,1315489679,1315489679,1,5,0
76562640@N00,3669,58,1078755862,1078758301,8,2,2439
76562640@N00,3669,71,1078749751,1078766216,3,2,16465
76562640@N00,3670,25,1078873049,1078878589,2,1,5540
7666975@N03,3671,19,1322710509,1322710836,7,6,327
7666975@N03,3671,41,1322708318,1322708318,1,6,0
7666975@N03,3671,48,1322701985,1322702347,2,6,362
7666975@N03,3671,69,1322701770,1322701770,1,6,0
7666975@N03,3671,71,1322699873,1322699873,1,6,0
7666975@N03,3671,84,1322706167,1322706167,1,6,0
7666975@N03,3672,11,1322800554,1322800918,9,2,364
7666975@N03,3672,36,1322785394,1322785394,1,2,0
76711295@N00,3673,22,1241260199,1241266419,2,1,6220
76711295@N00,3674,27,1276336593,1276336593,1,1,0
76711295@N00,3675,11,1284694388,1284700935,5,1,6547
76711295@N00,3676,76,1293947699,1293947699,1,1,0
76711295@N00,3677,15,1294796305,1294796305,1,2,0
76711295@N00,3677,71,1294798934,1294799633,2,2,699
76711295@N00,3678,21,1297238683,1297244792,3,1,6109
76711295@N00,3679,11,1297472382,1297472382,1,1,0
76711295@N00,3680,11,1298018504,1298018504,1,1,0
76711295@N00,3681,39,1298187895,1298191652,4,1,3757
76711295@N00,3682,26,1300582857,1300582857,1,1,0
76711295@N00,3683,3,1311418173,1311418173,1,1,0
76711295@N00,3684,45,1312086430,1312086430,1,1,0
76711295@N00,3685,71,1313291731,1313291731,1,1,0
76711295@N00,3686,16,1313374464,1313374464,1,1,0
76711295@N00,3687,48,1314353981,1314353981,1,1,0
76711295@N00,3688,2,1315046415,1315046415,1,1,0
76711295@N00,3689,34,1315106733,1315106733,1,1,0
76711295@N00,3690,14,1315278589,1315283666,2,1,5077
76711295@N00,3691,7,1315797427,1315797427,1,1,0
76711295@N00,3692,21,1324455099,1324455099,1,1,0
76711295@N00,3693,39,1324502254,1324502254,1,1,0
76711295@N00,3694,35,1325147984,1325147984,1,1,0
76711295@N00,3695,22,1325240852,1325240852,1,1,0
76711295@N00,3696,17,1325991411,1325991411,1,2,0
76711295@N00,3696,32,1325994717,1325994717,1,2,0
76711295@N00,3697,71,1327572382,1327572382,1,1,0
76711295@N00,3698,57,1346411590,1346411590,1,1,0
76711295@N00,3699,11,1355555432,1355555432,1,1,0
76711295@N00,3700,11,1359497405,1359497405,1,1,0
76711295@N00,3701,26,1360064839,1360064839,1,1,0
76711295@N00,3702,41,1360564984,1360564984,1,1,0
76711295@N00,3703,11,1361366677,1361366677,1,1,0
76711295@N00,3704,71,1361522557,1361522557,1,1,0
76711295@N00,3705,11,1366022587,1366022587,1,1,0
76711295@N00,3706,22,1367060541,1367060541,1,1,0
76711295@N00,3707,21,1368016869,1368016869,1,1,0
76711295@N00,3708,53,1368941706,1368941706,1,1,0
76711295@N00,3709,13,1369473086,1369473086,1,2,0
76711295@N00,3709,71,1369469412,1369469412,1,2,0
76711295@N00,3710,11,1373007578,1373007578,1,1,0
76711295@N00,3711,57,1377339623,1377339623,1,1,0
76711295@N00,3712,11,1378119881,1378119881,1,1,0
76711295@N00,3713,11,1378433834,1378433834,1,1,0
76711295@N00,3714,4,1381392673,1381392673,1,1,0
76711295@N00,3715,26,1382151453,1382151453,1,1,0
76711295@N00,3716,11,1384005069,1384005069,1,1,0
76711295@N00,3717,67,1384766323,1384766323,1,1,0
76711295@N00,3718,11,1384916906,1384916906,1,1,0
76711295@N00,3719,35,1390734210,1390734210,1,2,0
76711295@N00,3719,70,1390734412,1390734412,1,2,0
76711295@N00,3720,4,1392276732,1392276732,1,1,0
76711295@N00,3721,40,1393069153,1393069153,1,2,0
76711295@N00,3721,50,1393079510,1393079510,1,2,0
76711295@N00,3722,71,1393202304,1393202304,1,1,0
76711295@N00,3723,38,1393667294,1393667294,1,1,0
76711295@N00,3724,53,1398572312,1398572312,1,1,0
76726772@N00,3725,81,1067514902,1067514902,1,1,0
76726772@N00,3726,24,1124263486,1124263486,1,1,0
76726772@N00,3727,7,1128646008,1128646593,2,1,585
76726772@N00,3728,46,1138149989,1138150026,2,2,37
76726772@N00,3728,80,1138152357,1138152357,1,2,0
76726772@N00,3729,0,1143111320,1143113337,2,6,2017
76726772@N00,3729,44,1143113800,1143114877,4,6,1077
76726772@N00,3729,63,1143108878,1143109113,2,6,235
76726772@N00,3729,67,1143106247,1143106442,2,6,195
76726772@N00,3729,81,1143102213,1143102213,1,6,0
76726772@N00,3729,82,1143104027,1143104045,2,6,18
76726772@N00,3730,16,1151469062,1151469062,1,1,0
76726772@N00,3731,44,1159005971,1159011856,8,1,5885
76726772@N00,3732,48,1163740845,1163740971,2,2,126
76726772@N00,3732,69,1163739867,1163741319,2,2,1452
76726772@N00,3733,31,1164367595,1164367634,2,1,39
76726772@N00,3734,9,1164449818,1164449884,2,2,66
76726772@N00,3734,84,1164450837,1164450837,1,2,0
76726772@N00,3735,55,1169098991,1169098991,1,3,0
76726772@N00,3735,56,1169100745,1169100786,2,3,41
76726772@N00,3735,63,1169070336,1169101271,26,3,30935
76726772@N00,3736,25,1182673857,1182674038,2,5,181
76726772@N00,3736,68,1182663998,1182677249,24,5,13251
76726772@N00,3736,71,1182677591,1182677859,2,5,268
76726772@N00,3736,82,1182675190,1182675190,1,5,0
76726772@N00,3736,84,1182655208,1182655208,1,5,0
76726772@N00,3737,35,1185592495,1185592523,3,1,28
76726772@N00,3738,85,1186178802,1186178802,1,1,0
76726772@N00,3739,3,1186295017,1186295017,1,2,0
76726772@N00,3739,85,1186302278,1186302278,1,2,0
76726772@N00,3740,7,1188015604,1188015604,1,1,0
76726772@N00,3741,57,1188109015,1188138083,5,1,29068
76726772@N00,3742,71,1190963229,1190969560,11,1,6331
76726772@N00,3743,47,1230963009,1230963009,1,1,0
77072369@N05,3744,32,1395621066,1395621066,1,1,0
77152181@N06,3745,2,1354089458,1354089458,1,4,0
77152181@N06,3745,11,1354076239,1354076470,2,4,231
77152181@N06,3745,40,1354069996,1354108988,7,4,38992
77152181@N06,3745,48,1354077057,1354078382,5,4,1325
77152181@N06,3746,2,1354145477,1354145591,4,2,114
77152181@N06,3746,40,1354145142,1354145142,1,2,0
77152181@N06,3747,9,1366770401,1366770511,3,3,110
77152181@N06,3747,22,1366770782,1366773306,5,3,2524
77152181@N06,3747,41,1366770971,1366773521,3,3,2550
77152181@N06,3748,31,1366857469,1366857960,5,6,491
77152181@N06,3748,43,1366854150,1366856561,2,6,2411
77152181@N06,3748,49,1366855024,1366855847,3,6,823
77152181@N06,3748,75,1366852427,1366852427,1,6,0
77152181@N06,3748,81,1366860359,1366860406,2,6,47
77152181@N06,3748,82,1366860490,1366860490,1,6,0
77152181@N06,3749,22,1367740902,1367740902,1,2,0
77152181@N06,3749,71,1367739162,1367740091,2,2,929
77152181@N06,3750,31,1367801010,1367801010,1,3,0
77152181@N06,3750,71,1367805427,1367805427,1,3,0
77152181@N06,3750,82,1367802361,1367802361,1,3,0
77152181@N06,3751,0,1367845295,1367845295,1,3,0
77152181@N06,3751,22,1367848204,1367848204,1,3,0
77152181@N06,3751,31,1367846562,1367846562,1,3,0
77152181@N06,3752,9,1367930146,1367930146,1,3,0
77152181@N06,3752,22,1367931513,1367931513,1,3,0
77152181@N06,3752,81,1367932502,1367932502,1,3,0
77152181@N06,3753,31,1368143710,1368143710,1,1,0
77152181@N06,3754,31,1368285523,1368287321,2,1,1798
77152181@N06,3755,31,1368941267,1368941615,3,1,348
77152181@N06,3756,3,1374044436,1374044436,1,2,0
77152181@N06,3756,48,1374047798,1374047798,1,2,0
77152181@N06,3757,35,1374124111,1374124145,2,5,34
77152181@N06,3757,50,1374123150,1374123150,1,5,0
77152181@N06,3757,70,1374123492,1374124577,4,5,1085
77152181@N06,3757,71,1374121304,1374123142,4,5,1838
77152181@N06,3757,82,1374122555,1374122633,2,5,78
77152181@N06,3758,18,1374203790,1374208153,8,5,4363
77152181@N06,3758,23,1374203322,1374203322,1,5,0
77152181@N06,3758,31,1374199938,1374212844,5,5,12906
77152181@N06,3758,32,1374193264,1374195825,3,5,2561
77152181@N06,3758,35,1374208520,1374208520,1,5,0
77152181@N06,3759,31,1376139611,1376140785,2,1,1174
77152181@N06,3760,31,1376524412,1376528872,11,1,4460
77152181@N06,3761,13,1384900248,1384900248,1,10,0
77152181@N06,3761,14,1384895916,1384896854,3,10,938
77152181@N06,3761,15,1384914839,1384915103,3,10,264
77152181@N06,3761,17,1384896527,1384899772,10,10,3245
77152181@N06,3761,31,1384907779,1384910879,13,10,3100
77152181@N06,3761,35,1384904239,1384904239,1,10,0
77152181@N06,3761,44,1384907000,1384907000,1,10,0
77152181@N06,3761,50,1384914129,1384914129,1,10,0
77152181@N06,3761,71,1384905887,1384905887,1,10,0
77152181@N06,3761,81,1384905231,1384906098,4,10,867
77152181@N06,3762,14,1385012210,1385014233,2,5,2023
77152181@N06,3762,50,1385020054,1385021919,3,5,1865
77152181@N06,3762,71,1385020643,1385022517,7,5,1874
77152181@N06,3762,81,1385021716,1385023639,4,5,1923
77152181@N06,3762,82,1385022413,1385022413,1,5,0
7718718@N07,3763,40,1179227524,1179235479,8,1,7955
7718718@N07,3764,11,1225536082,1225536118,2,1,36
77211894@N00,3765,44,1164722181,1164722181,1,2,0
77211894@N00,3765,81,1164713379,1164722296,2,2,8917
77235006@N00,3766,35,1336199895,1336199895,1,1,0
77235006@N00,3767,2,1341119609,1341119609,1,5,0
77235006@N00,3767,35,1341118237,1341118237,1,5,0
77235006@N00,3767,40,1341119335,1341119778,8,5,443
77235006@N00,3767,50,1341116702,1341116731,2,5,29
77235006@N00,3767,51,1341120365,1341120400,2,5,35
77235006@N00,3768,9,1343321820,1343322364,2,1,544
77235006@N00,3769,85,1347678472,1347678481,2,1,9
77235006@N00,3770,44,1350704206,1350704389,5,2,183
77235006@N00,3770,45,1350704413,1350704598,5,2,185
77235006@N00,3771,44,1350795106,1350795109,2,3,3
77235006@N00,3771,46,1350789717,1350789717,1,3,0
77235006@N00,3771,85,1350787912,1350788154,2,3,242
77235006@N00,3772,9,1355644332,1355646150,6,6,1818
77235006@N00,3772,15,1355647519,1355647519,1,6,0
77235006@N00,3772,17,1355650244,1355650244,1,6,0
77235006@N00,3772,35,1355646550,1355651936,15,6,5386
77235006@N00,3772,70,1355646790,1355647052,5,6,262
77235006@N00,3772,84,1355643578,1355643635,4,6,57
77235006@N00,3773,27,1356962761,1356962761,1,2,0
77235006@N00,3773,44,1356961912,1356962043,4,2,131
77235006@N00,3774,55,1358568801,1358589393,34,3,20592
77235006@N00,3774,56,1358556266,1358559763,13,3,3497
77235006@N00,3774,63,1358560320,1358560541,3,3,221
77235006@N00,3775,9,1359158689,1359160946,70,4,2257
77235006@N00,3775,35,1359161539,1359161539,1,4,0
77235006@N00,3775,44,1359162492,1359162492,1,4,0
77235006@N00,3775,75,1359162747,1359173887,25,4,11140
77235006@N00,3776,0,1365916198,1365918012,7,1,1814
77235006@N00,3777,57,1368342016,1368348575,34,1,6559
77235006@N00,3778,57,1370594530,1370604201,6,1,9671
77235006@N00,3779,53,1370942712,1370951768,8,1,9056
77235006@N00,3780,71,1371889205,1371891590,10,1,2385
77235006@N00,3781,71,1379478082,1379479429,5,1,1347
77235006@N00,3782,26,1397899657,1397900570,5,1,913
77273938@N03,3783,75,1335794400,1335794400,1,1,0
77341465@N00,3784,26,1314944656,1314944656,1,1,0
77341465@N00,3785,5,1316852110,1316852110,2,1,0
77341465@N00,3786,26,1317457226,1317457226,1,1,0
77341484@N00,3787,21,1350604023,1350604023,1,1,0
77341484@N00,3788,8,1356839484,1356839616,3,1,132
77341484@N00,3789,3,1358390020,1358390020,1,1,0
77341484@N00,3790,72,1358588524,1358593584,2,1,5060
77341484@N00,3791,26,1359337771,1359337771,1,1,0
77341484@N00,3792,44,1360065465,1360065465,1,1,0
77341484@N00,3793,32,1360374121,1360374121,1,1,0
77341484@N00,3794,11,1361603813,1361603813,1,1,0
77341484@N00,3795,32,1362287552,1362287552,1,1,0
77341484@N00,3796,8,1362548077,1362548077,1,1,0
77341484@N00,3797,21,1362613453,1362613453,1,1,0
77341484@N00,3798,11,1363237603,1363237603,1,1,0
77341484@N00,3799,71,1363321958,1363321958,1,1,0
77341484@N00,3800,3,1363745646,1363745646,1,1,0
77341484@N00,3801,11,1370518090,1370518090,1,1,0
77341484@N00,3802,48,1375500439,1375500439,1,1,0
77341484@N00,3803,41,1393917298,1393917298,1,1,0
77341484@N00,3804,11,1396406051,1396406051,1,1,0
77541634@N00,3805,27,1265806847,1265806847,1,1,0
77541634@N00,3806,46,1328748157,1328748157,1,1,0
77736600@N00,3807,45,1245014621,1245014621,1,1,0
77767159@N00,3808,26,1119788542,1119788542,1,1,0
77767159@N00,3809,7,1128137870,1128137870,1,1,0
7783513@N05,3810,82,1388565353,1388565353,1,1,0
77967821@N00,3811,35,1300435652,1300448434,2,4,12782
77967821@N00,3811,41,1300450772,1300450772,1,4,0
77967821@N00,3811,50,1300446594,1300446594,1,4,0
77967821@N00,3811,82,1300446678,1300446678,1,4,0
77967821@N00,3812,18,1302308927,1302308927,1,1,0
77967821@N00,3813,50,1305787352,1305789318,3,1,1966
77967821@N00,3814,33,1317871286,1317871286,1,1,0
77967821@N00,3815,33,1318246738,1318247142,2,1,404
77967821@N00,3816,3,1318284578,1318284764,3,1,186
77967821@N00,3817,33,1318319128,1318319128,1,1,0
77967821@N00,3818,11,1326531423,1326531584,4,2,161
77967821@N00,3818,26,1326541828,1326541828,1,2,0
77967821@N00,3819,31,1345856815,1345857087,3,1,272
77967821@N00,3820,15,1355464624,1355464859,2,1,235
77981096@N05,3821,57,1336677000,1336683097,2,1,6097
7811493@N07,3822,29,1256994000,1256994000,1,1,0
7811493@N07,3823,71,1321750279,1321750279,1,1,0
7811565@N03,3824,57,1180448902,1180448902,1,2,0
7811565@N03,3824,81,1180448364,1180448364,1,2,0
78211664@N00,3825,32,1045438152,1045438152,1,1,0
78211664@N00,3826,35,1101862274,1101862274,1,1,0
78211664@N00,3827,57,1132290329,1132290329,1,1,0
78211664@N00,3828,40,1149530704,1149530704,1,1,0
78211664@N00,3829,45,1170583297,1170583420,2,1,123
78211664@N00,3830,40,1338173245,1338173245,1,1,0
78211664@N00,3831,41,1357870131,1357870131,1,1,0
78239672@N00,3832,7,1227332830,1227332830,1,1,0
78518246@N00,3833,13,1325477450,1325477450,1,1,0
78518246@N00,3834,12,1328075515,1328075515,1,1,0
78518246@N00,3835,16,1329345884,1329345884,1,1,0
78518246@N00,3836,70,1329835924,1329836073,2,1,149
78518246@N00,3837,45,1329945513,1329945513,1,1,0
78518246@N00,3838,21,1330809525,1330809525,1,1,0
78518246@N00,3839,21,1330995130,1330995130,1,1,0
78518246@N00,3840,36,1331046658,1331046658,1,2,0
78518246@N00,3840,84,1331030600,1331030600,1,2,0
78518246@N00,3841,25,1331154269,1331156280,6,1,2011
78518246@N00,3842,45,1331761396,1331761396,1,1,0
78518246@N00,3843,9,1331837840,1331837840,1,1,0
78518246@N00,3844,16,1331970187,1331970187,1,3,0
78518246@N00,3844,25,1331956560,1331956560,1,3,0
78518246@N00,3844,31,1331951283,1331951283,1,3,0
78518246@N00,3845,47,1332042474,1332046005,2,1,3531
78518246@N00,3846,0,1332139835,1332140398,2,3,563
78518246@N00,3846,4,1332153821,1332153821,1,3,0
78518246@N00,3846,70,1332136499,1332152577,2,3,16078
78518246@N00,3847,73,1333148924,1333148924,1,1,0
78518246@N00,3848,41,1333768593,1333768593,1,1,0
78518246@N00,3849,21,1333856507,1333856507,1,1,0
78518246@N00,3850,21,1334029354,1334029433,2,1,79
78518246@N00,3851,16,1334187852,1334187852,1,1,0
78518246@N00,3852,13,1334284334,1334284334,1,1,0
78518246@N00,3853,23,1334629706,1334629706,1,1,0
78518246@N00,3854,3,1334734435,1334734435,1,1,0
78518246@N00,3855,15,1334807422,1334807422,1,2,0
78518246@N00,3855,16,1334832501,1334832501,1,2,0
78518246@N00,3856,82,1334891041,1334891041,1,1,0
78518246@N00,3857,13,1335236501,1335236501,1,1,0
78518246@N00,3858,36,1335929528,1335929528,1,1,0
78518246@N00,3859,18,1336634131,1336634131,1,1,0
78518246@N00,3860,14,1348539862,1348539862,1,1,0
78518246@N00,3861,15,1387766609,1387766609,1,1,0
78518246@N00,3862,47,1387863053,1387863053,1,1,0
78667200@N00,3863,39,1075504947,1075537200,5,1,32253
78667200@N00,3864,39,1075655886,1075655886,1,1,0
78667200@N00,3865,39,1075716444,1075716444,1,1,0
78667200@N00,3866,39,1076114176,1076114176,1,1,0
78681550@N00,3867,50,1222763772,1222764379,5,2,607
78681550@N00,3867,82,1222762340,1222762383,2,2,43
78681550@N00,3868,50,1223050471,1223050834,3,3,363
78681550@N00,3868,71,1223051331,1223051331,1,3,0
78681550@N00,3868,82,1223050450,1223051592,3,3,1142
78681550@N00,3869,25,1248310114,1248311820,2,5,1706
78681550@N00,3869,27,1248307378,1248312564,8,5,5186
78681550@N00,3869,31,1248305354,1248305389,3,5,35
78681550@N00,3869,36,1248324147,1248324246,3,5,99
78681550@N00,3869,85,1248306921,1248306921,1,5,0
78681550@N00,3870,71,1276252973,1276252973,1,1,0
78681550@N00,3871,70,1281608683,1281608719,2,2,36
78681550@N00,3871,71,1281612234,1281612234,2,2,0
78681550@N00,3872,63,1299494216,1299499414,5,1,5198
78681550@N00,3873,38,1299580829,1299580829,1,2,0
78681550@N00,3873,63,1299568009,1299586485,23,2,18476
7874812@N06,3874,70,1308447388,1308451684,6,1,4296
7874812@N06,3875,70,1308524885,1308533372,33,1,8487
7874812@N06,3876,70,1308730429,1308730429,1,1,0
7874812@N06,3877,42,1342834540,1342834579,2,1,39
7878308@N04,3878,3,1288708783,1288708783,1,3,0
7878308@N04,3878,48,1288719245,1288719245,1,3,0
7878308@N04,3878,71,1288716240,1288718511,12,3,2271
7878308@N04,3879,48,1288790849,1288808681,15,1,17832
78792858@N04,3880,45,1334214638,1334214638,1,1,0
78959240@N00,3881,71,1340117090,1340117090,1,1,0
79227756@N00,3882,50,1384831262,1384831262,1,1,0
79227756@N00,3883,71,1385260500,1385260500,1,1,0
79235216@N00,3884,74,1193941423,1193941423,2,1,0
79235216@N00,3885,76,1225578083,1225578926,3,1,843
79235216@N00,3886,7,1228016581,1228016581,2,1,0
79235216@N00,3887,7,1338432466,1338432775,5,1,309
79235216@N00,3888,7,1339802102,1339802133,2,4,31
79235216@N00,3888,35,1339803775,1339803794,2,4,19
79235216@N00,3888,50,1339804103,1339804103,1,4,0
79235216@N00,3888,70,1339804080,1339804080,1,4,0
79235216@N00,3889,77,1341293003,1341293273,2,1,270
79235216@N00,3890,8,1343453627,1343453627,1,10,0
79235216@N00,3890,9,1343453050,1343454472,8,10,1422
79235216@N00,3890,22,1343448727,1343449645,13,10,918
79235216@N00,3890,23,1343453596,1343453596,1,10,0
79235216@N00,3890,27,1343435922,1343436953,2,10,1031
79235216@N00,3890,32,1343454519,1343454812,5,10,293
79235216@N00,3890,37,1343451097,1343451097,1,10,0
79235216@N00,3890,38,1343439942,1343440947,5,10,1005
79235216@N00,3890,41,1343449953,1343451006,11,10,1053
79235216@N00,3890,42,1343438524,1343439802,4,10,1278
79235216@N00,3891,39,1343525293,1343531130,41,4,5837
79235216@N00,3891,40,1343519040,1343531554,8,4,12514
79235216@N00,3891,51,1343529930,1343531902,7,4,1972
79235216@N00,3891,68,1343525406,1343525438,3,4,32
79235216@N00,3892,7,1355488264,1355490142,9,1,1878
79235216@N00,3893,48,1371342188,1371342620,4,2,432
79235216@N00,3893,51,1371343383,1371343383,1,2,0
79235216@N00,3894,81,1371538638,1371538851,3,1,213
79254487@N04,3895,15,1352189203,1352189203,1,1,0
79254487@N04,3896,21,1353209012,1353210940,3,1,1928
79254487@N04,3897,21,1354323141,1354323467,4,1,326
79254487@N04,3898,67,1364663752,1364663757,6,1,5
79254487@N04,3899,67,1364921980,1364922370,4,1,390
79254487@N04,3900,9,1385550074,1385550084,2,1,10
79297804@N08,3901,50,1302073872,1302073872,1,1,0
79382895@N08,3902,59,1336798160,1336798160,1,1,0
79382895@N08,3903,50,1343044931,1343044931,1,1,0
79399613@N00,3904,14,1355447960,1355447960,1,1,0
79399613@N00,3905,82,1355534089,1355534089,1,1,0
79399613@N00,3906,41,1355628515,1355628515,1,1,0
79463716@N00,3907,26,1090274100,1090274100,2,1,0
79463716@N00,3908,26,1108861203,1108861250,3,1,47
79470481@N02,3909,21,1184995861,1184995949,6,1,88
79470481@N02,3910,85,1239539211,1239540276,3,1,1065
79470481@N02,3911,39,1336877475,1336877475,1,1,0
79470481@N02,3912,85,1359185888,1359185888,1,1,0
79470481@N02,3913,24,1382054121,1382054121,1,1,0
7956017@N07,3914,37,1339118448,1339120630,43,1,2182
7956695@N03,3915,6,1338795862,1338795862,1,1,0
7969997@N02,3916,14,1376655811,1376657820,18,1,2009
7988532@N06,3917,73,1228430609,1228430609,1,1,0
79893993@N00,3918,14,1133510814,1133510814,1,1,0
79925938@N00,3919,71,1104369016,1104369048,2,1,32
79925938@N00,3920,71,1108448880,1108448968,5,1,88
79925938@N00,3921,71,1109747060,1109747094,2,1,34
79925938@N00,3922,2,1110028318,1110036073,2,1,7755
79925938@N00,3923,71,1111054601,1111054601,1,1,0
79925938@N00,3924,71,1111388489,1111388489,1,1,0
79925938@N00,3925,2,1123760346,1123762181,3,1,1835
79925938@N00,3926,2,1125747558,1125747558,1,1,0
79925938@N00,3927,71,1126936235,1126936235,1,1,0
79925938@N00,3928,2,1131800008,1131804110,5,1,4102
79925938@N00,3929,32,1137917443,1137917443,1,1,0
79925938@N00,3930,21,1141989684,1142012928,21,1,23244
79925938@N00,3931,71,1142331842,1142331842,1,1,0
79925938@N00,3932,21,1145109321,1145127172,27,1,17851
79925938@N00,3933,21,1146837288,1146851182,13,1,13894
79925938@N00,3934,21,1146897477,1146917822,22,1,20345
79925938@N00,3935,21,1149331308,1149370225,58,1,38917
79925938@N00,3936,21,1150557165,1150564992,11,1,7827
79925938@N00,3937,21,1151158777,1151174446,33,1,15669
79925938@N00,3938,21,1151738319,1151755531,18,1,17212
79925938@N00,3939,16,1151820549,1151830185,21,1,9636
79925938@N00,3940,21,1152971878,1153000717,38,1,28839
79925938@N00,3941,15,1153297567,1153297567,1,1,0
79925938@N00,3942,22,1153483736,1153489378,7,1,5642
79925938@N00,3943,26,1153826418,1153834536,17,1,8118
79925938@N00,3944,71,1155197803,1155197803,1,1,0
79925938@N00,3945,12,1156408517,1156411298,13,1,2781
79925938@N00,3946,27,1157202493,1157211029,45,1,8536
79925938@N00,3947,25,1159623737,1159630223,45,1,6486
79925938@N00,3948,22,1161439393,1161455449,35,1,16056
79925938@N00,3949,4,1166879983,1166883982,25,1,3999
79925938@N00,3950,25,1168089234,1168095825,22,1,6591
79925938@N00,3951,25,1169299976,1169302682,21,1,2706
79925938@N00,3952,25,1171114000,1171118081,24,1,4081
79925938@N00,3953,2,1171627857,1171628791,5,1,934
79925938@N00,3954,18,1171728567,1171729845,10,2,1278
79925938@N00,3954,25,1171717361,1171720236,12,2,2875
79925938@N00,3955,25,1172927574,1172930508,19,1,2934
79925938@N00,3956,25,1173539153,1173541929,12,1,2776
79925938@N00,3957,20,1174652301,1174656947,10,2,4646
79925938@N00,3957,27,1174658358,1174666359,24,2,8001
79925938@N00,3958,22,1174740451,1174755399,40,1,14948
79925938@N00,3959,20,1175258583,1175277860,47,1,19277
79925938@N00,3960,25,1175957148,1175960226,25,1,3078
79925938@N00,3961,25,1176562092,1176564441,31,1,2349
79925938@N00,3962,25,1177772804,1177775046,22,1,2242
79925938@N00,3963,4,1178382036,1178388451,21,3,6415
79925938@N00,3963,18,1178372188,1178376882,12,3,4694
79925938@N00,3963,25,1178378162,1178380122,26,3,1960
79925938@N00,3964,25,1178981553,1178983326,19,1,1773
79925938@N00,3965,20,1179490582,1179509980,51,1,19398
79925938@N00,3966,25,1179586611,1179591225,36,1,4614
79925938@N00,3967,20,1180097726,1180112640,43,1,14914
79925938@N00,3968,20,1180705213,1180715605,11,1,10392
79925938@N00,3969,25,1180797028,1180799101,23,1,2073
79925938@N00,3970,2,1181915342,1181924245,14,1,8903
79925938@N00,3971,18,1182000716,1182002695,6,2,1979
79925938@N00,3971,25,1182004298,1182007435,24,2,3137
79925938@N00,3972,16,1182069871,1182073617,3,1,3746
79925938@N00,3973,20,1182521103,1182534875,43,1,13772
79925938@N00,3974,18,1182609773,1182619357,27,1,9584
79925938@N00,3975,20,1183124234,1183141503,36,1,17269
79925938@N00,3976,25,1183213704,1183215776,29,1,2072
79925938@N00,3977,4,1183811851,1183814666,10,3,2815
79925938@N00,3977,18,1183821926,1183831991,17,3,10065
79925938@N00,3977,25,1183817385,1183820300,21,3,2915
79925938@N00,3978,20,1184335129,1184347710,36,1,12581
79925938@N00,3979,25,1184422861,1184431922,27,1,9061
79925938@N00,3980,2,1184940380,1184946380,16,1,6000
79925938@N00,3981,18,1185024041,1185026770,6,1,2729
79925938@N00,3982,20,1185544643,1185557780,21,1,13137
79925938@N00,3983,25,1185633670,1185637192,32,1,3522
79925938@N00,3984,40,1186149418,1186151847,14,1,2429
79925938@N00,3985,18,1186241051,1186245626,12,2,4575
79925938@N00,3985,25,1186235923,1186239257,21,2,3334
79925938@N00,3986,25,1186840940,1186846054,17,1,5114
79925938@N00,3987,2,1187358976,1187364908,12,1,5932
79925938@N00,3988,4,1187451668,1187459524,24,2,7856
79925938@N00,3988,25,1187445137,1187449525,33,2,4388
79925938@N00,3989,25,1188051183,1188053827,21,1,2644
79925938@N00,3990,20,1188564988,1188578003,25,1,13015
79925938@N00,3991,18,1188661141,1188669508,40,2,8367
79925938@N00,3991,25,1188653675,1188656530,28,2,2855
79925938@N00,3992,18,1189262966,1189271055,24,2,8089
79925938@N00,3992,25,1189253028,1189260866,70,2,7838
79925938@N00,3993,25,1189863947,1189866620,22,1,2673
79925938@N00,3994,20,1190382880,1190385360,13,1,2480
79925938@N00,3995,18,1190460224,1190484116,71,2,23892
79925938@N00,3995,25,1190473606,1190474941,22,2,1335
79925938@N00,3996,20,1190982814,1190993298,12,1,10484
79925938@N00,3997,20,1191067565,1191068194,5,2,629
79925938@N00,3997,25,1191071062,1191074116,34,2,3054
79925938@N00,3998,31,1191132452,1191132903,4,1,451
79925938@N00,3999,82,1191191976,1191192298,5,1,322
79925938@N00,4000,25,1192887902,1192890701,22,1,2799
79925938@N00,4001,27,1193214966,1193214966,1,2,0
79925938@N00,4001,85,1193217102,1193219298,3,2,2196
79925938@N00,4002,40,1193400587,1193413026,11,1,12439
79925938@N00,4003,17,1193490495,1193507903,23,2,17408
79925938@N00,4003,25,1193494044,1193497453,28,2,3409
79925938@N00,4004,25,1194092712,1194097271,25,1,4559
79925938@N00,4005,25,1194265773,1194284734,36,1,18961
79925938@N00,4006,18,1194710633,1194713070,16,2,2437
79925938@N00,4006,25,1194698767,1194701067,15,2,2300
79925938@N00,4007,25,1195306067,1195308417,14,1,2350
79925938@N00,4008,25,1196515027,1196517801,13,1,2774
79925938@N00,4009,25,1197724894,1197728959,23,1,4065
79925938@N00,4010,25,1198328967,1198330118,14,1,1151
79925938@N00,4011,18,1198586052,1198597029,48,1,10977
79925938@N00,4012,25,1198935566,1198938671,9,1,3105
79925938@N00,4013,25,1199538677,1199541142,21,1,2465
79925938@N00,4014,25,1200142619,1200146283,26,1,3664
79925938@N00,4015,4,1200753001,1200763178,16,2,10177
79925938@N00,4015,25,1200748121,1200750724,14,2,2603
79925938@N00,4016,40,1201276892,1201279336,7,1,2444
79925938@N00,4017,25,1201354464,1201357621,17,1,3157
79925938@N00,4018,18,1201963431,1201977126,24,2,13695
79925938@N00,4018,25,1201958676,1201962151,17,2,3475
79925938@N00,4019,25,1204288690,1204303853,27,1,15163
79925938@N00,4020,25,1204377795,1204380288,22,1,2493
79925938@N00,4021,56,1204706025,1204715734,28,1,9709
79925938@N00,4022,25,1204982828,1204985288,21,1,2460
79925938@N00,4023,60,1205646016,1205655335,24,1,9319
79925938@N00,4024,25,1206019261,1206026377,29,1,7116
79925938@N00,4025,25,1206193993,1206199145,12,1,5152
79925938@N00,4026,4,1206801150,1206817358,38,1,16208
79925938@N00,4027,25,1208095067,1208095983,8,1,916
79925938@N00,4028,18,1208696923,1208709793,21,2,12870
79925938@N00,4028,25,1208702062,1208703246,10,2,1184
79925938@N00,4029,40,1209915697,1209924294,22,1,8597
79925938@N00,4030,4,1211123008,1211130167,16,1,7159
79925938@N00,4031,18,1212332216,1212334777,5,2,2561
79925938@N00,4031,25,1212329332,1212330637,13,2,1305
79925938@N00,4032,71,1212664649,1212670270,11,1,5621
79925938@N00,4033,4,1213447544,1213453565,19,1,6021
79925938@N00,4034,18,1214747521,1214761070,36,1,13549
79925938@N00,4035,18,1215349267,1215364199,16,1,14932
79925938@N00,4036,25,1215958388,1215960344,24,1,1956
79925938@N00,4037,18,1216561375,1216572745,23,1,11370
79925938@N00,4038,18,1217772643,1217781759,26,1,9116
79925938@N00,4039,18,1218384852,1218386430,9,1,1578
79925938@N00,4040,18,1219592950,1219597891,17,2,4941
79925938@N00,4040,25,1219584934,1219590630,23,2,5696
79925938@N00,4041,18,1220102569,1220113842,15,1,11273
79925938@N00,4042,56,1223208283,1223226841,62,1,18558
79925938@N00,4043,47,1289985695,1289985695,1,1,0
79925938@N00,4044,1,1293362997,1293362997,1,1,0
79925938@N00,4045,22,1301136030,1301145758,3,1,9728
79925938@N00,4046,45,1302688172,1302688172,1,1,0
79925938@N00,4047,47,1303353347,1303353347,1,1,0
79925938@N00,4048,16,1353665288,1353665288,1,1,0
80021819@N00,4049,19,1382265029,1382265029,1,3,0
80021819@N00,4049,23,1382273738,1382273738,1,3,0
80021819@N00,4049,32,1382273856,1382273856,1,3,0
80296347@N00,4050,9,1294896865,1294897104,17,1,239
80296347@N00,4051,9,1295156952,1295156952,1,2,0
80296347@N00,4051,41,1295168753,1295168753,1,2,0
80373436@N00,4052,18,1313391350,1313391350,1,1,0
80373436@N00,4053,68,1324973120,1324974356,6,3,1236
80373436@N00,4053,71,1324972501,1324972501,1,3,0
80373436@N00,4053,81,1324980286,1324980886,16,3,600
80373436@N00,4054,32,1368852485,1368852485,1,1,0
80384851@N00,4055,26,1316066560,1316066673,2,1,113
80539888@N00,4056,45,1296874086,1296874086,1,1,0
8074405@N06,4057,32,1206059709,1206073497,12,2,13788
8074405@N06,4057,71,1206075575,1206076200,3,2,625
80994469@N00,4058,71,1316697664,1316697664,1,1,0
80994469@N00,4059,17,1316749189,1316750490,2,1,1301
80994469@N00,4060,71,1316790887,1316790888,2,1,1
81043308@N00,4061,84,1199323447,1199323447,1,1,0
81043308@N00,4062,82,1286610612,1286610612,1,1,0
81043308@N00,4063,41,1289045694,1289045694,1,1,0
81043308@N00,4064,41,1292245202,1292245202,1,1,0
81043308@N00,4065,41,1380787865,1380793882,6,1,6017
8107002@N03,4066,18,1324709297,1324709297,1,1,0
8107002@N03,4067,27,1324981519,1324982813,4,2,1294
8107002@N03,4067,44,1324982013,1324983090,2,2,1077
8107002@N03,4068,27,1325022259,1325022362,3,1,103
8107002@N03,4069,3,1325061085,1325061085,1,5,0
8107002@N03,4069,22,1325059502,1325059502,1,5,0
8107002@N03,4069,23,1325058319,1325058319,1,5,0
8107002@N03,4069,71,1325058507,1325058507,1,5,0
8107002@N03,4069,82,1325058406,1325058406,1,5,0
81177269@N00,4070,14,1304315642,1304315642,1,1,0
81177269@N00,4071,18,1309571955,1309571955,1,1,0
81177269@N00,4072,8,1322882270,1322882270,1,1,0
81177269@N00,4073,14,1323140403,1323140403,1,1,0
81177269@N00,4074,35,1323943257,1323943257,1,1,0
81177269@N00,4075,71,1324708892,1324708892,1,1,0
81177269@N00,4076,39,1324948419,1324948419,1,1,0
81177269@N00,4077,1,1327824687,1327824687,1,1,0
81177269@N00,4078,60,1330548504,1330548504,1,1,0
81177269@N00,4079,32,1331625447,1331628626,2,1,3179
81177269@N00,4080,3,1332844251,1332844251,1,1,0
81177269@N00,4081,26,1333675825,1333691685,3,1,15860
81177269@N00,4082,57,1333948504,1333952506,2,2,4002
81177269@N00,4082,82,1333959879,1333959879,1,2,0
81177269@N00,4083,9,1337168419,1337168419,1,2,0
81177269@N00,4083,45,1337157966,1337157966,1,2,0
81452997@N00,4084,50,1214086027,1214086027,2,2,0
81452997@N00,4084,68,1214088684,1214092342,3,2,3658
81697278@N02,4085,15,1341207453,1341207453,1,3,0
81697278@N02,4085,50,1341207458,1341207458,1,3,0
81697278@N02,4085,84,1341207426,1341207426,1,3,0
8202681@N05,4086,21,1281231096,1281231096,1,1,0
8202681@N05,4087,18,1291359584,1291359584,1,1,0
8205133@N06,4088,71,1153625041,1153627263,10,1,2222
8205133@N06,4089,71,1154679652,1154679652,1,1,0
8205133@N06,4090,71,1171171190,1171171190,1,1,0
8205133@N06,4091,18,1183364411,1183364411,1,1,0
8205133@N06,4092,14,1185001927,1185001927,1,1,0
8205133@N06,4093,71,1185683035,1185684266,14,1,1231
8205133@N06,4094,25,1252616575,1252616575,1,1,0
8205133@N06,4095,16,1289701856,1289701972,3,1,116
8205133@N06,4096,40,1308807776,1308807776,1,2,0
8205133@N06,4096,85,1308807562,1308807562,1,2,0
8205133@N06,4097,26,1334908759,1334909954,2,1,1195
8205133@N06,4098,85,1336939740,1336939740,1,1,0
8205133@N06,4099,85,1355805633,1355805633,1,1,0
8205133@N06,4100,45,1356233781,1356251928,5,1,18147
8205133@N06,4101,80,1357587394,1357587481,2,1,87
8205133@N06,4102,21,1362274030,1362276292,13,2,2262
8205133@N06,4102,84,1362281281,1362281303,2,2,22
82139102@N00,4103,35,1183105382,1183105723,3,1,341
82139102@N00,4104,35,1183535471,1183535514,2,1,43
82155102@N07,4105,13,1370516261,1370516398,2,3,137
82155102@N07,4105,17,1370516128,1370516181,2,3,53
82155102@N07,4105,82,1370515445,1370515445,1,3,0
82256568@N03,4106,15,1392017138,1392017224,3,7,86
82256568@N03,4106,35,1392018804,1392019230,8,7,426
82256568@N03,4106,45,1392016619,1392020488,6,7,3869
82256568@N03,4106,50,1392019393,1392019474,2,7,81
82256568@N03,4106,70,1392019341,1392019341,1,7,0
82256568@N03,4106,71,1392017448,1392018604,13,7,1156
82256568@N03,4106,82,1392017293,1392017293,1,7,0
82256568@N03,4107,44,1392061505,1392061514,2,3,9
82256568@N03,4107,45,1392062291,1392062291,1,3,0
82256568@N03,4107,81,1392060906,1392061628,2,3,722
82256568@N03,4108,44,1392113056,1392113056,1,3,0
82256568@N03,4108,50,1392112516,1392112516,1,3,0
82256568@N03,4108,81,1392112826,1392113124,2,3,298
82256568@N03,4109,45,1392147475,1392147475,1,1,0
82256568@N03,4110,25,1392198520,1392198520,1,1,0
82289516@N00,4111,0,1248054902,1248054902,1,1,0
82289516@N00,4112,0,1248405012,1248405012,1,1,0
82397118@N00,4113,35,1357967483,1357967483,1,3,0
82397118@N00,4113,71,1357967641,1357985770,3,3,18129
82397118@N00,4113,82,1357967356,1357967508,2,3,152
82397118@N00,4114,37,1361775763,1361775763,1,1,0
82397118@N00,4115,66,1372028858,1372028858,1,1,0
82397118@N00,4116,48,1373527896,1373527896,1,1,0
82397118@N00,4117,68,1374367802,1374367802,1,1,0
82397118@N00,4118,82,1376727521,1376727521,1,1,0
82397118@N00,4119,85,1377844965,1377844965,1,1,0
8249050@N02,4120,70,1317391200,1317391200,1,2,0
8249050@N02,4120,81,1317391200,1317391200,1,2,0
8249050@N02,4121,36,1318756052,1318757213,2,3,1161
8249050@N02,4121,40,1318764354,1318764354,1,3,0
8249050@N02,4121,53,1318752933,1318752933,1,3,0
82681134@N00,4122,28,1159120469,1159131603,16,1,11134
82698298@N00,4123,9,1168839970,1168839970,1,3,0
82698298@N00,4123,35,1168830765,1168830765,1,3,0
82698298@N00,4123,50,1168831274,1168840402,3,3,9128
82698298@N00,4124,43,1168906571,1168906571,1,4,0
82698298@N00,4124,49,1168906749,1168908686,8,4,1937
82698298@N00,4124,71,1168905207,1168905542,3,4,335
82698298@N00,4124,81,1168909912,1168909912,1,4,0
82698298@N00,4125,26,1169421516,1169423072,3,2,1556
82698298@N00,4125,48,1169426149,1169426539,2,2,390
82698298@N00,4126,8,1169506264,1169506382,2,5,118
82698298@N00,4126,35,1169506514,1169507241,2,5,727
82698298@N00,4126,50,1169506874,1169506874,1,5,0
82698298@N00,4126,70,1169507820,1169507820,1,5,0
82698298@N00,4126,82,1169506787,1169506787,1,5,0
8281413@N06,4127,45,1363338243,1363340785,2,3,2542
8281413@N06,4127,50,1363342559,1363342559,1,3,0
8281413@N06,4127,71,1363310557,1363310557,1,3,0
8281413@N06,4128,31,1363411969,1363411969,1,2,0
8281413@N06,4128,57,1363394630,1363394630,1,2,0
82955378@N05,4129,19,1344214546,1344214546,1,7,0
82955378@N05,4129,32,1344214160,1344214160,1,7,0
82955378@N05,4129,35,1344229063,1344229063,1,7,0
82955378@N05,4129,41,1344213613,1344213613,1,7,0
82955378@N05,4129,50,1344229560,1344229560,1,7,0
82955378@N05,4129,51,1344228146,1344228146,1,7,0
82955378@N05,4129,73,1344215339,1344215339,1,7,0
83029300@N00,4130,44,1162090653,1162092287,14,4,1634
83029300@N00,4130,45,1162088256,1162088293,2,4,37
83029300@N00,4130,68,1162085671,1162086387,4,4,716
83029300@N00,4130,82,1162087511,1162088387,6,4,876
83029300@N00,4131,28,1307759410,1307775205,10,1,15795
83029300@N00,4132,27,1372210167,1372210167,1,1,0
8329215@N04,4133,8,1267851188,1267851188,1,4,0
8329215@N04,4133,41,1267839172,1267839172,1,4,0
8329215@N04,4133,45,1267844779,1267849402,3,4,4623
8329215@N04,4133,82,1267849761,1267850481,9,4,720
8329215@N04,4134,0,1287188147,1287202351,2,9,14204
8329215@N04,4134,25,1287192253,1287192253,1,9,0
8329215@N04,4134,31,1287192524,1287202350,15,9,9826
8329215@N04,4134,44,1287191491,1287191491,1,9,0
8329215@N04,4134,45,1287186730,1287192253,51,9,5523
8329215@N04,4134,50,1287207770,1287207770,1,9,0
8329215@N04,4134,71,1287199206,1287203148,12,9,3942
8329215@N04,4134,81,1287199071,1287199108,2,9,37
8329215@N04,4134,82,1287199184,1287199184,1,9,0
8329215@N04,4135,82,1287288580,1287288696,7,1,116
8329215@N04,4136,68,1301564730,1301564730,1,1,0
8329215@N04,4137,9,1301620061,1301620061,1,2,0
8329215@N04,4137,71,1301618530,1301618530,1,2,0
8329215@N04,4138,27,1301709604,1301715629,51,1,6025
8329215@N04,4139,22,1301789935,1301789935,1,2,0
8329215@N04,4139,85,1301810076,1301810076,1,2,0
8329215@N04,4140,82,1362099846,1362099846,1,1,0
83332749@N00,4141,0,1232256647,1232256995,4,7,348
83332749@N00,4141,14,1232285853,1232285939,3,7,86
83332749@N00,4141,25,1232242938,1232247528,7,7,4590
83332749@N00,4141,31,1232257024,1232257249,4,7,225
83332749@N00,4141,51,1232248432,1232250384,22,7,1952
83332749@N00,4141,71,1232253240,1232255866,15,7,2626
83332749@N00,4141,81,1232256032,1232256170,2,7,138
83332749@N00,4142,25,1232357758,1232361827,10,1,4069
83332749@N00,4143,31,1235228369,1235228369,1,1,0
83339757@N00,4144,31,1372054799,1372054799,1,1,0
83526122@N07,4145,44,1379396263,1379396263,1,1,0
83633366@N00,4146,50,1333945427,1333946446,12,2,1019
83633366@N00,4146,71,1333945908,1333946940,5,2,1032
83633366@N00,4147,16,1336276008,1336276355,13,1,347
83633366@N00,4148,9,1364791776,1364791835,3,1,59
83633366@N00,4149,9,1379218502,1379218502,1,1,0
8365908@N05,4150,71,1284462198,1284462198,1,1,0
83788286@N00,4151,35,1210970456,1210970458,2,1,2
83794824@N07,4152,62,1343556951,1343556951,1,1,0
84097316@N00,4153,28,1176254145,1176254145,1,1,0
8429346@N03,4154,20,1344006298,1344006298,1,1,0
8429346@N03,4155,20,1347643393,1347643393,1,1,0
8429346@N03,4156,71,1351461991,1351462559,2,1,568
8429346@N03,4157,37,1353708193,1353708193,1,1,0
8429346@N03,4158,20,1359767669,1359772393,2,1,4724
8429346@N03,4159,32,1360053123,1360053123,1,1,0
8429346@N03,4160,17,1360284101,1360284101,1,4,0
8429346@N03,4160,70,1360284266,1360284266,1,4,0
8429346@N03,4160,71,1360280225,1360291078,4,4,10853
8429346@N03,4160,82,1360291319,1360291319,1,4,0
8429346@N03,4161,20,1362792093,1362792093,1,1,0
84385698@N00,4162,46,1291192402,1291201003,8,1,8601
84385698@N00,4163,5,1291288542,1291288542,1,2,0
84385698@N00,4163,46,1291289587,1291289587,1,2,0
84385698@N00,4164,46,1291357316,1291386724,10,1,29408
84385698@N00,4165,63,1292518213,1292518213,1,1,0
84385698@N00,4166,18,1295076861,1295076861,1,1,0
84385698@N00,4167,71,1296904603,1296904603,1,1,0
84385698@N00,4168,2,1302305627,1302305627,1,1,0
84385698@N00,4169,57,1303649577,1303651974,3,1,2397
84385698@N00,4170,2,1314744677,1314745158,4,1,481
84385698@N00,4171,3,1318628031,1318628031,1,5,0
84385698@N00,4171,14,1318628270,1318628270,1,5,0
84385698@N00,4171,22,1318627406,1318627406,1,5,0
84385698@N00,4171,71,1318627133,1318627133,1,5,0
84385698@N00,4171,81,1318628542,1318628634,2,5,92
84385698@N00,4172,37,1321385334,1321385334,1,1,0
84385698@N00,4173,71,1321707473,1321707473,1,1,0
84385698@N00,4174,2,1322051144,1322051144,1,1,0
84385698@N00,4175,71,1323856930,1323856930,1,1,0
84385698@N00,4176,21,1331829116,1331829116,1,1,0
84579440@N00,4177,71,1273022553,1273022553,1,1,0
84579440@N00,4178,57,1273205150,1273205150,1,1,0
8471767@N05,4179,31,1256373841,1256373841,1,1,0
8473570@N02,4180,32,1290380845,1290386899,9,1,6054
8473570@N02,4181,27,1290632371,1290635815,10,1,3444
8473570@N02,4182,28,1290784300,1290792359,9,3,8059
8473570@N02,4182,32,1290797199,1290803722,5,3,6523
8473570@N02,4182,50,1290808760,1290809404,9,3,644
8473570@N02,4183,13,1290893678,1290893770,3,4,92
8473570@N02,4183,32,1290894165,1290900536,4,4,6371
8473570@N02,4183,33,1290887364,1290888364,2,4,1000
8473570@N02,4183,49,1290891118,1290891841,5,4,723
8473570@N02,4184,32,1291392510,1291396584,3,1,4074
8473570@N02,4185,31,1291474444,1291480095,4,5,5651
8473570@N02,4185,32,1291482181,1291489456,3,5,7275
8473570@N02,4185,46,1291504718,1291504890,2,5,172
8473570@N02,4185,51,1291490311,1291490746,2,5,435
8473570@N02,4185,71,1291484367,1291486999,4,5,2632
84801166@N00,4186,32,1273808302,1273808302,1,1,0
84801166@N00,4187,42,1317092956,1317092956,1,2,0
84801166@N00,4187,85,1317092353,1317092353,1,2,0
84801166@N00,4188,42,1319431814,1319431814,1,1,0
84801166@N00,4189,42,1320373919,1320373919,1,1,0
84801166@N00,4190,85,1345519107,1345519107,1,1,0
84801166@N00,4191,9,1346642402,1346642402,1,1,0
84801166@N00,4192,12,1347491045,1347491045,1,1,0
84801166@N00,4193,42,1347529247,1347529247,1,1,0
84801166@N00,4194,32,1352862022,1352862022,1,1,0
84801166@N00,4195,9,1354864055,1354864055,1,1,0
84802084@N00,4196,57,1338008318,1338009845,2,1,1527
8485766@N07,4197,44,1202442292,1202442292,1,1,0
8485766@N07,4198,44,1211606800,1211606800,1,4,0
8485766@N07,4198,49,1211610689,1211610812,2,4,123
8485766@N07,4198,75,1211607238,1211608188,3,4,950
8485766@N07,4198,81,1211606584,1211606584,1,4,0
84987970@N00,4199,10,1235269721,1235273335,3,5,3614
84987970@N00,4199,26,1235287251,1235287251,1,5,0
84987970@N00,4199,39,1235274831,1235274843,3,5,12
84987970@N00,4199,40,1235274858,1235275613,9,5,755
84987970@N00,4199,78,1235274082,1235274473,2,5,391
84987970@N00,4200,39,1301565652,1301565652,1,2,0
84987970@N00,4200,42,1301562134,1301562134,1,2,0
84987970@N00,4201,85,1301698220,1301698281,2,1,61
84987970@N00,4202,26,1301801503,1301812907,2,4,11404
84987970@N00,4202,31,1301800722,1301800722,1,4,0
84987970@N00,4202,32,1301798943,1301798943,1,4,0
84987970@N00,4202,85,1301800342,1301819404,5,4,19062
84987970@N00,4203,40,1301886564,1301887033,12,3,469
84987970@N00,4203,82,1301897489,1301897489,1,3,0
84987970@N00,4203,84,1301899685,1301899691,2,3,6
84987970@N00,4204,9,1305965003,1305965003,1,4,0
84987970@N00,4204,23,1305964583,1305964583,1,4,0
84987970@N00,4204,31,1305945275,1305945275,1,4,0
84987970@N00,4204,32,1305964774,1305964774,1,4,0
84987970@N00,4205,31,1306042090,1306042090,1,4,0
84987970@N00,4205,35,1306063262,1306063262,1,4,0
84987970@N00,4205,37,1306046363,1306046363,1,4,0
84987970@N00,4205,81,1306051964,1306065579,2,4,13615
84987970@N00,4206,8,1306112963,1306112968,2,5,5
84987970@N00,4206,22,1306132943,1306132943,1,5,0
84987970@N00,4206,23,1306112954,1306112954,1,5,0
84987970@N00,4206,31,1306137333,1306137333,1,5,0
84987970@N00,4206,84,1306125408,1306125408,1,5,0
84987970@N00,4207,4,1355219301,1355219344,2,2,43
84987970@N00,4207,24,1355219444,1355219694,5,2,250
84987970@N00,4208,21,1355299349,1355302227,3,2,2878
84987970@N00,4208,26,1355291979,1355292196,5,2,217
84987970@N00,4209,4,1355357066,1355358512,9,10,1446
84987970@N00,4209,9,1355365754,1355401284,5,10,35530
84987970@N00,4209,15,1355401934,1355401934,1,10,0
84987970@N00,4209,18,1355400418,1355400418,1,10,0
84987970@N00,4209,22,1355366203,1355366203,1,10,0
84987970@N00,4209,23,1355400616,1355400622,2,10,6
84987970@N00,4209,24,1355356871,1355377606,10,10,20735
84987970@N00,4209,32,1355400345,1355400414,3,10,69
84987970@N00,4209,36,1355403524,1355403524,1,10,0
84987970@N00,4209,84,1355363315,1355364220,2,10,905
84987970@N00,4210,32,1355487870,1355487870,1,3,0
84987970@N00,4210,48,1355468407,1355468407,1,3,0
84987970@N00,4210,51,1355471324,1355471324,1,3,0
84987970@N00,4211,2,1355559833,1355559833,1,7,0
84987970@N00,4211,9,1355567792,1355567792,1,7,0
84987970@N00,4211,25,1355571538,1355571715,2,7,177
84987970@N00,4211,35,1355560444,1355564940,6,7,4496
84987970@N00,4211,70,1355561369,1355564315,4,7,2946
84987970@N00,4211,81,1355569558,1355569569,2,7,11
84987970@N00,4211,82,1355570041,1355570814,3,7,773
84987970@N00,4212,4,1355647597,1355647597,1,8,0
84987970@N00,4212,9,1355645378,1355645378,1,8,0
84987970@N00,4212,14,1355644795,1355644795,1,8,0
84987970@N00,4212,18,1355645531,1355645627,3,8,96
84987970@N00,4212,32,1355630999,1355645297,2,8,14298
84987970@N00,4212,36,1355647565,1355647565,1,8,0
84987970@N00,4212,47,1355640764,1355641297,4,8,533
84987970@N00,4212,84,1355647357,1355647357,1,8,0
84987970@N00,4213,10,1355725366,1355725374,2,3,8
84987970@N00,4213,24,1355708080,1355708080,1,3,0
84987970@N00,4213,37,1355706487,1355706571,2,3,84
84987970@N00,4214,9,1355833478,1355833710,2,5,232
84987970@N00,4214,24,1355801619,1355812736,7,5,11117
84987970@N00,4214,39,1355788853,1355792766,12,5,3913
84987970@N00,4214,69,1355800286,1355800291,2,5,5
84987970@N00,4214,85,1355810659,1355810659,1,5,0
84987970@N00,4215,53,1355884876,1355884883,2,2,7
84987970@N00,4215,85,1355879875,1355880252,2,2,377
8502118@N08,4216,9,1357276087,1357276087,1,3,0
8502118@N08,4216,71,1357278547,1357278680,8,3,133
8502118@N08,4216,81,1357278599,1357278599,1,3,0
8502118@N08,4217,0,1357549118,1357549120,2,10,2
8502118@N08,4217,1,1357516446,1357516671,4,10,225
8502118@N08,4217,13,1357546976,1357546976,1,10,0
8502118@N08,4217,17,1357546981,1357546981,1,10,0
8502118@N08,4217,27,1357530210,1357532286,18,10,2076
8502118@N08,4217,44,1357545496,1357545496,1,10,0
8502118@N08,4217,45,1357545936,1357556157,26,10,10221
8502118@N08,4217,47,1357521972,1357522091,3,10,119
8502118@N08,4217,81,1357545291,1357545355,3,10,64
8502118@N08,4217,82,1357546905,1357546952,2,10,47
8502118@N08,4218,21,1357600298,1357601625,36,1,1327
8502118@N08,4219,2,1357697035,1357697387,9,9,352
8502118@N08,4219,4,1357711131,1357711131,1,9,0
8502118@N08,4219,21,1357719686,1357722399,25,9,2713
8502118@N08,4219,36,1357704109,1357710733,12,9,6624
8502118@N08,4219,37,1357705807,1357709319,2,9,3512
8502118@N08,4219,39,1357696795,1357698527,4,9,1732
8502118@N08,4219,40,1357697415,1357702054,33,9,4639
8502118@N08,4219,41,1357711305,1357711515,2,9,210
8502118@N08,4219,51,1357697633,1357698064,7,9,431
85225246@N00,4220,12,1263704901,1263708193,4,1,3292
85225246@N00,4221,12,1263755900,1263774863,25,1,18963
85226206@N00,4222,15,1085191364,1085191505,2,1,141
85226206@N00,4223,71,1085351807,1085351949,2,1,142
85226206@N00,4224,0,1096078218,1096078218,1,2,0
85226206@N00,4224,71,1096090705,1096090705,1,2,0
85266958@N07,4225,26,1363681923,1363681923,1,1,0
85266958@N07,4226,25,1365151780,1365151780,1,1,0
85458885@N04,4227,0,1341368684,1341368684,1,1,0
85533777@N00,4228,63,1295687971,1295687971,1,1,0
85533777@N00,4229,32,1304516562,1304516562,1,1,0
85636444@N00,4230,41,1302576398,1302582852,16,1,6454
85711459@N00,4231,37,1158030733,1158030768,2,1,35
85711459@N00,4232,6,1158096555,1158096555,1,2,0
85711459@N00,4232,35,1158116258,1158116258,1,2,0
85711459@N00,4233,84,1158538574,1158538574,1,1,0
85798762@N00,4234,81,1196485924,1196485924,1,1,0
85798762@N00,4235,71,1196600198,1196600198,1,2,0
85798762@N00,4235,82,1196598096,1196598096,1,2,0
85919197@N00,4236,63,1144864994,1144865119,2,1,125
85919197@N00,4237,63,1144910643,1144910939,10,1,296
85919197@N00,4238,49,1146828144,1146828225,3,1,81
85919197@N00,4239,49,1146884306,1146885770,4,1,1464
85919197@N00,4240,62,1229764483,1229764483,1,1,0
85919197@N00,4241,28,1240190858,1240190858,1,1,0
85919197@N00,4242,15,1287960669,1287960669,1,1,0
86174736@N00,4243,58,1363223929,1363223965,2,1,36
86292040@N00,4244,11,1311397856,1311397881,6,3,25
86292040@N00,4244,32,1311397814,1311397816,2,3,2
86292040@N00,4244,42,1311397829,1311397846,11,3,17
86292040@N00,4245,11,1311753811,1311753811,1,4,0
86292040@N00,4245,32,1311753219,1311753625,9,4,406
86292040@N00,4245,42,1311753756,1311753787,2,4,31
86292040@N00,4245,71,1311753723,1311753723,1,4,0
86589646@N00,4246,50,1225229379,1225229395,2,1,16
86589646@N00,4247,50,1227486637,1227486706,5,1,69
86589646@N00,4248,50,1228817180,1228817181,2,1,1
86589646@N00,4249,35,1258513738,1258513738,1,1,0
86589646@N00,4250,50,1271765448,1271765448,1,1,0
86589646@N00,4251,35,1283919886,1283919890,2,1,4
86589646@N00,4252,28,1285026664,1285026706,3,1,42
86589646@N00,4253,65,1286664748,1286670508,3,1,5760
86589646@N00,4254,9,1289344198,1289344198,1,1,0
86589646@N00,4255,35,1291103682,1291106939,4,1,3257
86589646@N00,4256,28,1292636908,1292636908,2,1,0
86589646@N00,4257,9,1292888001,1292888017,2,3,16
86589646@N00,4257,35,1292888502,1292888502,1,3,0
86589646@N00,4257,71,1292888159,1292888159,1,3,0
86589646@N00,4258,40,1293073613,1293073631,3,1,18
86589646@N00,4259,73,1295401076,1295401076,1,1,0
86589646@N00,4260,28,1296963943,1296967367,2,1,3424
86589646@N00,4261,9,1297138404,1297138404,1,11,0
86589646@N00,4261,15,1297136314,1297136486,2,11,172
86589646@N00,4261,16,1297142206,1297143133,8,11,927
86589646@N00,4261,19,1297141532,1297141877,3,11,345
86589646@N00,4261,22,1297139215,1297139649,6,11,434
86589646@N00,4261,23,1297137945,1297137945,1,11,0
86589646@N00,4261,35,1297137885,1297137885,1,11,0
86589646@N00,4261,41,1297139728,1297139728,1,11,0
86589646@N00,4261,50,1297133148,1297133148,1,11,0
86589646@N00,4261,68,1297138841,1297138841,1,11,0
86589646@N00,4261,71,1297132883,1297133790,3,11,907
86589646@N00,4262,23,1299535742,1299535742,1,1,0
86589646@N00,4263,71,1301011869,1301011869,1,1,0
86589646@N00,4264,9,1304379332,1304379332,1,1,0
86589646@N00,4265,9,1308700350,1308700350,1,1,0
86589646@N00,4266,50,1311898069,1311898189,2,2,120
86589646@N00,4266,71,1311898202,1311898202,1,2,0
86636924@N02,4267,48,1340403162,1340403162,1,1,0
86636924@N02,4268,1,1342806778,1342806778,1,2,0
86636924@N02,4268,85,1342805082,1342815827,3,2,10745
86657001@N00,4269,46,1173592555,1173592555,1,1,0
87023816@N00,4270,48,1359206950,1359206950,1,1,0
87023816@N00,4271,23,1359817193,1359817193,1,1,0
87023816@N00,4272,3,1372485636,1372485636,1,1,0
87023816@N00,4273,56,1390016923,1390016923,1,1,0
87023816@N00,4274,55,1390437595,1390437595,1,2,0
87023816@N00,4274,63,1390444809,1390444809,1,2,0
87109756@N02,4275,13,1259136376,1259136649,2,1,273
87109756@N02,4276,81,1263202624,1263202624,1,1,0
87109756@N02,4277,50,1264157686,1264157686,1,1,0
87109756@N02,4278,13,1265515872,1265515872,1,1,0
87109756@N02,4279,67,1266395038,1266395038,1,1,0
87109756@N02,4280,49,1276580102,1276580102,1,1,0
87109756@N02,4281,68,1277609248,1277609248,1,1,0
87109756@N02,4282,23,1279287195,1279287195,1,1,0
87109756@N02,4283,13,1279435539,1279435539,1,1,0
87109756@N02,4284,45,1310210678,1310210678,1,1,0
87109756@N02,4285,32,1314415567,1314415567,1,1,0
87109756@N02,4286,9,1321079322,1321079322,1,1,0
87109756@N02,4287,31,1321240513,1321240513,1,1,0
87109756@N02,4288,40,1323652358,1323652358,1,1,0
87109756@N02,4289,71,1347569776,1347569776,1,1,0
87109756@N02,4290,2,1348030775,1348031722,2,6,947
87109756@N02,4290,13,1348028138,1348028138,1,6,0
87109756@N02,4290,17,1348028097,1348028097,1,6,0
87109756@N02,4290,40,1348031001,1348031001,1,6,0
87109756@N02,4290,50,1348028378,1348029236,3,6,858
87109756@N02,4290,70,1348029143,1348029143,1,6,0
87109756@N02,4291,9,1348910179,1348910179,1,1,0
87168693@N00,4292,55,1326673605,1326673605,1,2,0
87168693@N00,4292,63,1326677874,1326702923,3,2,25049
87168693@N00,4293,71,1326767639,1326767639,1,1,0
87168693@N00,4294,63,1326852111,1326873446,2,1,21335
87168693@N00,4295,57,1326959818,1326959818,1,1,0
87168693@N00,4296,48,1327023906,1327023906,1,2,0
87168693@N00,4296,72,1327021028,1327021028,1,2,0
8721758@N06,4297,7,1092402296,1092403166,3,1,870
8721758@N06,4298,7,1124832419,1124832419,1,1,0
8721758@N06,4299,7,1124878738,1124893392,5,1,14654
8721758@N06,4300,1,1223500675,1223500675,1,1,0
8721758@N06,4301,25,1223593216,1223593216,1,2,0
8721758@N06,4301,81,1223586188,1223587189,2,2,1001
8721758@N06,4302,26,1223672127,1223672127,1,1,0
8721758@N06,4303,35,1223758956,1223758956,1,2,0
8721758@N06,4303,82,1223758238,1223758238,1,2,0
8721758@N06,4304,7,1274010437,1274012470,7,1,2033
8721758@N06,4305,45,1295305796,1295305796,1,1,0
8721758@N06,4306,71,1295565112,1295565112,1,1,0
8721758@N06,4307,76,1387951605,1387951605,1,1,0
8721758@N06,4308,45,1388132200,1388136987,7,1,4787
8721758@N06,4309,49,1388221202,1388221621,3,1,419
87232391@N00,4310,81,1283238273,1283238273,1,1,0
87232391@N00,4311,82,1287502086,1287502086,1,1,0
8732405@N02,4312,42,1280969162,1280969162,1,1,0
87355829@N00,4313,13,1279766549,1279766549,1,2,0
87355829@N00,4313,50,1279768531,1279768531,1,2,0
87355829@N00,4314,14,1279853853,1279853853,1,3,0
87355829@N00,4314,17,1279851710,1279852594,2,3,884
87355829@N00,4314,71,1279880787,1279886559,4,3,5772
87355829@N00,4315,11,1279962470,1279962470,1,3,0
87355829@N00,4315,13,1279939419,1279939419,1,3,0
87355829@N00,4315,17,1279935174,1279935619,3,3,445
87355829@N00,4316,13,1280021341,1280021341,1,4,0
87355829@N00,4316,17,1280022927,1280022927,1,4,0
87355829@N00,4316,18,1280017930,1280018017,3,4,87
87355829@N00,4316,32,1280030301,1280038304,3,4,8003
87355829@N00,4317,13,1280130954,1280130954,1,1,0
87355829@N00,4318,71,1280281949,1280281986,6,1,37
87355829@N00,4319,70,1280318700,1280318798,8,1,98
87355829@N00,4320,13,1280366075,1280366075,1,2,0
87355829@N00,4320,71,1280368294,1280368294,1,2,0
87356726@N00,4321,45,1181413505,1181416662,16,1,3157
87356726@N00,4322,71,1277259042,1277259042,1,1,0
87356726@N00,4323,20,1287611573,1287611637,2,1,64
87356726@N00,4324,71,1287701116,1287701116,1,1,0
87356726@N00,4325,11,1287977734,1287977749,2,1,15
87356726@N00,4326,85,1288226104,1288226104,1,1,0
87356726@N00,4327,20,1289954933,1289954951,2,1,18
87356726@N00,4328,39,1290470749,1290470944,2,3,195
87356726@N00,4328,71,1290471528,1290471528,1,3,0
87356726@N00,4328,72,1290470460,1290470460,1,3,0
87356726@N00,4329,71,1290647654,1290667684,5,1,20030
87356726@N00,4330,82,1290837216,1290837292,2,1,76
87356726@N00,4331,51,1291680169,1291680388,5,1,219
87356726@N00,4332,0,1295494113,1295494113,1,2,0
87356726@N00,4332,31,1295495553,1295495553,1,2,0
87356726@N00,4333,11,1296291714,1296296902,2,1,5188
87356726@N00,4334,71,1298715696,1298724875,3,1,9179
87356726@N00,4335,66,1301130685,1301153912,42,1,23227
87356726@N00,4336,36,1301994475,1302004269,4,1,9794
87356726@N00,4337,82,1302169976,1302169976,1,1,0
87356726@N00,4338,15,1305107377,1305107377,1,1,0
87356726@N00,4339,26,1307143578,1307143578,1,1,0
87356726@N00,4340,17,1307760215,1307760215,1,1,0
87356726@N00,4341,82,1308107372,1308107423,2,1,51
87356726@N00,4342,19,1309234100,1309234100,1,1,0
87356726@N00,4343,82,1309906189,1309906250,2,1,61
87356726@N00,4344,40,1313752289,1313761685,3,1,9396
87356726@N00,4345,11,1313839674,1313840059,4,1,385
87356726@N00,4346,35,1314263622,1314263645,2,1,23
87356726@N00,4347,62,1316503994,1316503994,1,1,0
87356726@N00,4348,26,1316597712,1316597712,1,1,0
87356726@N00,4349,73,1318550559,1318550559,1,1,0
87356726@N00,4350,40,1356041566,1356041566,1,1,0
87356726@N00,4351,15,1356677902,1356677902,1,1,0
87356726@N00,4352,16,1356937966,1356937966,1,1,0
87356726@N00,4353,32,1357863072,1357863072,1,1,0
87356726@N00,4354,16,1358492377,1358492377,1,1,0
87356726@N00,4355,31,1360190184,1360190184,1,1,0
87356726@N00,4356,35,1365858828,1365858828,1,1,0
87356726@N00,4357,19,1369379662,1369379662,1,1,0
87356726@N00,4358,56,1370385657,1370385657,1,1,0
87356726@N00,4359,32,1370904543,1370904543,1,1,0
87356726@N00,4360,44,1372498711,1372498711,1,1,0
87356726@N00,4361,44,1374923838,1374923838,1,1,0
87356726@N00,4362,32,1375334338,1375334338,1,1,0
87356726@N00,4363,82,1379670756,1379670756,1,1,0
87356726@N00,4364,16,1382669289,1382669289,1,1,0
87356726@N00,4365,19,1383188715,1383188715,1,1,0
87356726@N00,4366,16,1383513512,1383513512,1,1,0
87393953@N00,4367,27,1360167237,1360167237,1,2,0
87393953@N00,4367,45,1360167650,1360167650,1,2,0
87393953@N00,4368,8,1360208610,1360208610,1,4,0
87393953@N00,4368,27,1360206053,1360206053,1,4,0
87393953@N00,4368,50,1360207337,1360207337,1,4,0
87393953@N00,4368,71,1360206731,1360206731,1,4,0
87393953@N00,4369,28,1360256919,1360257394,2,3,475
87393953@N00,4369,81,1360238740,1360238740,1,3,0
87393953@N00,4369,82,1360238442,1360238442,1,3,0
87393953@N00,4370,41,1360304664,1360304664,1,1,0
8752047@N02,4371,36,1086012000,1086012000,1,1,0
8755651@N05,4372,7,1341202693,1341202693,1,4,0
8755651@N05,4372,22,1341205049,1341205193,2,4,144
8755651@N05,4372,82,1341208858,1341208858,1,4,0
8755651@N05,4372,84,1341203569,1341203569,1,4,0
87584208@N00,4373,73,1302305255,1302305255,1,1,0
87584208@N00,4374,57,1302339845,1302339845,1,1,0
87584208@N00,4375,9,1302411358,1302411358,1,3,0
87584208@N00,4375,25,1302438098,1302438098,1,3,0
87584208@N00,4375,84,1302409078,1302409078,1,3,0
87584208@N00,4376,3,1302485749,1302487644,2,4,1895
87584208@N00,4376,4,1302484470,1302484470,1,4,0
87584208@N00,4376,26,1302503492,1302503492,1,4,0
87584208@N00,4376,73,1302480217,1302480217,1,4,0
87584208@N00,4377,49,1314419955,1314419955,1,1,0
87584208@N00,4378,12,1314522366,1314522366,1,2,0
87584208@N00,4378,70,1314499241,1314505092,2,2,5851
87584208@N00,4379,4,1317479237,1317479237,1,1,0
87584208@N00,4380,47,1317620089,1317620089,1,1,0
87584208@N00,4381,63,1321951637,1321951637,1,1,0
87584208@N00,4382,26,1326606421,1326606421,1,1,0
87584208@N00,4383,26,1328957921,1328957921,1,1,0
87584208@N00,4384,25,1333950089,1333955318,3,1,5229
87584208@N00,4385,86,1334930889,1334930889,1,1,0
87584208@N00,4386,47,1339908342,1339908466,2,1,124
87584208@N00,4387,32,1342792935,1342792935,1,1,0
87584208@N00,4388,3,1342874438,1342874438,1,2,0
87584208@N00,4388,61,1342862650,1342871803,2,2,9153
87584208@N00,4389,9,1355542728,1355542728,1,3,0
87584208@N00,4389,25,1355543701,1355543701,1,3,0
87584208@N00,4389,82,1355548132,1355548132,1,3,0
87729121@N00,4390,11,1144144761,1144144780,4,1,19
87729121@N00,4391,35,1145180636,1145180636,1,1,0
87729121@N00,4392,32,1164519284,1164520517,3,2,1233
87729121@N00,4392,84,1164509762,1164515794,2,2,6032
87729121@N00,4393,3,1165572559,1165576228,3,1,3669
87729121@N00,4394,84,1166327904,1166328244,3,1,340
87729121@N00,4395,22,1331964427,1331968036,4,1,3609
87801055@N06,4396,25,1345881597,1345881597,1,4,0
87801055@N06,4396,31,1345880496,1345880496,1,4,0
87801055@N06,4396,34,1345870873,1345870873,1,4,0
87801055@N06,4396,44,1345880801,1345880801,1,4,0
87801055@N06,4397,27,1345943402,1345943402,1,2,0
87801055@N06,4397,48,1345958290,1345959128,2,2,838
87801055@N06,4398,26,1346027468,1346027468,1,1,0
87801055@N06,4399,22,1346126181,1346126181,1,3,0
87801055@N06,4399,36,1346115697,1346120626,3,3,4929
87801055@N06,4399,41,1346125235,1346125235,1,3,0
87837676@N00,4400,48,1125523459,1125523459,1,1,0
87837676@N00,4401,48,1318386072,1318386072,1,1,0
87837676@N00,4402,48,1320622470,1320622470,1,1,0
88134187@N00,4403,85,1324605937,1324605937,1,1,0
88134187@N00,4404,26,1326949900,1326970742,2,1,20842
88641821@N00,4405,2,1088371082,1088371134,2,1,52
88641821@N00,4406,81,1099566505,1099566535,2,1,30
88641821@N00,4407,15,1100590834,1100590834,1,2,0
88641821@N00,4407,71,1100591232,1100591232,1,2,0
88641821@N00,4408,26,1107714860,1107715424,9,1,564
88641821@N00,4409,22,1125762627,1125762657,2,1,30
88641821@N00,4410,9,1160461262,1160461262,1,2,0
88641821@N00,4410,35,1160461694,1160462350,4,2,656
88641821@N00,4411,32,1164002202,1164002202,1,1,0
88641821@N00,4412,32,1164103427,1164109385,14,1,5958
88641821@N00,4413,16,1168002017,1168004837,3,1,2820
88641821@N00,4414,26,1198610067,1198610067,1,1,0
88781298@N00,4415,14,1282266457,1282266457,1,1,0
88955553@N00,4416,47,1297388147,1297388147,1,1,0
88955553@N00,4417,48,1304134295,1304134295,1,1,0
88955553@N00,4418,26,1315959176,1315960562,2,1,1386
88955553@N00,4419,26,1319258125,1319258125,1,1,0
88955553@N00,4420,26,1371522962,1371522962,1,1,0
88955553@N00,4421,66,1376353614,1376353614,1,1,0
88955553@N00,4422,26,1377998451,1378008263,9,1,9812
88955553@N00,4423,26,1379038967,1379038967,1,1,0
88955553@N00,4424,71,1379207984,1379213349,8,1,5365
88955553@N00,4425,26,1379733880,1379734502,2,1,622
88955553@N00,4426,26,1379815690,1379817662,3,1,1972
88955553@N00,4427,59,1380689457,1380689457,1,1,0
88955553@N00,4428,82,1381194069,1381194069,1,1,0
88955553@N00,4429,26,1381533781,1381533781,1,1,0
88997718@N00,4430,55,1161247289,1161247289,1,1,0
89165847@N00,4431,50,1244282665,1244282665,1,3,0
89165847@N00,4431,71,1244282675,1244282716,3,3,41
89165847@N00,4431,82,1244282727,1244282727,1,3,0
89165847@N00,4432,57,1334474391,1334474391,1,1,0
89165847@N00,4433,39,1354598774,1354598774,1,1,0
89165847@N00,4434,71,1363069854,1363072590,4,1,2736
89165847@N00,4435,82,1371220413,1371220413,1,1,0
89165847@N00,4436,6,1371275850,1371275850,1,15,0
89165847@N00,4436,9,1371278002,1371278187,3,15,185
89165847@N00,4436,32,1371278220,1371278628,6,15,408
89165847@N00,4436,35,1371277408,1371277916,5,15,508
89165847@N00,4436,39,1371276799,1371276799,1,15,0
89165847@N00,4436,42,1371279043,1371279043,1,15,0
89165847@N00,4436,44,1371253927,1371254315,5,15,388
89165847@N00,4436,45,1371254687,1371254687,1,15,0
89165847@N00,4436,57,1371262327,1371275498,4,15,13171
89165847@N00,4436,68,1371261241,1371261443,4,15,202
89165847@N00,4436,71,1371259275,1371259449,6,15,174
89165847@N00,4436,78,1371276181,1371276725,8,15,544
89165847@N00,4436,79,1371263652,1371263652,1,15,0
89165847@N00,4436,81,1371253512,1371254015,7,15,503
89165847@N00,4436,82,1371253430,1371255075,2,15,1645
89165847@N00,4437,5,1372053005,1372054511,5,2,1506
89165847@N00,4437,46,1372070667,1372070667,1,2,0
89165847@N00,4438,5,1372138225,1372140822,4,2,2597
89165847@N00,4438,46,1372118170,1372135967,3,2,17797
89165847@N00,4439,46,1372202475,1372202475,1,1,0
89165847@N00,4440,32,1375226155,1375249034,4,4,22879
89165847@N00,4440,38,1375238175,1375238181,2,4,6
89165847@N00,4440,80,1375253128,1375253251,3,4,123
89165847@N00,4440,85,1375250419,1375250419,1,4,0
89165847@N00,4441,32,1375307732,1375310853,6,1,3121
89165847@N00,4442,6,1384230283,1384240522,3,2,10239
89165847@N00,4442,10,1384230856,1384230856,1,2,0
89165847@N00,4443,56,1384302722,1384302976,2,2,254
89165847@N00,4443,57,1384302496,1384302496,1,2,0
89495020@N00,4444,50,1180597524,1180597547,2,1,23
89504146@N00,4445,26,1108092401,1108092401,1,1,0
8956529@N05,4446,7,1190184314,1190184314,1,1,0
89743353@N00,4447,71,1339958406,1339958406,1,2,0
89743353@N00,4447,85,1339942825,1339942825,1,2,0
89743353@N00,4448,71,1340008264,1340008264,1,1,0
89743353@N00,4449,14,1347216109,1347216109,1,3,0
89743353@N00,4449,27,1347216423,1347216997,2,3,574
89743353@N00,4449,85,1347215921,1347215921,1,3,0
89743353@N00,4450,23,1347719319,1347719650,3,4,331
89743353@N00,4450,32,1347718093,1347718093,1,4,0
89743353@N00,4450,84,1347722850,1347723836,2,4,986
89743353@N00,4450,85,1347716641,1347716641,1,4,0
89864780@N00,4451,26,1141446520,1141455983,13,1,9463
89864780@N00,4452,26,1148003847,1148004396,4,1,549
89864780@N00,4453,26,1149221702,1149221785,2,1,83
89864780@N00,4454,0,1152677134,1152677134,1,3,0
89864780@N00,4454,31,1152677463,1152682391,4,3,4928
89864780@N00,4454,71,1152684933,1152685742,2,3,809
89864780@N00,4455,26,1171408169,1171408169,1,1,0
89864780@N00,4456,11,1190002774,1190002774,1,1,0
89864780@N00,4457,29,1196134253,1196134253,1,2,0
89864780@N00,4457,75,1196134241,1196134241,1,2,0
90014740@N00,4458,56,1294868746,1294868746,1,1,0
90038077@N00,4459,1,1172186190,1172186190,1,1,0
90627738@N00,4460,32,1201258292,1201258292,1,2,0
90627738@N00,4460,45,1201256136,1201256315,2,2,179
90627738@N00,4461,9,1204280810,1204280924,2,2,114
90627738@N00,4461,25,1204276908,1204276908,1,2,0
90627738@N00,4462,41,1206536402,1206536402,1,1,0
90627738@N00,4463,53,1210662563,1210662563,1,1,0
90627738@N00,4464,53,1211954253,1211954253,1,1,0
9066072@N08,4465,78,1384648171,1384652045,2,1,3874
90716728@N00,4466,35,1166162900,1166162900,1,1,0
90716728@N00,4467,14,1166220765,1166220765,1,1,0
90716728@N00,4468,35,1283661504,1283661504,1,3,0
90716728@N00,4468,46,1283652946,1283652946,1,3,0
90716728@N00,4468,70,1283661443,1283661443,1,3,0
90716728@N00,4469,27,1283749834,1283771199,7,1,21365
90716728@N00,4470,50,1283836849,1283863140,3,1,26291
90928781@N00,4471,22,1343275805,1343277417,2,1,1612
91151414@N00,4472,9,1362629893,1362630473,15,6,580
91151414@N00,4472,21,1362626921,1362628408,10,6,1487
91151414@N00,4472,36,1362611625,1362614876,12,6,3251
91151414@N00,4472,45,1362632472,1362644707,11,6,12235
91151414@N00,4472,71,1362608743,1362608773,2,6,30
91151414@N00,4472,82,1362624283,1362624283,1,6,0
91256982@N00,4473,42,1176801462,1176801462,1,1,0
91256982@N00,4474,48,1182765904,1182765904,1,1,0
91256982@N00,4475,32,1189511765,1189511765,1,1,0
91256982@N00,4476,35,1190630961,1190630961,1,1,0
91256982@N00,4477,45,1197512700,1197512700,1,1,0
91256982@N00,4478,73,1200192343,1200192343,1,1,0
91256982@N00,4479,4,1203993900,1203993900,1,1,0
91256982@N00,4480,9,1204622914,1204622914,1,1,0
91256982@N00,4481,9,1207099047,1207099047,1,1,0
91256982@N00,4482,42,1208344480,1208344480,1,1,0
91256982@N00,4483,9,1209546240,1209546240,1,1,0
91256982@N00,4484,45,1215604420,1215604420,1,1,0
91256982@N00,4485,68,1218014107,1218014107,1,1,0
91256982@N00,4486,85,1219440343,1219440343,1,1,0
91256982@N00,4487,32,1220526916,1220526916,1,1,0
91256982@N00,4488,53,1222948033,1222948033,1,1,0
91256982@N00,4489,1,1223034350,1223034350,1,1,0
91256982@N00,4490,1,1223103882,1223103882,1,1,0
91256982@N00,4491,68,1223282484,1223282484,1,1,0
91256982@N00,4492,68,1223370796,1223370796,1,1,0
91256982@N00,4493,68,1224141378,1224141378,1,1,0
91256982@N00,4494,80,1226396373,1226396373,1,1,0
91256982@N00,4495,84,1226828256,1226828256,1,1,0
91256982@N00,4496,29,1228374172,1228374172,1,1,0
91256982@N00,4497,1,1256108792,1256108792,1,1,0
91256982@N00,4498,73,1268728523,1268728523,1,1,0
91256982@N00,4499,16,1284168044,1284168044,1,1,0
91256982@N00,4500,9,1284628070,1284628070,1,1,0
91256982@N00,4501,16,1284803106,1284803106,1,1,0
91256982@N00,4502,38,1289987538,1289987538,1,1,0
91256982@N00,4503,0,1290591297,1290591297,1,1,0
91256982@N00,4504,1,1296115311,1296115311,1,1,0
91256982@N00,4505,9,1296197137,1296197137,1,1,0
91256982@N00,4506,53,1296291119,1296291119,1,1,0
91256982@N00,4507,19,1296728624,1296728624,1,1,0
91256982@N00,4508,38,1296806202,1296806202,1,1,0
91256982@N00,4509,84,1296893873,1296893873,1,1,0
91256982@N00,4510,19,1297154940,1297154940,1,1,0
91256982@N00,4511,32,1297237337,1297237337,1,1,0
91256982@N00,4512,32,1298289444,1298289444,1,2,0
91256982@N00,4512,38,1298290351,1298290351,1,2,0
91256982@N00,4513,32,1299822715,1299822715,1,1,0
91256982@N00,4514,19,1300100118,1300100389,2,1,271
91256982@N00,4515,32,1300963282,1300963282,1,1,0
91256982@N00,4516,73,1301037001,1301037001,1,1,0
91256982@N00,4517,32,1302331948,1302331948,1,1,0
91256982@N00,4518,19,1302433020,1302433020,1,1,0
91256982@N00,4519,71,1303005185,1303005185,1,1,0
91256982@N00,4520,71,1303117280,1303117280,1,1,0
91256982@N00,4521,22,1304590415,1304590415,1,1,0
91256982@N00,4522,71,1305107360,1305107360,1,1,0
91256982@N00,4523,38,1305348863,1305348863,1,1,0
91256982@N00,4524,35,1305632323,1305632323,1,1,0
91256982@N00,4525,41,1306645144,1306645144,1,1,0
91256982@N00,4526,73,1308289193,1308289193,1,1,0
91256982@N00,4527,22,1308654838,1308654838,1,1,0
91256982@N00,4528,73,1308827498,1308827498,1,1,0
91256982@N00,4529,35,1309262743,1309262743,1,1,0
91256982@N00,4530,22,1309432844,1309432844,1,1,0
91256982@N00,4531,38,1310195784,1310195784,1,1,0
91256982@N00,4532,84,1311584143,1311584143,1,1,0
91256982@N00,4533,45,1311860141,1311860141,1,1,0
91256982@N00,4534,9,1312106328,1312106328,1,2,0
91256982@N00,4534,19,1312107415,1312107415,1,2,0
91256982@N00,4535,44,1312351362,1312351362,1,1,0
91256982@N00,4536,84,1313660440,1313660440,1,1,0
91256982@N00,4537,38,1314698887,1314698887,1,1,0
91256982@N00,4538,45,1314792639,1314792639,1,1,0
91256982@N00,4539,4,1314881333,1314881333,1,1,0
91256982@N00,4540,19,1316075848,1316075848,1,1,0
91256982@N00,4541,19,1316645770,1316645770,1,1,0
91256982@N00,4542,48,1316686388,1316686388,1,1,0
91256982@N00,4543,73,1317119363,1317119363,1,1,0
91256982@N00,4544,37,1317296845,1317296845,1,1,0
91256982@N00,4545,85,1317512443,1317512443,1,1,0
91256982@N00,4546,73,1318236726,1318236726,1,1,0
91256982@N00,4547,9,1318409705,1318409705,1,1,0
91256982@N00,4548,19,1318592467,1318592467,1,1,0
91256982@N00,4549,22,1318844622,1318844622,1,1,0
91256982@N00,4550,21,1319621514,1319621514,1,1,0
91256982@N00,4551,73,1319704598,1319704598,1,1,0
91256982@N00,4552,0,1319879190,1319879190,1,1,0
91256982@N00,4553,69,1320225474,1320225474,1,1,0
91256982@N00,4554,80,1320653251,1320653251,1,1,0
91256982@N00,4555,80,1320838530,1320838530,1,1,0
91256982@N00,4556,68,1321956228,1321956228,1,1,0
91256982@N00,4557,1,1322040071,1322040071,1,1,0
91256982@N00,4558,42,1322730858,1322730858,1,1,0
91256982@N00,4559,19,1323338743,1323338743,1,1,0
91256982@N00,4560,19,1323683204,1323683204,1,1,0
91256982@N00,4561,19,1323942719,1323942719,1,1,0
91256982@N00,4562,38,1324431118,1324431118,1,1,0
91256982@N00,4563,37,1324548926,1324548926,1,1,0
91256982@N00,4564,37,1324645096,1324645096,1,1,0
91256982@N00,4565,42,1324868669,1324868669,1,1,0
91256982@N00,4566,73,1325128066,1325128066,1,1,0
91256982@N00,4567,32,1325286290,1325286290,1,1,0
91256982@N00,4568,1,1325328011,1325328011,1,1,0
91256982@N00,4569,48,1326506584,1326506584,1,1,0
91256982@N00,4570,32,1327399727,1327399727,1,1,0
91256982@N00,4571,48,1328091675,1328091675,1,1,0
91256982@N00,4572,9,1331509603,1331509603,1,1,0
91256982@N00,4573,38,1331634314,1331634314,1,1,0
91256982@N00,4574,32,1332155063,1332155063,1,1,0
91256982@N00,4575,35,1332567483,1332567483,1,1,0
91256982@N00,4576,42,1332752589,1332752589,1,1,0
91256982@N00,4577,50,1333020550,1333020550,1,1,0
91256982@N00,4578,38,1333947205,1333947205,1,1,0
91256982@N00,4579,19,1334227759,1334227759,1,1,0
91256982@N00,4580,19,1334568368,1334568989,2,1,621
91256982@N00,4581,4,1334655222,1334655222,1,1,0
91256982@N00,4582,73,1334736317,1334736317,1,1,0
91256982@N00,4583,13,1334921823,1334921823,1,1,0
91256982@N00,4584,21,1334964238,1334964238,1,1,0
91256982@N00,4585,32,1335431249,1335431249,1,1,0
91256982@N00,4586,19,1335860987,1335860987,1,1,0
91256982@N00,4587,19,1336099380,1336099380,1,1,0
91256982@N00,4588,68,1336550410,1336550410,1,1,0
91256982@N00,4589,48,1336812087,1336812087,1,1,0
91256982@N00,4590,32,1337063416,1337063416,1,1,0
91256982@N00,4591,38,1337229557,1337229557,1,1,0
91256982@N00,4592,2,1337415688,1337415688,1,1,0
91256982@N00,4593,19,1337673097,1337673097,1,2,0
91256982@N00,4593,84,1337671999,1337671999,1,2,0
91256982@N00,4594,9,1338090304,1338090304,1,2,0
91256982@N00,4594,32,1338089653,1338089653,1,2,0
91256982@N00,4595,68,1338292537,1338292537,1,1,0
91256982@N00,4596,22,1338535571,1338535571,1,1,0
91256982@N00,4597,16,1338809681,1338809681,1,1,0
91256982@N00,4598,31,1340424115,1340424115,1,1,0
91256982@N00,4599,48,1341021817,1341021817,1,1,0
91256982@N00,4600,16,1341407331,1341407331,1,1,0
91256982@N00,4601,51,1341830856,1341830856,1,1,0
91256982@N00,4602,0,1342170489,1342170489,1,2,0
91256982@N00,4602,31,1342170323,1342170323,1,2,0
91256982@N00,4603,21,1342596400,1342596400,1,1,0
91256982@N00,4604,19,1342688869,1342688869,1,2,0
91256982@N00,4604,36,1342682065,1342682065,1,2,0
91256982@N00,4605,4,1343462630,1343462630,1,1,0
91256982@N00,4606,68,1343710152,1343710152,1,2,0
91256982@N00,4606,71,1343710478,1343710478,1,2,0
91256982@N00,4607,57,1343796593,1343796593,1,1,0
91256982@N00,4608,16,1344290227,1344290227,1,1,0
91256982@N00,4609,16,1344808980,1344808980,1,1,0
91256982@N00,4610,22,1345220361,1345220361,1,1,0
91256982@N00,4611,19,1346402726,1346402726,1,1,0
91256982@N00,4612,19,1346838388,1346838388,1,1,0
91256982@N00,4613,9,1347449385,1347449385,1,1,0
91256982@N00,4614,9,1348055455,1348055455,1,1,0
91256982@N00,4615,19,1352352157,1352352157,1,1,0
91256982@N00,4616,84,1352805867,1352805867,1,1,0
91256982@N00,4617,19,1352973910,1352973910,1,1,0
91256982@N00,4618,84,1353922828,1353922828,1,1,0
91256982@N00,4619,38,1354824538,1354824538,1,1,0
91256982@N00,4620,38,1356664374,1356664374,1,2,0
91256982@N00,4620,52,1356684898,1356684898,1,2,0
91256982@N00,4621,1,1356740513,1356740513,1,3,0
91256982@N00,4621,53,1356741040,1356741378,2,3,338
91256982@N00,4621,85,1356742045,1356742045,1,3,0
91256982@N00,4622,16,1360055431,1360055431,1,1,0
91256982@N00,4623,35,1361428431,1361428431,1,1,0
91256982@N00,4624,28,1362176655,1362180941,2,1,4286
91256982@N00,4625,21,1362264505,1362264505,1,1,0
91256982@N00,4626,41,1362651831,1362651831,1,1,0
91256982@N00,4627,22,1363724061,1363724061,1,1,0
91256982@N00,4628,38,1364817536,1364817536,1,1,0
91256982@N00,4629,38,1364902886,1364902886,1,1,0
91256982@N00,4630,84,1365833241,1365833241,1,1,0
91256982@N00,4631,84,1366517067,1366517067,1,1,0
91256982@N00,4632,42,1366795901,1366795901,1,1,0
91256982@N00,4633,84,1367840059,1367840059,1,1,0
91256982@N00,4634,16,1367918066,1367918066,1,1,0
91256982@N00,4635,21,1368312554,1368312554,1,1,0
91256982@N00,4636,16,1368532727,1368532727,1,1,0
91256982@N00,4637,15,1369219320,1369219320,1,1,0
91256982@N00,4638,27,1369652258,1369652258,1,1,0
91256982@N00,4639,86,1371558688,1371558688,1,1,0
91256982@N00,4640,22,1374052322,1374052322,1,1,0
91256982@N00,4641,19,1376109092,1376109092,1,1,0
91256982@N00,4642,4,1380534936,1380535106,3,2,170
91256982@N00,4642,84,1380534628,1380534628,1,2,0
91256982@N00,4643,51,1381745040,1381745040,1,1,0
91256982@N00,4644,51,1383817539,1383817539,1,1,0
91256982@N00,4645,9,1395227694,1395227694,1,1,0
91342102@N00,4646,26,1251986555,1251986555,1,1,0
91348311@N05,4647,50,1341448467,1341448467,1,1,0
91471608@N00,4648,20,1172299751,1172299820,4,1,69
91748271@N00,4649,22,1298696001,1298696001,1,1,0
91748271@N00,4650,16,1320457712,1320457751,3,3,39
91748271@N00,4650,36,1320448764,1320448764,1,3,0
91748271@N00,4650,84,1320455952,1320455952,1,3,0
91748271@N00,4651,68,1326592366,1326608799,6,1,16433
91748271@N00,4652,9,1331941866,1331941866,1,1,0
91748271@N00,4653,22,1335063390,1335063390,1,1,0
91748271@N00,4654,84,1335514274,1335514274,1,1,0
91748271@N00,4655,9,1336091018,1336091053,2,1,35
91748271@N00,4656,17,1336272457,1336272457,1,1,0
91748271@N00,4657,11,1338551493,1338551493,1,1,0
91748271@N00,4658,3,1340374975,1340374975,1,1,0
91748271@N00,4659,11,1340771469,1340771469,1,1,0
91748271@N00,4660,45,1345877803,1345877803,1,1,0
91748271@N00,4661,85,1347001453,1347001453,1,1,0
91748271@N00,4662,32,1349939163,1349939163,1,1,0
91748271@N00,4663,50,1350693507,1350693507,1,2,0
91748271@N00,4663,71,1350702600,1350703342,2,2,742
91748271@N00,4664,39,1351495176,1351495176,1,1,0
91748271@N00,4665,11,1353219761,1353219761,1,1,0
91748271@N00,4666,14,1376642652,1376642652,1,1,0
91748271@N00,4667,37,1376750430,1376750430,1,1,0
91748271@N00,4668,37,1377856761,1377856761,1,1,0
91748271@N00,4669,18,1380008694,1380008694,1,1,0
91748271@N00,4670,67,1389495660,1389499740,3,1,4080
91783980@N05,4671,6,1374502200,1374502211,12,1,11
91783980@N05,4672,6,1374569825,1374588044,22,2,18219
91783980@N05,4672,79,1374586965,1374587005,4,2,40
91783980@N05,4673,0,1374640201,1374641591,5,1,1390
91821745@N00,4674,26,1048647082,1048647082,1,1,0
91821745@N00,4675,71,1070024400,1070024400,1,1,0
91821745@N00,4676,57,1073618442,1073618442,1,1,0
91821745@N00,4677,71,1118553618,1118553618,1,1,0
91821745@N00,4678,46,1123391057,1123391057,1,1,0
91821745@N00,4679,26,1142916279,1142916371,4,1,92
91821745@N00,4680,71,1145931537,1145931537,1,2,0
91821745@N00,4680,82,1145931961,1145938013,2,2,6052
91821745@N00,4681,57,1167179239,1167197198,7,1,17959
91821745@N00,4682,50,1167378711,1167385912,5,3,7201
91821745@N00,4682,71,1167378280,1167378658,4,3,378
91821745@N00,4682,82,1167386337,1167386337,1,3,0
91821745@N00,4683,57,1167461684,1167461684,1,1,0
91821745@N00,4684,71,1168648310,1168648310,1,1,0
91821745@N00,4685,81,1176467168,1176467320,4,1,152
91821745@N00,4686,57,1184471637,1184479250,11,2,7613
91821745@N00,4686,71,1184469660,1184469660,1,2,0
91821745@N00,4687,25,1190879077,1190894503,5,2,15426
91821745@N00,4687,45,1190900205,1190900205,1,2,0
91872843@N00,4688,20,1386836715,1386836715,1,1,0
91872843@N00,4689,50,1387000064,1387000112,2,3,48
91872843@N00,4689,81,1387000240,1387000272,3,3,32
91872843@N00,4689,82,1387000289,1387000289,1,3,0
92134758@N00,4690,50,1201591019,1201602247,4,1,11228
92134758@N00,4691,21,1201675015,1201678977,6,1,3962
92134758@N00,4692,7,1201898362,1201931592,105,1,33230
9225942@N03,4693,26,1326968805,1326968805,1,1,0
92434067@N00,4694,19,1315075871,1315083406,3,2,7535
92434067@N00,4694,84,1315081082,1315081082,2,2,0
92434067@N00,4695,36,1334889153,1334889153,2,1,0
92434067@N00,4696,39,1334948793,1334948793,2,2,0
92434067@N00,4696,41,1334966414,1334966414,2,2,0
92434067@N00,4697,71,1335008745,1335008745,2,1,0
92496717@N00,4698,0,1106223057,1106223057,1,3,0
92496717@N00,4698,53,1106214832,1106216740,2,3,1908
92496717@N00,4698,82,1106219804,1106219804,1,3,0
92496717@N00,4699,27,1175297301,1175297301,1,2,0
92496717@N00,4699,53,1175296049,1175296049,1,2,0
92496717@N00,4700,25,1175346269,1175346269,1,1,0
92496717@N00,4701,2,1261924078,1261924078,1,2,0
92496717@N00,4701,40,1261923575,1261923575,1,2,0
92496717@N00,4702,52,1262012462,1262012462,1,4,0
92496717@N00,4702,57,1262003107,1262015648,4,4,12541
92496717@N00,4702,81,1262018148,1262018148,1,4,0
92496717@N00,4702,82,1262018438,1262018438,1,4,0
92496717@N00,4703,21,1377425363,1377425363,1,1,0
92496717@N00,4704,8,1377555466,1377555466,1,2,0
92496717@N00,4704,85,1377569719,1377569719,1,2,0
92496717@N00,4705,15,1378009096,1378009096,1,2,0
92496717@N00,4705,50,1378005178,1378005178,1,2,0
92496717@N00,4706,31,1394322458,1394322458,1,1,0
92496717@N00,4707,67,1394363663,1394363663,1,1,0
92545550@N00,4708,9,1367470105,1367470105,1,1,0
92828317@N00,4709,4,1303082478,1303082485,2,1,7
92828317@N00,4710,13,1304040426,1304040426,1,4,0
92828317@N00,4710,16,1304052499,1304052499,1,4,0
92828317@N00,4710,21,1304051925,1304051967,2,4,42
92828317@N00,4710,35,1304040538,1304040579,3,4,41
92828317@N00,4711,71,1305863048,1305863057,2,1,9
92828317@N00,4712,9,1309127809,1309127809,1,2,0
92828317@N00,4712,21,1309127973,1309127973,1,2,0
92828317@N00,4713,41,1309575771,1309575771,1,1,0
92828317@N00,4714,14,1310706028,1310708655,12,1,2627
92828317@N00,4715,61,1312619039,1312623263,7,1,4224
92828317@N00,4716,19,1316256575,1316258355,3,1,1780
92828317@N00,4717,84,1323204656,1323204656,1,1,0
92828317@N00,4718,24,1331532437,1331532461,3,1,24
92828317@N00,4719,37,1345775308,1345775329,2,1,21
92828317@N00,4720,0,1371872466,1371872466,1,1,0
92886069@N00,4721,7,1071542103,1071542103,1,1,0
92996181@N00,4722,27,1335709546,1335709546,1,2,0
92996181@N00,4722,46,1335704825,1335733274,22,2,28449
93003266@N04,4723,39,1360214386,1360214386,1,1,0
93003266@N04,4724,22,1361398386,1361398728,12,1,342
93003266@N04,4725,9,1361878651,1361878651,1,2,0
93003266@N04,4725,32,1361878813,1361878813,1,2,0
93003266@N04,4726,2,1361948950,1361958436,8,8,9486
93003266@N04,4726,5,1361949614,1361955356,4,8,5742
93003266@N04,4726,8,1361952090,1361954880,2,8,2790
93003266@N04,4726,9,1361951918,1361951918,1,8,0
93003266@N04,4726,32,1361948564,1361948564,1,8,0
93003266@N04,4726,35,1361952248,1361952248,1,8,0
93003266@N04,4726,39,1361955084,1361957650,2,8,2566
93003266@N04,4726,70,1361955438,1361958488,5,8,3050
93003266@N04,4727,40,1363236915,1363236915,1,1,0
93003266@N04,4728,18,1364379714,1364379714,1,2,0
93003266@N04,4728,40,1364382488,1364382488,1,2,0
93003266@N04,4729,35,1365313618,1365313618,1,2,0
93003266@N04,4729,39,1365313140,1365313368,2,2,228
93003266@N04,4730,24,1365382060,1365382060,1,1,0
93012314@N00,4731,20,1329518130,1329518159,3,1,29
93012314@N00,4732,68,1329610421,1329612525,8,1,2104
93012314@N00,4733,32,1390011389,1390011389,1,1,0
93012314@N00,4734,13,1390614706,1390614706,1,2,0
93012314@N00,4734,27,1390610283,1390610283,1,2,0
93012314@N00,4735,46,1391156755,1391156792,2,1,37
93012314@N00,4736,67,1391308740,1391309733,7,2,993
93012314@N00,4736,75,1391309946,1391309971,8,2,25
93012314@N00,4737,47,1391504068,1391504068,1,2,0
93012314@N00,4737,73,1391503786,1391503786,1,2,0
93012314@N00,4738,36,1392373500,1392373500,1,2,0
93012314@N00,4738,68,1392374913,1392374920,2,2,7
93012314@N00,4739,22,1392440112,1392440112,1,2,0
93012314@N00,4739,68,1392428928,1392429027,4,2,99
93012314@N00,4740,45,1393059007,1393059007,1,2,0
93012314@N00,4740,67,1393066783,1393066783,1,2,0
93012314@N00,4741,2,1398145756,1398145756,1,2,0
93012314@N00,4741,40,1398145847,1398145847,1,2,0
93012314@N00,4742,9,1398565258,1398565258,1,4,0
93012314@N00,4742,49,1398562208,1398562208,1,4,0
93012314@N00,4742,76,1398560882,1398560882,1,4,0
93012314@N00,4742,81,1398563099,1398563099,1,4,0
93042826@N00,4743,48,1321026974,1321026974,1,1,0
93323136@N00,4744,0,1343580987,1343580987,1,2,0
93323136@N00,4744,32,1343572611,1343582533,4,2,9922
93323136@N00,4745,27,1344533188,1344533188,1,1,0
93384183@N00,4746,1,1184012616,1184012616,1,2,0
93384183@N00,4746,71,1184005214,1184005242,2,2,28
93384183@N00,4747,44,1184078962,1184079533,3,2,571
93384183@N00,4747,71,1184079051,1184079390,2,2,339
93384183@N00,4748,11,1380908362,1380908362,1,2,0
93384183@N00,4748,49,1380911918,1380911918,1,2,0
93384183@N00,4749,0,1380988765,1380988765,1,5,0
93384183@N00,4749,8,1380986396,1380986396,1,5,0
93384183@N00,4749,13,1380986516,1380986667,2,5,151
93384183@N00,4749,19,1380982722,1380982722,1,5,0
93384183@N00,4749,32,1380986187,1380986187,1,5,0
93444913@N00,4750,22,1226530325,1226530325,1,1,0
93444913@N00,4751,22,1226895350,1226895350,1,1,0
93444913@N00,4752,21,1229575660,1229575660,1,1,0
93444913@N00,4753,48,1249794392,1249795050,2,1,658
93444913@N00,4754,27,1261110161,1261110161,1,1,0
93444913@N00,4755,68,1262247793,1262247793,1,1,0
93444913@N00,4756,22,1268617254,1268617254,1,1,0
93444913@N00,4757,22,1273214368,1273214609,2,1,241
93444913@N00,4758,25,1274488636,1274488636,1,1,0
93444913@N00,4759,22,1277254700,1277254700,1,1,0
93444913@N00,4760,22,1281310511,1281310511,1,1,0
93444913@N00,4761,22,1282105616,1282105616,1,1,0
93444913@N00,4762,22,1282288080,1282288080,1,1,0
93444913@N00,4763,22,1282785177,1282785177,1,1,0
93444913@N00,4764,22,1283126159,1283126159,1,1,0
93444913@N00,4765,22,1287019877,1287019877,1,1,0
93444913@N00,4766,22,1287100322,1287100322,1,1,0
93444913@N00,4767,25,1298934903,1298934903,1,1,0
93445752@N00,4768,25,1183707496,1183707496,1,1,0
93621759@N06,4769,35,1363611651,1363611682,2,2,31
93621759@N06,4769,50,1363611657,1363611692,2,2,35
93650545@N06,4770,35,1322896099,1322896099,1,1,0
93650545@N06,4771,71,1362791978,1362791978,1,1,0
93650545@N06,4772,9,1367376098,1367376098,1,1,0
93650545@N06,4773,22,1370768095,1370768095,1,2,0
93650545@N06,4773,82,1370771759,1370771759,1,2,0
93650545@N06,4774,71,1371901825,1371901825,1,1,0
93650545@N06,4775,71,1371945722,1371945722,1,1,0
93650545@N06,4776,21,1373440503,1373440503,1,1,0
93907767@N00,4777,35,1141801679,1141804685,6,1,3006
93907767@N00,4778,84,1145683357,1145683370,2,1,13
93907767@N00,4779,71,1151502248,1151502303,4,1,55
93907767@N00,4780,84,1162964933,1162964949,2,1,16
93907767@N00,4781,14,1168416875,1168418019,2,1,1144
93907767@N00,4782,15,1175755914,1175755914,1,1,0
93913731@N00,4783,25,1180818353,1180819051,4,3,698
93913731@N00,4783,44,1180819142,1180819142,1,3,0
93913731@N00,4783,67,1180804802,1180820491,2,3,15689
93913731@N00,4784,48,1376195094,1376204060,34,1,8966
93917488@N04,4785,81,1362908093,1362908093,1,1,0
93987037@N00,4786,15,1220737009,1220753157,3,11,16148
93987037@N00,4786,21,1220744165,1220749750,4,11,5585
93987037@N00,4786,25,1220739915,1220740358,8,11,443
93987037@N00,4786,40,1220742880,1220742880,1,11,0
93987037@N00,4786,44,1220739358,1220739365,2,11,7
93987037@N00,4786,45,1220739508,1220739823,7,11,315
93987037@N00,4786,50,1220738033,1220738528,3,11,495
93987037@N00,4786,61,1220736493,1220736493,1,11,0
93987037@N00,4786,71,1220738753,1220738797,3,11,44
93987037@N00,4786,81,1220738889,1220739165,6,11,276
93987037@N00,4786,82,1220737923,1220738133,3,11,210
9416709@N08,4787,8,1389166382,1389166382,1,1,0
9416709@N08,4788,27,1389311739,1389311910,2,2,171
9416709@N08,4788,46,1389313341,1389313341,1,2,0
94327650@N03,4789,2,1365029678,1365029678,1,1,0
94327650@N03,4790,16,1367644693,1367644693,1,3,0
94327650@N03,4790,41,1367648643,1367648643,1,3,0
94327650@N03,4790,84,1367645728,1367645728,1,3,0
94327650@N03,4791,22,1367826639,1367826639,1,1,0
94327650@N03,4792,32,1368517796,1368517796,1,1,0
94327650@N03,4793,85,1370666817,1370666817,1,1,0
94327650@N03,4794,85,1371787315,1371801005,2,1,13690
94327650@N03,4795,86,1372671520,1372671520,1,1,0
94327650@N03,4796,3,1374530728,1374530728,1,1,0
94327650@N03,4797,46,1376783254,1376793789,2,1,10535
94327650@N03,4798,24,1379670115,1379670115,1,1,0
94327650@N03,4799,26,1379749092,1379749092,1,1,0
94327650@N03,4800,48,1380950558,1380950558,1,1,0
94327650@N03,4801,48,1381008032,1381008032,1,1,0
94327650@N03,4802,48,1382010615,1382010615,1,1,0
94327650@N03,4803,31,1382244706,1382244706,1,1,0
94327650@N03,4804,85,1383373884,1383373884,1,1,0
94327650@N03,4805,31,1385273505,1385273505,1,1,0
94327650@N03,4806,48,1385420716,1385420716,1,1,0
94327650@N03,4807,70,1387433211,1387433211,1,1,0
94327650@N03,4808,85,1388725432,1388725432,1,1,0
94327650@N03,4809,24,1389271266,1389271266,1,1,0
94327650@N03,4810,50,1394178464,1394178464,1,1,0
94327650@N03,4811,25,1394934158,1394934158,1,1,0
94327650@N03,4812,31,1395654181,1395654181,1,1,0
94327650@N03,4813,10,1396334259,1396334259,1,1,0
94327650@N03,4814,25,1396649471,1396649471,1,1,0
94327650@N03,4815,4,1397120312,1397120312,1,1,0
94327650@N03,4816,41,1397730814,1397730814,1,1,0
9433773@N08,4817,9,1258689550,1258689833,9,6,283
9433773@N08,4817,11,1258679037,1258685743,20,6,6706
9433773@N08,4817,23,1258689940,1258689940,1,6,0
9433773@N08,4817,35,1258689479,1258689535,2,6,56
9433773@N08,4817,44,1258689911,1258689911,1,6,0
9433773@N08,4817,50,1258689889,1258689889,1,6,0
9433773@N08,4818,13,1258788063,1258788256,9,1,193
94366076@N00,4819,81,1372415897,1372415897,1,1,0
94366076@N00,4820,45,1372576878,1372576878,1,1,0
94366076@N00,4821,42,1373101645,1373101645,1,1,0
9438227@N06,4822,22,1317451654,1317451654,1,1,0
9438227@N06,4823,18,1324186134,1324186134,1,1,0
9438227@N06,4824,9,1324366447,1324366447,1,1,0
9438227@N06,4825,9,1325905960,1325905960,1,1,0
9438227@N06,4826,22,1326784635,1326784635,1,1,0
9438227@N06,4827,46,1328675744,1328675744,1,1,0
9438227@N06,4828,17,1331471347,1331471347,1,5,0
9438227@N06,4828,35,1331458294,1331458294,1,5,0
9438227@N06,4828,41,1331474167,1331474167,1,5,0
9438227@N06,4828,50,1331463131,1331469948,5,5,6817
9438227@N06,4828,71,1331462096,1331469240,2,5,7144
9438227@N06,4829,71,1333002967,1333002967,1,1,0
9438227@N06,4830,27,1333424700,1333427300,8,1,2600
9438227@N06,4831,48,1333518798,1333518944,2,2,146
9438227@N06,4831,69,1333518740,1333518740,1,2,0
9438227@N06,4832,14,1335015647,1335015647,1,4,0
9438227@N06,4832,19,1335014876,1335014876,1,4,0
9438227@N06,4832,27,1335016002,1335016002,1,4,0
9438227@N06,4832,48,1334986321,1335007541,5,4,21220
9438227@N06,4833,27,1337941581,1337941581,1,1,0
9438227@N06,4834,25,1338024454,1338024454,1,1,0
9438227@N06,4835,53,1352865956,1352865956,1,1,0
9438227@N06,4836,53,1352931622,1352931622,1,1,0
9438227@N06,4837,71,1361602390,1361602390,1,1,0
94482242@N00,4838,50,1201586369,1201594469,24,1,8100
94482242@N00,4839,24,1252727711,1252728206,26,1,495
94482242@N00,4840,4,1281148142,1281148142,1,1,0
94482242@N00,4841,84,1291930990,1291930990,1,1,0
94482242@N00,4842,8,1293855563,1293855751,4,4,188
94482242@N00,4842,18,1293855990,1293855990,1,4,0
94482242@N00,4842,24,1293862704,1293862704,1,4,0
94482242@N00,4842,36,1293861977,1293861977,1,4,0
94482242@N00,4843,7,1296555131,1296555131,1,1,0
94482242@N00,4844,24,1326883848,1326883848,1,1,0
94482242@N00,4845,56,1336460869,1336460869,1,1,0
94482242@N00,4846,24,1349391130,1349391130,1,1,0
94482242@N00,4847,7,1368141621,1368141621,1,1,0
94482242@N00,4848,71,1393147233,1393148440,2,1,1207
94482242@N00,4849,2,1394936666,1394936666,1,3,0
94482242@N00,4849,22,1394934096,1394934096,1,3,0
94482242@N00,4849,84,1394931234,1394931234,1,3,0
94482242@N00,4850,7,1396339203,1396339203,1,1,0
94520611@N05,4851,37,1392194319,1392194319,1,1,0
94520611@N05,4852,35,1392370167,1392370167,1,6,0
94520611@N05,4852,50,1392364711,1392364747,2,6,36
94520611@N05,4852,63,1392367204,1392367329,3,6,125
94520611@N05,4852,67,1392366191,1392366191,1,6,0
94520611@N05,4852,81,1392365544,1392365662,2,6,118
94520611@N05,4852,82,1392364760,1392364760,1,6,0
94728561@N06,4853,59,1363285329,1363285329,1,1,0
94728561@N06,4854,58,1363464159,1363464368,2,1,209
94728561@N06,4855,58,1366987310,1366987310,1,1,0
94968748@N00,4856,10,1374476428,1374476428,1,1,0
94968748@N00,4857,10,1374817864,1374818014,2,1,150
94968748@N00,4858,10,1374888208,1374888208,1,1,0
94968748@N00,4859,10,1384653443,1384653443,1,1,0
95023164@N00,4860,32,1320725198,1320725198,1,1,0
95122302@N02,4861,63,1371298161,1371298161,1,1,0
95122302@N02,4862,47,1373087720,1373087720,1,1,0
95436929@N00,4863,84,1164767861,1164767861,1,1,0
95436929@N00,4864,18,1165053316,1165053316,1,2,0
95436929@N00,4864,32,1165029243,1165061452,4,2,32209
95436929@N00,4865,14,1165096740,1165096740,1,1,0
95464641@N00,4866,25,1279176110,1279176110,1,2,0
95464641@N00,4866,42,1279153588,1279153588,1,2,0
95464641@N00,4867,17,1378022649,1378022715,2,1,66
95464641@N00,4868,9,1378085850,1378085850,1,3,0
95464641@N00,4868,14,1378080153,1378080153,1,3,0
95464641@N00,4868,15,1378082632,1378082632,1,3,0
95464641@N00,4869,11,1396530847,1396531323,4,1,476
9574497@N07,4870,22,1283917349,1283917349,1,1,0
9574497@N07,4871,31,1285144661,1285144661,1,2,0
9574497@N07,4871,71,1285144145,1285144145,1,2,0
9574497@N07,4872,13,1299134242,1299134242,1,1,0
95902070@N02,4873,84,1367984219,1367984219,1,1,0
95902070@N02,4874,85,1368152804,1368152804,1,1,0
95902070@N02,4875,31,1368934985,1368934985,1,1,0
95902070@N02,4876,84,1370061951,1370061951,1,1,0
95902070@N02,4877,2,1370245567,1370245567,1,2,0
95902070@N02,4877,84,1370258384,1370258384,1,2,0
95902070@N02,4878,17,1386979266,1386979266,1,1,0
95902070@N02,4879,9,1389217210,1389217210,1,1,0
95902070@N02,4880,50,1393073834,1393073834,1,1,0
95902070@N02,4881,36,1393385019,1393385019,1,1,0
95902070@N02,4882,31,1394156763,1394156763,1,1,0
95902070@N02,4883,67,1394428371,1394428371,1,1,0
96155869@N00,4884,50,1174814479,1174814479,1,1,0
96155869@N00,4885,14,1182150261,1182150261,1,5,0
96155869@N00,4885,15,1182149728,1182149728,1,5,0
96155869@N00,4885,17,1182149788,1182149788,1,5,0
96155869@N00,4885,38,1182152570,1182152570,1,5,0
96155869@N00,4885,85,1182151837,1182151837,1,5,0
96256161@N00,4886,71,1350024850,1350024850,1,1,0
96256161@N00,4887,3,1350112476,1350112476,1,4,0
96256161@N00,4887,4,1350113659,1350113659,1,4,0
96256161@N00,4887,48,1350095366,1350098949,8,4,3583
96256161@N00,4887,69,1350091977,1350092772,3,4,795
96261984@N00,4888,71,1302434349,1302434349,1,2,0
96261984@N00,4888,82,1302433672,1302433672,1,2,0
96308839@N00,4889,25,1365070425,1365070425,1,2,0
96308839@N00,4889,46,1365066761,1365066761,1,2,0
9662258@N02,4890,2,1358654359,1358654359,1,9,0
9662258@N02,4890,5,1358653349,1358653349,1,9,0
9662258@N02,4890,15,1358655212,1358655212,1,9,0
9662258@N02,4890,25,1358653534,1358653713,5,9,179
9662258@N02,4890,45,1358653810,1358653889,3,9,79
9662258@N02,4890,50,1358655183,1358655183,1,9,0
9662258@N02,4890,57,1358654839,1358654839,1,9,0
9662258@N02,4890,63,1358654061,1358654061,1,9,0
9662258@N02,4890,71,1358655108,1358655108,1,9,0
96772430@N00,4891,32,1378341782,1378341782,1,1,0
96772430@N00,4892,71,1378384875,1378384875,1,1,0
96841228@N00,4893,50,1301121710,1301121710,1,1,0
96841228@N00,4894,60,1301197812,1301197812,1,1,0
96951910@N00,4895,35,1322183874,1322183874,1,1,0
97026536@N00,4896,2,1296381119,1296381119,1,1,0
97026536@N00,4897,22,1333229218,1333229218,1,1,0
97026536@N00,4898,31,1343411705,1343411705,1,1,0
97026536@N00,4899,51,1378092607,1378092607,1,1,0
97064055@N00,4900,28,1248333626,1248334798,7,1,1172
97064055@N00,4901,48,1252828262,1252828262,1,2,0
97064055@N00,4901,69,1252827995,1252827995,1,2,0
97064055@N00,4902,31,1253007178,1253046563,9,3,39385
97064055@N00,4902,44,1253006558,1253052533,4,3,45975
97064055@N00,4902,81,1253041991,1253042384,4,3,393
97064055@N00,4903,81,1253502635,1253502676,2,1,41
97166741@N00,4904,26,1363232750,1363232750,1,1,0
97304820@N00,4905,39,1278136480,1278136698,2,1,218
97304820@N00,4906,32,1291193064,1291193282,3,4,218
97304820@N00,4906,50,1291194285,1291196141,8,4,1856
97304820@N00,4906,70,1291195644,1291195644,1,4,0
97304820@N00,4906,71,1291195029,1291195383,4,4,354
97304820@N00,4907,4,1291275201,1291275201,1,13,0
97304820@N00,4907,9,1291273579,1291274305,11,13,726
97304820@N00,4907,16,1291269891,1291269945,2,13,54
97304820@N00,4907,19,1291269977,1291269977,1,13,0
97304820@N00,4907,22,1291274554,1291274598,3,13,44
97304820@N00,4907,23,1291273546,1291273714,5,13,168
97304820@N00,4907,35,1291273147,1291273485,4,13,338
97304820@N00,4907,41,1291274672,1291274672,1,13,0
97304820@N00,4907,50,1291272509,1291272833,4,13,324
97304820@N00,4907,70,1291273198,1291273271,3,13,73
97304820@N00,4907,71,1291272109,1291272965,26,13,856
97304820@N00,4907,84,1291274656,1291274656,1,13,0
97304820@N00,4907,85,1291270963,1291270963,1,13,0
97304820@N00,4908,32,1291306575,1291306575,1,1,0
97304820@N00,4909,38,1291354390,1291354390,1,2,0
97304820@N00,4909,42,1291353971,1291353971,1,2,0
97308508@N00,4910,48,1169830969,1169831686,3,1,717
97708873@N00,4911,6,1211976331,1211976331,1,2,0
97708873@N00,4911,68,1211974493,1211974500,2,2,7
97708873@N00,4912,25,1212338462,1212338462,1,1,0
97867688@N00,4913,29,1067311908,1067311908,1,1,0
97867688@N00,4914,24,1070681460,1070681460,1,1,0
97867688@N00,4915,18,1099568540,1099568540,1,9,0
97867688@N00,4915,21,1099558448,1099558448,1,9,0
97867688@N00,4915,25,1099559164,1099559179,3,9,15
97867688@N00,4915,32,1099558709,1099568846,2,9,10137
97867688@N00,4915,41,1099558838,1099558838,1,9,0
97867688@N00,4915,62,1099590925,1099590925,1,9,0
97867688@N00,4915,71,1099589674,1099589674,1,9,0
97867688@N00,4915,80,1099567563,1099567563,1,9,0
97867688@N00,4915,85,1099559275,1099559297,2,9,22
97867688@N00,4916,22,1101347783,1101347783,1,1,0
97867688@N00,4917,29,1102044628,1102044687,4,2,59
97867688@N00,4917,42,1102044713,1102044713,1,2,0
97867688@N00,4918,22,1104139909,1104139909,1,1,0
97867688@N00,4919,45,1105255672,1105255672,1,1,0
97867688@N00,4920,85,1108021301,1108021301,1,1,0
97867688@N00,4921,36,1109054555,1109054555,1,1,0
97867688@N00,4922,13,1113374810,1113374810,1,4,0
97867688@N00,4922,17,1113374650,1113374650,1,4,0
97867688@N00,4922,50,1113373101,1113373101,1,4,0
97867688@N00,4922,71,1113377405,1113377405,1,4,0
97867688@N00,4923,71,1114687421,1114687421,1,1,0
97867688@N00,4924,68,1115703580,1115703580,1,1,0
97867688@N00,4925,32,1116027535,1116027535,1,1,0
97867688@N00,4926,32,1116656247,1116656247,1,1,0
97867688@N00,4927,27,1118630736,1118631133,4,2,397
97867688@N00,4927,85,1118632338,1118632338,1,2,0
97867688@N00,4928,85,1120706938,1120706938,1,1,0
97867688@N00,4929,15,1120803194,1120803194,1,3,0
97867688@N00,4929,80,1120808489,1120808489,1,3,0
97867688@N00,4929,85,1120789484,1120789484,1,3,0
97867688@N00,4930,35,1123314775,1123314775,1,2,0
97867688@N00,4930,71,1123299759,1123299759,1,2,0
97867688@N00,4931,12,1124351573,1124351573,1,1,0
97867688@N00,4932,85,1124434274,1124434274,1,1,0
97867688@N00,4933,82,1124969370,1124969370,1,1,0
97867688@N00,4934,41,1125022123,1125022123,1,2,0
97867688@N00,4934,44,1125035902,1125035902,1,2,0
97867688@N00,4935,29,1127978427,1127978637,3,3,210
97867688@N00,4935,31,1127976178,1127976178,1,3,0
97867688@N00,4935,38,1127989998,1127989998,1,3,0
97867688@N00,4936,10,1129330332,1129330332,1,1,0
97867688@N00,4937,27,1131683074,1131683074,1,1,0
97867688@N00,4938,11,1131745614,1131745614,1,2,0
97867688@N00,4938,17,1131745621,1131745621,1,2,0
97867688@N00,4939,71,1133849411,1133849587,2,1,176
97867688@N00,4940,10,1145503859,1145503862,2,1,3
97867688@N00,4941,14,1149326477,1149326477,1,1,0
97867688@N00,4942,35,1154071848,1154071848,1,1,0
97867688@N00,4943,71,1154244493,1154244493,1,1,0
97867688@N00,4944,29,1155985680,1155985680,1,1,0
97867688@N00,4945,0,1157314327,1157314327,1,1,0
97867688@N00,4946,22,1158371754,1158374661,2,2,2907
97867688@N00,4946,84,1158374955,1158374955,1,2,0
97867688@N00,4947,19,1163377480,1163377480,1,1,0
97867688@N00,4948,10,1165301374,1165302102,3,1,728
97867688@N00,4949,82,1165743753,1165743793,3,1,40
97867688@N00,4950,32,1166770065,1166770065,1,1,0
97867688@N00,4951,15,1168491813,1168491813,1,2,0
97867688@N00,4951,38,1168499402,1168499402,1,2,0
97867688@N00,4952,86,1178869522,1178869522,1,1,0
97867688@N00,4953,26,1183167517,1183167964,2,1,447
97867688@N00,4954,19,1217636959,1217636959,1,1,0
97867688@N00,4955,44,1221033479,1221033499,2,1,20
97867688@N00,4956,82,1222256277,1222256277,1,1,0
97867688@N00,4957,85,1222316200,1222316200,1,1,0
97867688@N00,4958,47,1225514722,1225514722,1,1,0
97867688@N00,4959,71,1227039011,1227039011,1,1,0
97867688@N00,4960,82,1227257837,1227257837,1,1,0
97867688@N00,4961,32,1227394923,1227394923,1,2,0
97867688@N00,4961,71,1227416056,1227416056,1,2,0
97867688@N00,4962,31,1228086093,1228086093,1,1,0
97867688@N00,4963,84,1229908039,1229908039,1,1,0
97867688@N00,4964,19,1230967689,1230967689,1,2,0
97867688@N00,4964,46,1230968861,1230968861,1,2,0
97867688@N00,4965,71,1231838809,1231838992,2,1,183
97867688@N00,4966,19,1231987039,1231987039,1,1,0
97867688@N00,4967,80,1233388158,1233388158,1,1,0
97867688@N00,4968,9,1237079431,1237079431,1,1,0
97867688@N00,4969,10,1237277177,1237277177,1,1,0
97867688@N00,4970,36,1237539967,1237539967,1,1,0
97867688@N00,4971,47,1240179730,1240179730,1,1,0
97867688@N00,4972,32,1241240573,1241240573,1,1,0
97867688@N00,4973,8,1259457541,1259457541,1,2,0
97867688@N00,4973,17,1259459834,1259459834,1,2,0
97867688@N00,4974,16,1259910340,1259910340,1,2,0
97867688@N00,4974,32,1259911334,1259911334,1,2,0
97867688@N00,4975,50,1261126742,1261126742,1,1,0
97867688@N00,4976,8,1262252229,1262252229,1,1,0
97867688@N00,4977,9,1268554990,1268555058,6,1,68
97867688@N00,4978,16,1268727582,1268727582,1,1,0
97867688@N00,4979,47,1273381584,1273381591,2,1,7
97972855@N00,4980,41,1390017756,1390017756,1,6,0
97972855@N00,4980,50,1390001669,1390002185,4,6,516
97972855@N00,4980,71,1390006810,1390006987,2,6,177
97972855@N00,4980,81,1390008435,1390008435,1,6,0
97972855@N00,4980,82,1390003419,1390003711,3,6,292
97972855@N00,4980,84,1390011571,1390011571,1,6,0
97972855@N00,4981,22,1390116125,1390116125,1,1,0
97972855@N00,4982,45,1390200175,1390204650,2,3,4475
97972855@N00,4982,71,1390198016,1390198016,1,3,0
97972855@N00,4982,81,1390198612,1390199138,3,3,526
97972855@N00,4983,15,1390361395,1390361804,3,6,409
97972855@N00,4983,35,1390366476,1390366476,1,6,0
97972855@N00,4983,40,1390335117,1390335117,1,6,0
97972855@N00,4983,48,1390338613,1390346000,3,6,7387
97972855@N00,4983,51,1390335593,1390337496,4,6,1903
97972855@N00,4983,85,1390353585,1390353585,1,6,0
98089177@N00,4984,63,1170580657,1170585409,20,1,4752
98089177@N00,4985,27,1197367256,1197367256,1,1,0
98089177@N00,4986,2,1333709100,1333709100,1,1,0
98089177@N00,4987,45,1336179666,1336180205,2,1,539
98089177@N00,4988,85,1340147077,1340147077,1,1,0
98089177@N00,4989,28,1350709641,1350709641,1,1,0
98089177@N00,4990,65,1358372456,1358374147,12,1,1691
98105605@N00,4991,16,1235039165,1235039165,1,1,0
98105605@N00,4992,11,1235794202,1235794202,1,1,0
98105605@N00,4993,53,1236928098,1236928098,1,1,0
98105605@N00,4994,11,1237088231,1237088231,1,1,0
98105605@N00,4995,2,1237454009,1237454009,1,2,0
98105605@N00,4995,11,1237450454,1237450454,1,2,0
98105605@N00,4996,2,1237509455,1237509455,1,2,0
98105605@N00,4996,32,1237514219,1237514219,1,2,0
98105605@N00,4997,84,1238136956,1238136956,1,1,0
98105605@N00,4998,32,1238626907,1238626907,1,1,0
98105605@N00,4999,17,1241227058,1241227058,1,1,0
98105605@N00,5000,83,1242814271,1242814271,1,1,0
98105605@N00,5001,57,1284715298,1284715298,1,2,0
98105605@N00,5001,79,1284715676,1284715676,1,2,0
98105605@N00,5002,3,1285968804,1285968804,1,1,0
98105605@N00,5003,31,1287546824,1287546824,1,1,0
98105605@N00,5004,9,1287716196,1287716196,1,1,0
98105605@N00,5005,11,1289251373,1289251373,1,1,0
98105605@N00,5006,41,1291960524,1291963563,2,2,3039
98105605@N00,5006,50,1291964665,1291964665,1,2,0
98105605@N00,5007,8,1292129265,1292129312,3,1,47
98105605@N00,5008,71,1292548708,1292548708,1,1,0
98105605@N00,5009,84,1294832034,1294832034,1,1,0
98105605@N00,5010,26,1295085103,1295085103,1,1,0
98105605@N00,5011,11,1296514195,1296514195,1,1,0
98105605@N00,5012,48,1296557632,1296557632,1,1,0
98105605@N00,5013,35,1297423646,1297423722,2,1,76
98105605@N00,5014,70,1302867447,1302867447,1,1,0
98105605@N00,5015,48,1303099403,1303099403,1,1,0
98105605@N00,5016,48,1303800947,1303801356,2,1,409
98105605@N00,5017,48,1303831069,1303831069,1,1,0
98105605@N00,5018,40,1303972429,1303972429,1,1,0
98105605@N00,5019,19,1305514715,1305514715,1,2,0
98105605@N00,5019,36,1305541461,1305541461,1,2,0
98105605@N00,5020,48,1306050052,1306050052,1,1,0
98105605@N00,5021,32,1306884916,1306884916,1,1,0
98105605@N00,5022,48,1321288375,1321288375,1,1,0
98105605@N00,5023,48,1324160247,1324160247,1,1,0
98105605@N00,5024,35,1324202251,1324202251,1,1,0
98105605@N00,5025,9,1324625415,1324625415,1,1,0
98105605@N00,5026,40,1328863791,1328863791,1,1,0
98105605@N00,5027,40,1336288907,1336288907,1,1,0
98105605@N00,5028,3,1337079234,1337079234,1,1,0
98105605@N00,5029,28,1337497183,1337497183,1,1,0
98105605@N00,5030,46,1342272725,1342272725,1,1,0
98105605@N00,5031,28,1342501323,1342511416,3,1,10093
98105605@N00,5032,48,1347339059,1347339059,1,1,0
98105605@N00,5033,28,1353126765,1353135936,2,1,9171
98467688@N08,5034,31,1386403020,1386403020,1,1,0
98768323@N00,5035,35,1186751648,1186751648,1,2,0
98768323@N00,5035,50,1186751521,1186751765,4,2,244
98768323@N00,5036,53,1186833657,1186840628,11,1,6971
98768323@N00,5037,1,1186938596,1186938660,3,1,64
98768323@N00,5038,1,1187074991,1187074991,1,1,0
98983159@N00,5039,35,1212475547,1212475547,1,1,0
98983159@N00,5040,16,1258691192,1258691192,1,1,0
98983159@N00,5041,50,1302135565,1302135565,1,1,0
98983159@N00,5042,35,1307679432,1307679432,1,1,0
98983159@N00,5043,40,1321599039,1321599039,1,1,0
98983159@N00,5044,22,1343963326,1343963326,1,1,0
98983159@N00,5045,11,1369408990,1369408990,1,1,0
98983159@N00,5046,26,1392553335,1392553335,1,1,0
98999190@N00,5047,10,1260406404,1260407823,3,6,1419
98999190@N00,5047,13,1260399619,1260399666,3,6,47
98999190@N00,5047,15,1260400153,1260400153,1,6,0
98999190@N00,5047,70,1260399699,1260399699,1,6,0
98999190@N00,5047,81,1260423920,1260423923,2,6,3
98999190@N00,5047,82,1260424277,1260424277,1,6,0
99109486@N00,5048,26,1329610302,1329610302,1,1,0
99109486@N00,5049,25,1329812934,1329813015,2,3,81
99109486@N00,5049,27,1329803494,1329803494,1,3,0
99109486@N00,5049,46,1329806556,1329806636,2,3,80
99109486@N00,5050,11,1330141109,1330142185,23,1,1076
99174151@N00,5051,9,1323337676,1323337676,1,1,0
99174151@N00,5052,85,1340783223,1340783223,1,1,0
99174151@N00,5053,85,1340818975,1340818975,1,1,0
99174151@N00,5054,85,1340896148,1340896148,1,1,0
99174151@N00,5055,42,1341434025,1341434025,1,1,0
99174151@N00,5056,32,1350572370,1350572370,1,1,0
99188729@N00,5057,9,1223711151,1223711151,1,1,0
99188729@N00,5058,8,1233298584,1233298584,1,2,0
99188729@N00,5058,50,1233301200,1233301200,1,2,0
99188729@N00,5059,2,1233535289,1233535289,1,2,0
99188729@N00,5059,78,1233519513,1233519513,1,2,0
99188729@N00,5060,45,1303696117,1303696117,1,1,0
99395734@N08,5061,9,1322176506,1322176506,1,1,0
99395734@N08,5062,50,1322264751,1322264751,1,3,0
99395734@N08,5062,82,1322260744,1322260744,1,3,0
99395734@N08,5062,84,1322253563,1322253563,1,3,0
99761031@N00,5063,71,1354139570,1354139570,1,1,0
99804259@N00,5064,0,1291092598,1291092598,1,4,0
99804259@N00,5064,39,1291077197,1291082840,3,4,5643
99804259@N00,5064,45,1291079957,1291092559,10,4,12602
99804259@N00,5064,49,1291119207,1291119207,1,4,0
99804259@N00,5065,31,1291155247,1291155247,1,5,0
99804259@N00,5065,49,1291178440,1291178481,2,5,41
99804259@N00,5065,50,1291155913,1291178529,3,5,22616
99804259@N00,5065,70,1291158225,1291158225,1,5,0
99804259@N00,5065,71,1291159198,1291178575,2,5,19377
99804259@N00,5066,24,1325928200,1325928470,2,3,270
99804259@N00,5066,48,1325926657,1325927565,10,3,908
99804259@N00,5066,72,1325916503,1325916858,4,3,355
99804259@N00,5067,4,1326016791,1326016791,1,4,0
99804259@N00,5067,16,1326016615,1326016615,1,4,0
99804259@N00,5067,19,1326016480,1326016480,1,4,0
99804259@N00,5067,24,1326016816,1326016816,1,4,0
99804259@N00,5068,21,1326153685,1326155744,2,2,2059
99804259@N00,5068,27,1326154552,1326154552,1,2,0
99804259@N00,5069,65,1326267871,1326267871,1,1,0
99804259@N00,5070,32,1326359323,1326359323,1,3,0
99804259@N00,5070,65,1326322795,1326323631,2,3,836
99804259@N00,5070,84,1326352220,1326352220,1,3,0
99804259@N00,5071,25,1326409218,1326409218,1,1,0
99804259@N00,5072,68,1326591260,1326597928,3,1,6668
99804259@N00,5073,85,1336861394,1336861394,1,1,0
99804259@N00,5074,3,1337413136,1337413136,1,1,0
99804259@N00,5075,12,1337670066,1337670066,1,1,0
99804259@N00,5076,84,1337772727,1337772894,4,1,167
99804259@N00,5077,3,1337904144,1337904144,1,1,0
99804259@N00,5078,45,1338091238,1338091238,1,2,0
99804259@N00,5078,82,1338078448,1338092415,3,2,13967
99804259@N00,5079,16,1338528795,1338528795,1,2,0
99804259@N00,5079,35,1338520506,1338520506,1,2,0
99804259@N00,5080,82,1338780040,1338780348,3,1,308
99804259@N00,5081,51,1339039889,1339039889,1,1,0
99804259@N00,5082,11,1339295446,1339295446,1,1,0
99804259@N00,5083,40,1339543916,1339549097,2,2,5181
99804259@N00,5083,71,1339557392,1339557756,2,2,364
99804259@N00,5084,82,1339639263,1339639263,1,1,0
99804259@N00,5085,82,1341737613,1341737613,1,1,0
99804259@N00,5086,82,1342173493,1342173493,1,1,0
99804259@N00,5087,82,1342430532,1342430532,1,1,0
99804259@N00,5088,82,1343556457,1343556457,1,1,0
99804259@N00,5089,82,1343612784,1343612784,1,1,0
99804259@N00,5090,82,1350204527,1350204551,3,1,24
99804259@N00,5091,28,1351645434,1351656395,16,1,10961
99804259@N00,5092,21,1351812498,1351813865,8,1,1367
99804259@N00,5093,13,1367398449,1367399277,2,1,828
99804259@N00,5094,30,1379903258,1379903258,1,1,0
99804259@N00,5095,51,1380086700,1380086700,1,1,0
99804259@N00,5096,15,1387795351,1387795351,1,3,0
99804259@N00,5096,47,1387787387,1387792790,10,3,5403
99804259@N00,5096,85,1387796572,1387796572,1,3,0
99804259@N00,5097,84,1388219514,1388219514,1,1,0
99804259@N00,5098,32,1388286029,1388286029,1,2,0
99804259@N00,5098,47,1388276104,1388282720,9,2,6616
99804259@N00,5099,74,1388458776,1388458776,1,1,0
99804259@N00,5100,50,1393497080,1393497080,1,1,0
99804259@N00,5101,32,1394594030,1394594030,1,3,0
99804259@N00,5101,47,1394611104,1394613189,6,3,2085
99804259@N00,5101,53,1394605801,1394606039,4,3,238
99804259@N00,5102,71,1394781394,1394781394,1,2,0
99804259@N00,5102,81,1394791706,1394791706,1,2,0
99804259@N00,5103,17,1394871613,1394871613,1,1,0
99804259@N00,5104,3,1395302789,1395302789,2,1,0
99804259@N00,5105,21,1396489522,1396489522,1,1,0
