userID,trajID,poiID,startTime,endTime,#photo,trajLen,poiDuration
1,2,5,1333868132,1333871166,0,4,3034
1,2,8,1333876893,1333879555,0,4,2662
1,2,5,1333887480,1333887893,0,4,413
1,2,11,1333887893,1333887953,0,4,60
1,4,5,1337376343,1337389354,0,1,13011
1,5,5,1337406908,1337407884,0,3,976
1,5,5,1337424215,1337424667,0,3,452
1,5,11,1337424667,1337424727,0,3,60
1,6,21,1337460350,1337461618,0,1,1268
1,7,11,1341640118,1341640574,0,6,456
1,7,5,1341640574,1341641765,0,6,1191
1,7,8,1341643189,1341646462,0,6,3273
1,7,8,1341647791,1341648380,0,6,589
1,7,5,1341654168,1341654634,0,6,466
1,7,11,1341654634,1341654694,0,6,60
1,8,28,1341704718,1341718846,0,2,14128
1,8,8,1341720040,1341721461,0,2,1421
1,9,5,1341736968,1341737028,0,1,60
1,11,5,1344542423,1344542483,0,1,60
1,12,21,1344582610,1344582670,0,1,60
1,13,28,1344595662,1344596366,0,3,704
1,13,21,1344596366,1344597454,0,3,1088
1,13,35,1344608673,1344608733,0,3,60
1,14,5,1351331861,1351335786,0,5,3925
1,14,8,1351336748,1351337983,0,5,1235
1,14,8,1351338621,1351344321,0,5,5700
1,14,5,1351344321,1351344956,0,5,635
1,14,11,1351344956,1351345016,0,5,60
1,15,11,1353661287,1353661347,0,1,60
1,16,11,1353757254,1353757998,0,2,744
1,16,21,1353764975,1353765035,0,2,60
1,17,11,1354925822,1354926073,0,3,251
1,17,5,1354926073,1354926408,0,3,335
1,17,5,1354947019,1354947079,0,3,60
1,21,28,1355480652,1355481227,0,1,575
1,29,5,1358036659,1358036870,0,1,211
2,31,11,1359204282,1359204342,0,1,60
2,33,59,1333535844,1333535904,0,1,60
2,39,59,1334315016,1334315076,0,1,60
2,40,59,1334482778,1334482838,0,1,60
2,41,59,1334581591,1334581651,0,1,60
2,42,59,1334665512,1334665572,0,1,60
2,45,59,1334841493,1334841553,0,1,60
2,50,59,1335186751,1335186811,0,1,60
2,54,71,1335359515,1335359575,0,1,60
2,59,59,1335616185,1335616245,0,1,60
2,62,59,1336482074,1336482134,0,1,60
2,64,59,1336564384,1336564444,0,1,60
2,67,77,1336750804,1336750864,0,1,60
2,69,59,1336998727,1336998787,0,1,60
2,72,59,1337174542,1337174602,0,1,60
2,77,59,1337691425,1337691485,0,1,60
2,84,59,1338296714,1338296774,0,1,60
2,90,59,1338894650,1338894710,0,1,60
2,93,21,1339059321,1339059381,0,1,60
2,99,59,1340102126,1340102186,0,1,60
2,103,59,1341234795,1341234855,0,1,60
2,106,59,1341405535,1341405595,0,1,60
2,108,59,1341485993,1341486053,0,1,60
2,116,59,1342616381,1342616441,0,1,60
2,121,59,1343644398,1343644458,0,1,60
2,123,59,1344508116,1344508176,0,1,60
2,131,59,1347534228,1347534288,0,1,60
2,144,59,1353494409,1353495793,0,1,1384
2,151,59,1354444600,1354444660,0,1,60
2,156,59,1355048762,1355048822,0,1,60
2,161,59,1355830260,1355830320,0,1,60
2,172,59,1357902174,1357902234,0,1,60
3,179,104,1333493936,1333493996,0,1,60
3,260,212,1357274433,1357274493,0,1,60
4,348,5,1342341819,1342344624,0,1,2805
4,349,5,1342408782,1342413003,0,1,4221
4,352,5,1343434929,1343440207,0,1,5278
5,441,5,1338005530,1338006696,0,2,1166
5,441,5,1338022829,1338023370,0,2,541
5,445,5,1338688292,1338689489,0,1,1197
5,446,5,1338711524,1338712154,0,1,630
5,450,5,1339217321,1339217843,0,2,522
5,450,5,1339229238,1339231361,0,2,2123
5,451,5,1339292229,1339311092,0,2,18863
5,451,5,1339311092,1339311152,0,2,60
5,454,5,1339563666,1339570689,0,2,7023
5,454,5,1339580855,1339581957,0,2,1102
5,457,5,1339910835,1339914416,0,3,3581
5,457,5,1339920379,1339921789,0,3,1410
5,457,253,1339921789,1339922103,0,3,314
5,458,253,1339939225,1339940679,0,1,1454
5,459,35,1340015530,1340015816,0,1,286
5,462,260,1341994244,1341994637,0,4,393
5,462,261,1341994637,1341995448,0,4,811
5,462,261,1341996784,1341997074,0,4,290
5,462,263,1341997074,1341997254,0,4,180
5,463,5,1342084993,1342086165,0,2,1172
5,463,35,1342086165,1342086225,0,2,60
5,464,5,1342251476,1342252997,0,1,1521
5,466,71,1342341023,1342342388,0,1,1365
5,467,5,1342413830,1342414335,0,1,505
5,470,5,1344504647,1344509643,0,1,4996
5,471,5,1344676512,1344676910,0,1,398
5,473,5,1344767056,1344767116,0,1,60
5,475,5,1344919388,1344919607,0,1,219
5,476,5,1345346281,1345351145,0,1,4864
5,478,5,1347686199,1347690565,0,3,4366
5,478,5,1347691537,1347692463,0,3,926
5,478,5,1347698952,1347699538,0,3,586
5,480,5,1350108154,1350108713,0,1,559
5,484,284,1351376661,1351377734,0,1,1073
5,486,5,1351490585,1351498982,0,1,8397
5,489,8,1352373000,1352373060,0,1,60
5,491,5,1353039124,1353039588,0,1,464
5,493,5,1353209726,1353209786,0,1,60
5,494,5,1353814403,1353822104,0,1,7701
5,495,253,1353837620,1353837680,0,1,60
5,496,5,1354431044,1354436586,0,1,5542
5,497,5,1355116431,1355116491,0,1,60
5,498,5,1355549518,1355549578,0,1,60
5,499,284,1355560909,1355560969,0,1,60
5,500,5,1355818345,1355818405,0,1,60
5,504,5,1357032347,1357032407,0,1,60
5,507,5,1357535092,1357535410,0,1,318
5,508,5,1358227432,1358228961,0,1,1529
5,509,5,1358489803,1358490201,0,1,398
5,512,260,1359101287,1359101586,0,1,299
5,514,297,1359690478,1359691993,0,1,1515
5,515,5,1360146853,1360148168,0,1,1315
5,516,5,1360308347,1360314633,0,1,6286
5,518,284,1360544249,1360544253,0,1,4
5,519,5,1360817147,1360817207,0,1,60
6,556,284,1337375694,1337375754,0,1,60
6,564,260,1338549453,1338551922,0,1,2469
6,576,336,1339507052,1339507112,0,1,60
6,611,351,1345380457,1345380517,0,1,60
6,626,35,1353127357,1353127417,0,1,60
6,628,260,1353468755,1353468815,0,1,60
7,665,5,1334314700,1334318426,0,1,3726
7,669,253,1334581829,1334581889,0,1,60
7,678,284,1336098944,1336102212,0,2,3268
7,678,11,1336102212,1336102272,0,2,60
7,679,284,1336205994,1336206054,0,1,60
7,683,284,1336796016,1336802361,0,1,6345
7,684,284,1336882860,1336886464,0,1,3604
7,688,284,1337351447,1337351507,0,1,60
7,701,284,1339891729,1339892966,0,1,1237
7,702,5,1339915228,1339935378,0,1,20150
7,715,284,1342340224,1342340284,0,1,60
7,716,284,1342428778,1342430859,0,1,2081
7,718,35,1343438500,1343440317,0,1,1817
7,729,35,1351325922,1351325982,0,1,60
7,736,284,1353146740,1353154919,0,1,8179
7,740,284,1353583931,1353588852,0,1,4921
8,763,77,1333503390,1333503450,0,1,60
8,764,21,1333537045,1333538751,0,2,1706
8,764,77,1333538751,1333538811,0,2,60
8,765,77,1333850015,1333850310,0,1,295
8,766,284,1333871775,1333874023,0,1,2248
8,767,21,1333970210,1333971435,0,2,1225
8,767,77,1333971435,1333974401,0,2,2966
8,768,77,1334108476,1334109976,0,2,1500
8,768,21,1334109976,1334110036,0,2,60
8,769,21,1334141247,1334142483,0,2,1236
8,769,77,1334142483,1334142543,0,2,60
8,770,21,1334197064,1334197124,0,1,60
8,771,21,1334229681,1334231344,0,2,1663
8,771,77,1334231344,1334231404,0,2,60
8,772,77,1334281616,1334282247,0,3,631
8,772,428,1334282247,1334283256,0,3,1009
8,772,21,1334283256,1334283316,0,3,60
8,773,21,1334315912,1334317160,0,2,1248
8,773,77,1334317160,1334317179,0,2,19
8,774,77,1334367462,1334370144,0,2,2682
8,774,21,1334370144,1334370204,0,2,60
8,776,21,1334487121,1334488665,0,2,1544
8,776,77,1334488665,1334489892,0,2,1227
8,778,21,1334659303,1334660831,0,2,1528
8,778,77,1334660831,1334660891,0,2,60
8,779,77,1334799350,1334800754,0,2,1404
8,779,21,1334800754,1334800814,0,2,60
8,780,21,1334838837,1334840308,0,2,1471
8,780,77,1334840308,1334840368,0,2,60
8,781,21,1334888340,1334888400,0,1,60
8,782,77,1334923200,1334923260,0,1,60
8,783,77,1334972505,1334973364,0,2,859
8,783,428,1334973364,1334973424,0,2,60
8,784,77,1335009472,1335009532,0,1,60
8,785,21,1335147371,1335147431,0,1,60
8,786,21,1335179513,1335179573,0,1,60
8,787,77,1335404216,1335404276,0,1,60
8,788,21,1335523665,1335524039,0,3,374
8,788,5,1335524039,1335524761,0,3,722
8,788,77,1335529493,1335529553,0,3,60
8,789,21,1335578196,1335578256,0,1,60
8,790,77,1335605197,1335605257,0,1,60
8,791,21,1335924244,1335924304,0,1,60
8,792,21,1335958786,1335960467,0,2,1681
8,792,77,1335960467,1335960527,0,2,60
8,793,77,1336354387,1336354447,0,1,60
8,794,77,1336390695,1336390755,0,1,60
8,796,77,1336527978,1336529823,0,2,1845
8,796,21,1336529823,1336529883,0,2,60
8,797,21,1336562026,1336562765,0,2,739
8,797,77,1336562765,1336562825,0,2,60
8,798,21,1336732788,1336733889,0,2,1101
8,798,11,1336733889,1336733949,0,2,60
8,799,77,1336787041,1336788763,0,2,1722
8,799,21,1336788763,1336788823,0,2,60
8,800,21,1336819750,1336820688,0,2,938
8,800,77,1336820688,1336827984,0,2,7296
8,801,297,1336872385,1336873391,0,1,1006
8,802,21,1336906495,1336907875,0,2,1380
8,802,77,1336907875,1336907935,0,2,60
8,803,77,1336966967,1336968817,0,2,1850
8,803,21,1336968817,1336971534,0,2,2717
8,804,77,1337219180,1337219240,0,1,60
8,805,21,1337254053,1337254113,0,1,60
8,806,77,1337391784,1337393792,0,2,2008
8,806,21,1337393792,1337393852,0,2,60
8,807,21,1337426805,1337428081,0,2,1276
8,807,77,1337428081,1337428141,0,2,60
8,808,21,1337683937,1337683997,0,1,60
8,809,77,1337823975,1337825788,0,2,1813
8,809,21,1337825788,1337825848,0,2,60
8,810,21,1337944296,1337944649,0,2,353
8,810,77,1337944649,1337944709,0,2,60
8,811,77,1338126569,1338128917,0,1,2348
8,812,77,1338168659,1338170404,0,2,1745
8,812,21,1338170404,1338170464,0,2,60
8,813,77,1338203731,1338203791,0,1,60
8,814,77,1338255938,1338255998,0,1,60
8,815,77,1338342204,1338342264,0,1,60
8,816,77,1338723958,1338724018,0,1,60
8,817,77,1338770793,1338772230,0,2,1437
8,817,21,1338772230,1338772290,0,2,60
8,818,77,1338860154,1338860214,0,1,60
8,819,21,1338896313,1338896373,0,1,60
8,820,21,1338981248,1338982179,0,2,931
8,820,77,1338982179,1338982239,0,2,60
8,821,77,1339031535,1339032606,0,1,1071
8,822,21,1339065696,1339069187,0,2,3491
8,822,77,1339069550,1339071018,0,2,1468
8,823,428,1339207001,1339208108,0,2,1107
8,823,21,1339208108,1339208168,0,2,60
8,824,21,1339240151,1339241170,0,2,1019
8,824,77,1339241476,1339245078,0,2,3602
8,825,21,1339293561,1339293621,0,1,60
8,826,21,1339326302,1339326362,0,1,60
8,827,260,1339379447,1339380048,0,2,601
8,827,21,1339380048,1339380108,0,2,60
8,828,5,1339414733,1339417896,0,1,3163
8,829,21,1339467386,1339467446,0,1,60
8,830,21,1339499059,1339499119,0,1,60
8,831,77,1339549512,1339550697,0,2,1185
8,831,21,1339550697,1339550757,0,2,60
8,832,21,1339584948,1339585008,0,1,60
8,835,77,1339897316,1339897376,0,1,60
8,837,77,1339983310,1339984630,0,2,1320
8,837,21,1339984630,1339984690,0,2,60
8,839,77,1340269284,1340269481,0,4,197
8,839,21,1340270524,1340271027,0,4,503
8,839,5,1340271027,1340281089,0,4,10062
8,839,21,1340281089,1340281149,0,4,60
8,840,21,1341109164,1341109224,0,1,60
8,842,77,1341452577,1341454734,0,2,2157
8,842,21,1341454734,1341454794,0,2,60
8,843,21,1341485579,1341486712,0,1,1133
8,844,21,1341571648,1341572521,0,1,873
8,845,77,1341625002,1341626765,0,2,1763
8,845,21,1341626765,1341626825,0,2,60
8,846,21,1341658680,1341660209,0,2,1529
8,846,449,1341660209,1341660987,0,2,778
8,848,260,1341972303,1341972363,0,1,60
8,849,21,1342008150,1342009020,0,1,870
8,850,77,1342057736,1342057796,0,1,60
8,851,21,1342092247,1342093929,0,1,1682
8,854,21,1342232706,1342232766,0,1,60
8,855,21,1342263329,1342263389,0,1,60
8,856,77,1342489620,1342489901,0,1,281
8,857,21,1342523833,1342525191,0,2,1358
8,857,77,1342525191,1342525251,0,2,60
8,859,21,1343127045,1343127723,0,1,678
8,861,77,1343612228,1343614630,0,2,2402
8,861,21,1343614630,1343614690,0,2,60
8,862,21,1343645879,1343646715,0,1,836
8,863,77,1344217681,1344217946,0,1,265
8,864,21,1344249819,1344249879,0,1,60
8,865,21,1344510484,1344510544,0,1,60
8,866,21,1344572256,1344572316,0,1,60
8,867,21,1344595654,1344597196,0,2,1542
8,867,449,1344597196,1344597256,0,2,60
8,869,77,1344822205,1344822265,0,1,60
8,870,77,1344908696,1344909113,0,2,417
8,870,21,1344910634,1344910694,0,2,60
8,871,428,1344947264,1344947637,0,1,373
8,872,77,1345168556,1345168763,0,1,207
8,873,77,1345239330,1345239390,0,1,60
8,876,21,1346844721,1346844781,0,1,60
8,877,77,1346895861,1346898805,0,2,2944
8,877,21,1346898805,1346898865,0,2,60
8,879,21,1349696413,1349696473,0,1,60
8,880,428,1350007190,1350007250,0,1,60
8,881,21,1350041311,1350043275,0,1,1964
8,882,77,1350092945,1350095095,0,2,2150
8,882,21,1350095095,1350095155,0,2,60
8,883,21,1350128428,1350128488,0,1,60
8,886,21,1350613077,1350613137,0,1,60
8,887,21,1350904067,1350904127,0,1,60
8,888,77,1350960133,1350963227,0,3,3094
8,888,284,1350967325,1350975480,0,3,8155
8,888,5,1350978563,1350978623,0,3,60
8,890,21,1351131978,1351132038,0,1,60
8,891,21,1351163103,1351163693,0,2,590
8,891,5,1351163693,1351165203,0,2,1510
8,892,21,1351213388,1351213448,0,1,60
8,894,77,1351317517,1351326134,0,1,8617
8,897,21,1351649927,1351649987,0,1,60
8,899,21,1351736334,1351736394,0,1,60
8,902,21,1352114881,1352115247,0,1,366
8,903,21,1352201081,1352201141,0,1,60
8,904,77,1352252741,1352252801,0,1,60
8,905,21,1352291449,1352291509,0,1,60
8,907,77,1352684995,1352685055,0,1,60
8,908,21,1352720521,1352720581,0,1,60
8,909,21,1352772749,1352772809,0,1,60
8,910,77,1353029742,1353032355,0,2,2613
8,910,21,1353032355,1353032415,0,2,60
8,912,77,1353203587,1353204927,0,2,1340
8,912,21,1353204927,1353204987,0,2,60
8,913,21,1353238400,1353240704,0,1,2304
8,914,21,1353378161,1353378221,0,1,60
8,915,77,1353462124,1353462184,0,1,60
8,917,21,1353723511,1353723571,0,1,60
8,919,21,1353810032,1353810092,0,1,60
8,920,77,1353981108,1353981168,0,1,60
8,922,77,1354499582,1354500982,0,2,1400
8,922,21,1354500982,1354501042,0,2,60
8,923,21,1354532874,1354532934,0,1,60
8,924,21,1354587544,1354587604,0,1,60
8,925,21,1354620192,1354620252,0,1,60
8,926,11,1354664739,1354664799,0,1,60
8,927,21,1354760377,1354760437,0,1,60
8,929,77,1354931329,1354933239,0,2,1910
8,929,21,1354933239,1354933299,0,2,60
8,930,21,1354965045,1354965105,0,1,60
8,931,77,1355017983,1355019660,0,2,1677
8,931,21,1355019660,1355019720,0,2,60
8,933,77,1355103720,1355103780,0,1,60
8,934,77,1355190522,1355190582,0,1,60
8,935,77,1355362636,1355365491,0,2,2855
8,935,21,1355365491,1355365551,0,2,60
8,936,21,1355398031,1355401136,0,1,3105
8,937,77,1355622537,1355622597,0,1,60
8,940,21,1355741680,1355745744,0,1,4064
8,942,77,1355968221,1355969891,0,2,1670
8,942,21,1355969891,1355969951,0,2,60
8,943,21,1356089767,1356090450,0,2,683
8,943,480,1356090450,1356090510,0,2,60
8,944,5,1356138045,1356138105,0,1,60
8,945,21,1356174478,1356174538,0,1,60
8,946,21,1356606542,1356606602,0,1,60
8,947,21,1356693782,1356693842,0,1,60
8,948,21,1356747366,1356747426,0,1,60
8,949,21,1356779234,1356780506,0,1,1272
8,950,21,1356865601,1356866534,0,2,933
8,950,449,1356866534,1356866551,0,2,17
8,953,21,1357210475,1357210535,0,1,60
8,954,77,1357261897,1357261957,0,1,60
8,955,5,1357296799,1357296859,0,1,60
8,956,77,1357350559,1357350619,0,1,60
8,957,21,1357384276,1357384336,0,1,60
8,958,21,1357438643,1357438703,0,1,60
8,959,77,1357471844,1357471904,0,1,60
8,960,21,1357525112,1357525172,0,1,60
8,963,21,1357814722,1357817560,0,1,2838
8,964,21,1357901214,1357901274,0,1,60
8,966,77,1358128131,1358128191,0,1,60
8,968,21,1358765765,1358765825,0,1,60
8,969,21,1359080517,1359080577,0,1,60
8,970,77,1359165495,1359165555,0,1,60
8,973,5,1359372394,1359372454,0,1,60
8,974,21,1359409812,1359409872,0,1,60
8,975,449,1359585838,1359587718,0,1,1880
8,976,77,1359683524,1359683584,0,1,60
8,977,77,1360288423,1360288483,0,1,60
8,979,77,1360719928,1360721764,0,2,1836
8,979,21,1360721764,1360721824,0,2,60
8,980,21,1360753087,1360756709,0,1,3622
9,981,77,1360979172,1360979232,0,1,60
9,983,428,1333530641,1333530837,0,2,196
9,983,260,1333541510,1333542149,0,2,639
9,987,5,1333853535,1333858351,0,3,4816
9,987,5,1333870357,1333870961,0,3,604
9,987,21,1333870961,1333871021,0,3,60
9,1000,297,1334464215,1334464290,0,2,75
9,1000,71,1334464290,1334466192,0,2,1902
9,1007,449,1334828668,1334829065,0,1,397
9,1011,260,1335071515,1335072022,0,1,507
9,1025,5,1336107367,1336107763,0,1,396
9,1026,5,1336128860,1336129163,0,1,303
9,1027,5,1336191983,1336192603,0,1,620
9,1028,5,1336210121,1336211887,0,1,1766
9,1033,428,1336557868,1336558845,0,1,977
9,1038,260,1336866846,1336866906,0,1,60
9,1039,260,1336908876,1336910029,0,1,1153
9,1053,253,1337677245,1337677825,0,2,580
9,1053,5,1337688581,1337690144,0,2,1563
9,1055,449,1337851714,1337852584,0,1,870
9,1057,11,1338090682,1338090966,0,6,284
9,1057,5,1338090966,1338091577,0,6,611
9,1057,71,1338098702,1338098914,0,6,212
9,1057,297,1338098914,1338100816,0,6,1902
9,1057,297,1338107942,1338108696,0,6,754
9,1057,260,1338108696,1338109956,0,6,1260
9,1070,428,1338973862,1338974004,0,2,142
9,1070,260,1338976721,1338977576,0,2,855
9,1076,5,1339290430,1339290953,0,1,523
10,1098,284,1344688170,1344688465,0,1,295
10,1101,284,1347228485,1347229880,0,1,1395
10,1102,284,1347660629,1347660689,0,1,60
10,1103,284,1347703023,1347705728,0,1,2705
10,1107,284,1350119570,1350119630,0,1,60
10,1108,5,1350891737,1350892204,0,1,467
10,1112,253,1351056558,1351058894,0,4,2336
10,1112,5,1351060724,1351062473,0,4,1749
10,1112,8,1351065271,1351068126,0,4,2855
10,1112,11,1351068126,1351068186,0,4,60
10,1114,351,1351346887,1351348809,0,1,1922
10,1115,35,1351369634,1351369822,0,1,188
10,1125,5,1352184820,1352187334,0,2,2514
10,1125,11,1352190452,1352190776,0,2,324
10,1126,35,1352282422,1352282662,0,1,240
10,1128,284,1352582474,1352583982,0,1,1508
10,1130,284,1353055149,1353057297,0,2,2148
10,1130,5,1353057297,1353060767,0,2,3470
10,1135,35,1353768205,1353789031,0,2,20826
10,1135,35,1353789031,1353789130,0,2,99
10,1137,253,1354412446,1354415453,0,2,3007
10,1137,71,1354432654,1354433657,0,2,1003
10,1138,21,1354434633,1354436146,0,1,1513
10,1139,253,1355123210,1355123467,0,2,257
10,1139,603,1355124375,1355124564,0,2,189
10,1140,5,1355199224,1355199497,0,2,273
10,1140,11,1355211798,1355211858,0,2,60
10,1147,35,1356167395,1356168113,0,1,718
10,1150,21,1357417506,1357417566,0,1,60
10,1157,28,1358056607,1358062063,0,1,5456
10,1161,351,1358804382,1358805141,0,2,759
10,1161,284,1358805141,1358805337,0,2,196
10,1162,253,1358829802,1358834768,0,2,4966
10,1162,11,1358846900,1358847231,0,2,331
10,1164,284,1359788921,1359788981,0,1,60
10,1166,5,1359881592,1359882442,0,1,850
10,1169,284,1360107318,1360107679,0,1,361
11,1187,21,1336345402,1336345462,0,1,60
11,1189,35,1337251030,1337251090,0,1,60
11,1195,21,1338725745,1338725805,0,1,60
11,1196,253,1338807086,1338807146,0,1,60
11,1199,640,1339201236,1339201296,0,1,60
11,1201,253,1339257389,1339257449,0,1,60
11,1213,35,1343629860,1343629920,0,1,60
11,1214,253,1344509575,1344509635,0,1,60
11,1216,651,1344664787,1344667218,0,1,2431
11,1233,21,1353115063,1353117247,0,1,2184
11,1262,651,1359715065,1359720159,0,1,5094
12,1266,11,1333866174,1333866564,0,5,390
12,1266,5,1333866564,1333867029,0,5,465
12,1266,71,1333870178,1333870194,0,5,16
12,1266,253,1333872026,1333872039,0,5,13
12,1266,5,1333876309,1333876369,0,5,60
12,1269,449,1336120370,1336120430,0,1,60
12,1270,11,1336220622,1336221050,0,3,428
12,1270,5,1336221050,1336221325,0,3,275
12,1270,8,1336221325,1336221385,0,3,60
12,1272,11,1337397797,1337398146,0,6,349
12,1272,5,1337398146,1337398161,0,6,15
12,1272,8,1337398161,1337398178,0,6,17
12,1272,71,1337398707,1337401537,0,6,2830
12,1272,5,1337401537,1337401950,0,6,413
12,1272,8,1337413487,1337417143,0,6,3656
12,1273,5,1339217692,1339218492,0,3,800
12,1273,71,1339218492,1339226505,0,3,8013
12,1273,8,1339226505,1339231703,0,3,5198
12,1275,5,1341649544,1341650091,0,4,547
12,1275,5,1341658748,1341658765,0,4,17
12,1275,8,1341658765,1341658794,0,4,29
12,1275,5,1341669871,1341669931,0,4,60
12,1277,1,1341716177,1341717103,0,3,926
12,1277,5,1341717103,1341717432,0,3,329
12,1277,8,1341717432,1341724146,0,3,6714
12,1278,11,1341754744,1341754804,0,1,60
12,1279,71,1342233099,1342235630,0,2,2531
12,1279,263,1342235630,1342236022,0,2,392
12,1280,21,1342255591,1342255853,0,4,262
12,1280,5,1342255853,1342255872,0,4,19
12,1280,8,1342255872,1342255885,0,4,13
12,1280,11,1342260138,1342260198,0,4,60
12,1285,11,1347666823,1347667156,0,2,333
12,1285,5,1347667156,1347667689,0,2,533
12,1287,5,1347714806,1347714828,0,2,22
12,1287,11,1347715487,1347715547,0,2,60
12,1288,11,1351059857,1351060148,0,3,291
12,1288,5,1351060148,1351060537,0,3,389
12,1288,480,1351060537,1351060724,0,3,187
12,1290,5,1353644862,1353648266,0,2,3404
12,1290,8,1353648266,1353653134,0,2,4868
12,1291,5,1353743078,1353744158,0,2,1080
12,1291,28,1353752179,1353752239,0,2,60
12,1292,5,1353823798,1353823820,0,2,22
12,1292,8,1353836694,1353840010,0,2,3316
12,1293,11,1353848497,1353848557,0,1,60
12,1295,261,1354333882,1354333900,0,7,18
12,1295,261,1354340901,1354342544,0,7,1643
12,1295,71,1354342544,1354342657,0,7,113
12,1295,5,1354346325,1354346353,0,7,28
12,1295,5,1354350051,1354350909,0,7,858
12,1295,11,1354350909,1354351053,0,7,144
12,1295,11,1354352675,1354352690,0,7,15
12,1297,28,1354458746,1354458758,0,1,12
12,1298,11,1354915758,1354916794,0,1,1036
12,1299,253,1354960299,1354961540,0,1,1241
12,1302,5,1355550508,1355550570,0,1,62
12,1303,5,1355640274,1355640413,0,3,139
12,1303,5,1355654893,1355654906,0,3,13
12,1303,8,1355654906,1355655587,0,3,681
12,1304,5,1356266894,1356266954,0,1,60
12,1305,336,1356844011,1356846241,0,1,2230
12,1308,5,1357136351,1357136909,0,2,558
12,1308,11,1357136909,1357136969,0,2,60
12,1309,11,1357293743,1357294064,0,2,321
12,1309,5,1357294064,1357294742,0,2,678
12,1310,5,1357465833,1357465867,0,2,34
12,1310,284,1357468505,1357477587,0,2,9082
12,1313,11,1359609133,1359609701,0,3,568
12,1313,5,1359609701,1359610168,0,3,467
12,1313,35,1359623739,1359624124,0,3,385
12,1314,28,1359726618,1359726678,0,1,60
12,1315,5,1359777032,1359777855,0,3,823
12,1315,765,1359777855,1359783111,0,3,5256
12,1315,5,1359783111,1359783143,0,3,32
12,1317,5,1359852561,1359853045,0,5,484
12,1317,21,1359853045,1359853432,0,5,387
12,1317,765,1359853432,1359854082,0,5,650
12,1317,263,1359854082,1359854357,0,5,275
12,1317,449,1359854357,1359854417,0,5,60
12,1318,21,1359894890,1359894950,0,1,60
13,1320,11,1360822051,1360822085,0,3,34
13,1320,5,1360824449,1360824466,0,3,17
13,1320,5,1360828967,1360831019,0,3,2052
13,1322,640,1333533926,1333533986,0,1,60
13,1323,35,1333534500,1333535551,0,3,1051
13,1323,35,1333538877,1333539202,0,3,325
13,1323,640,1333539202,1333549266,0,3,10064
13,1328,603,1333876083,1333876832,0,4,749
13,1328,35,1333876832,1333877013,0,4,181
13,1328,35,1333885178,1333885662,0,4,484
13,1328,603,1333885662,1333887045,0,4,1383
13,1333,640,1334095155,1334095480,0,1,325
13,1334,640,1334127180,1334127857,0,2,677
13,1334,640,1334138475,1334139706,0,2,1231
13,1335,640,1334152859,1334157278,0,1,4419
13,1336,640,1334202742,1334202891,0,1,149
13,1337,640,1334207858,1334207918,0,1,60
13,1341,640,1334314995,1334315516,0,2,521
13,1341,603,1334315516,1334315576,0,2,60
13,1342,603,1334354498,1334354815,0,2,317
13,1342,640,1334354815,1334355069,0,2,254
13,1346,603,1334526472,1334527177,0,2,705
13,1346,640,1334527177,1334527425,0,2,248
13,1347,603,1334563898,1334564397,0,2,499
13,1347,640,1334564397,1334564630,0,2,233
13,1348,603,1334612907,1334613565,0,2,658
13,1348,640,1334613565,1334613793,0,2,228
13,1352,603,1334787545,1334788042,0,3,497
13,1352,640,1334788042,1334788173,0,3,131
13,1352,640,1334802314,1334802550,0,3,236
13,1353,640,1334814490,1334833146,0,1,18656
13,1356,640,1334904128,1334904753,0,2,625
13,1356,35,1334904753,1334904971,0,2,218
13,1357,35,1334935644,1334936427,0,2,783
13,1357,603,1334936427,1334936747,0,2,320
13,1359,35,1335063376,1335063882,0,2,506
13,1359,603,1335063882,1335065860,0,2,1978
13,1361,603,1335130253,1335130977,0,3,724
13,1361,640,1335147543,1335150751,0,3,3208
13,1361,35,1335150751,1335150861,0,3,110
13,1362,35,1335162844,1335163175,0,1,331
13,1363,640,1335175782,1335176262,0,2,480
13,1363,603,1335176262,1335176466,0,2,204
13,1364,603,1335218592,1335219246,0,2,654
13,1364,640,1335219246,1335219306,0,2,60
13,1368,35,1335420434,1335421177,0,1,743
13,1369,35,1335450454,1335451074,0,2,620
13,1369,603,1335451074,1335451405,0,2,331
13,1370,640,1335538669,1335539409,0,2,740
13,1370,603,1335539409,1335539469,0,2,60
13,1372,603,1335624759,1335625012,0,1,253
13,1373,603,1335656671,1335657207,0,4,536
13,1373,35,1335657207,1335658367,0,4,1160
13,1373,253,1335658367,1335658382,0,4,15
13,1373,59,1335658382,1335658442,0,4,60
13,1374,603,1335908900,1335909818,0,1,918
13,1376,640,1335956808,1335957294,0,2,486
13,1376,603,1335957294,1335957530,0,2,236
13,1382,603,1336205469,1336205957,0,4,488
13,1382,35,1336205957,1336207400,0,4,1443
13,1382,35,1336212147,1336212658,0,4,511
13,1382,603,1336212658,1336212991,0,4,333
13,1384,603,1336342083,1336342143,0,1,60
13,1385,603,1336391205,1336391520,0,1,315
13,1388,603,1336514738,1336515406,0,2,668
13,1388,640,1336515406,1336515725,0,2,319
13,1390,640,1336563482,1336563836,0,2,354
13,1390,603,1336563836,1336564893,0,2,1057
13,1392,603,1336689911,1336691868,0,2,1957
13,1392,21,1336691868,1336692567,0,2,699
13,1393,21,1336910541,1336911682,0,2,1141
13,1393,603,1336911682,1336911841,0,2,159
13,1394,603,1336945671,1336946357,0,2,686
13,1394,640,1336946357,1336946417,0,2,60
13,1395,35,1336980821,1336982537,0,1,1716
13,1397,640,1337032855,1337035730,0,1,2875
13,1399,640,1337079551,1337079950,0,2,399
13,1399,603,1337079950,1337080218,0,2,268
13,1402,640,1337219201,1337219431,0,2,230
13,1402,35,1337220922,1337223855,0,2,2933
13,1403,603,1337264097,1337264411,0,1,314
13,1404,603,1337296001,1337296480,0,2,479
13,1404,640,1337296480,1337296540,0,2,60
13,1406,603,1337381592,1337382911,0,1,1319
13,1409,640,1337593381,1337594649,0,4,1268
13,1409,875,1337594649,1337596405,0,4,1756
13,1409,875,1337606675,1337607724,0,4,1049
13,1409,603,1337607724,1337607784,0,4,60
13,1410,603,1337636609,1337641258,0,2,4649
13,1410,640,1337643366,1337643426,0,2,60
13,1411,640,1337659627,1337660069,0,1,442
13,1413,640,1337827770,1337837393,0,1,9623
13,1414,640,1337851773,1337852057,0,2,284
13,1414,35,1337852057,1337852117,0,2,60
13,1415,35,1337941183,1337955866,0,1,14683
13,1416,603,1337987534,1337987594,0,1,60
13,1418,603,1338195970,1338196845,0,2,875
13,1418,640,1338196845,1338201328,0,2,4483
13,1419,640,1338211950,1338212277,0,2,327
13,1419,603,1338212277,1338212663,0,2,386
13,1420,603,1338242425,1338242811,0,3,386
13,1420,640,1338242811,1338259366,0,3,16555
13,1420,640,1338262749,1338262809,0,3,60
13,1422,603,1338328303,1338328779,0,2,476
13,1422,640,1338328779,1338328927,0,2,148
13,1423,651,1338353259,1338353319,0,1,60
13,1424,603,1338501441,1338502007,0,2,566
13,1424,640,1338502007,1338502270,0,2,263
13,1425,640,1338544880,1338545250,0,2,370
13,1425,35,1338545250,1338546140,0,2,890
13,1428,603,1338761104,1338761696,0,2,592
13,1428,640,1338761696,1338761817,0,2,121
13,1430,640,1338819844,1338820200,0,2,356
13,1430,603,1338820200,1338820260,0,2,60
13,1431,640,1338848022,1338848373,0,1,351
13,1433,640,1338906834,1338906894,0,1,60
13,1434,35,1338977032,1338987388,0,3,10356
13,1434,35,1338987924,1338988609,0,3,685
13,1434,603,1338988609,1338989129,0,3,520
13,1435,21,1339045716,1339045786,0,1,70
13,1436,35,1339408059,1339410239,0,3,2180
13,1436,640,1339410239,1339413664,0,3,3425
13,1436,640,1339428281,1339429411,0,3,1130
13,1437,35,1339458470,1339459656,0,2,1186
13,1437,603,1339475169,1339475229,0,2,60
13,1438,21,1339480655,1339482626,0,2,1971
13,1438,35,1339482626,1339482694,0,2,68
13,1439,21,1343518246,1343521852,0,3,3606
13,1439,480,1343521852,1343522017,0,3,165
13,1439,5,1343522017,1343522758,0,3,741
13,1440,35,1343550745,1343551156,0,2,411
13,1440,35,1343551156,1343562039,0,2,10883
13,1442,21,1343614220,1343615691,0,1,1471
13,1443,35,1352766975,1352768647,0,2,1672
13,1443,35,1352771575,1352772265,0,2,690
13,1444,603,1352793163,1352793730,0,3,567
13,1444,35,1352793730,1352794093,0,3,363
13,1444,35,1352802313,1352803138,0,3,825
13,1446,260,1354323761,1354326054,0,4,2293
13,1446,253,1354331072,1354331143,0,4,71
13,1446,59,1354331143,1354331575,0,4,432
13,1446,253,1354335438,1354337272,0,4,1834
13,1448,35,1354375253,1354376090,0,2,837
13,1448,35,1354376090,1354376150,0,2,60
14,1455,5,1333890170,1333890230,0,1,60
14,1458,5,1334065000,1334065060,0,1,60
14,1459,1,1334198960,1334200044,0,1,1084
14,1460,1,1334237815,1334237875,0,1,60
14,1461,5,1334277135,1334277195,0,1,60
14,1462,5,1334327041,1334328376,0,2,1335
14,1462,1,1334328376,1334328436,0,2,60
14,1465,1,1334496694,1334496754,0,1,60
14,1466,5,1334582146,1334584941,0,1,2795
14,1472,5,1335190704,1335190764,0,1,60
14,1474,5,1335540009,1335541505,0,1,1496
14,1476,5,1335708736,1335708796,0,1,60
14,1478,1,1336091361,1336092914,0,1,1553
14,1479,5,1336137671,1336137731,0,1,60
14,1483,5,1336397096,1336397156,0,1,60
14,1484,5,1336482944,1336483004,0,1,60
14,1486,1,1336695768,1336697222,0,1,1454
14,1487,5,1336798050,1336801846,0,2,3796
14,1487,5,1336808427,1336808487,0,2,60
14,1489,5,1336915592,1336917809,0,2,2217
14,1489,1,1336917809,1336917869,0,2,60
14,1494,5,1337141255,1337149067,0,3,7812
14,1494,5,1337150831,1337152842,0,3,2011
14,1494,1,1337152842,1337153838,0,3,996
14,1499,5,1337693985,1337694045,0,1,60
14,1500,5,1337837046,1337837106,0,1,60
14,1501,5,1337952684,1337952744,0,1,60
14,1505,5,1338124157,1338124217,0,1,60
14,1509,1,1338479298,1338479358,0,1,60
14,1510,5,1338685190,1338685670,0,1,480
14,1518,5,1339162549,1339162609,0,1,60
14,1520,5,1339245176,1339246778,0,2,1602
14,1520,1,1339246778,1339246838,0,2,60
14,1529,5,1339939440,1339939500,0,1,60
14,1538,5,1341322710,1341322770,0,1,60
14,1541,1,1341495798,1341495858,0,1,60
14,1543,5,1341668209,1341668269,0,1,60
14,1545,5,1341753230,1341753290,0,1,60
14,1546,5,1341795169,1341795637,0,1,468
14,1548,5,1341841630,1341843805,0,1,2175
14,1549,5,1341998085,1341998145,0,1,60
14,1550,5,1342099179,1342099239,0,1,60
14,1552,5,1342165533,1342166233,0,2,700
14,1552,5,1342166233,1342166293,0,2,60
14,1555,1,1342361064,1342361124,0,1,60
14,1559,5,1342792774,1342792834,0,1,60
14,1560,5,1342962970,1342963030,0,1,60
14,1561,5,1343136563,1343136623,0,1,60
14,1564,5,1343523662,1343524101,0,1,439
14,1567,1,1344593965,1344595148,0,3,1183
14,1567,5,1344595148,1344595726,0,3,578
14,1567,8,1344595726,1344606189,0,3,10463
14,1572,5,1345128749,1345128809,0,1,60
14,1576,5,1345468693,1345468753,0,1,60
14,1579,5,1347695751,1347696505,0,1,754
14,1595,5,1352250046,1352268282,0,1,18236
14,1597,5,1352508435,1352508495,0,1,60
14,1609,5,1353575944,1353576342,0,2,398
14,1609,1,1353593417,1353594136,0,2,719
14,1615,5,1354369436,1354369496,0,1,60
14,1616,5,1354495922,1354495982,0,1,60
14,1617,5,1354541259,1354541319,0,1,60
14,1619,5,1354669428,1354688224,0,1,18796
14,1621,1,1354890181,1354890241,0,1,60
14,1622,5,1354927777,1354928345,0,1,568
14,1631,5,1355964882,1355977182,0,1,12300
14,1633,8,1356100256,1356100316,0,1,60
14,1638,5,1356915615,1356933973,0,1,18358
14,1645,1,1357482341,1357482401,0,1,60
14,1647,5,1357652016,1357652076,0,1,60
14,1664,5,1359697983,1359698043,0,1,60
15,1703,1005,1339669134,1339670329,0,1,1195
15,1705,263,1340015261,1340015321,0,1,60
15,1713,263,1347531238,1347531298,0,1,60
15,1740,21,1359595713,1359595773,0,1,60
15,1741,260,1359634715,1359634775,0,1,60
16,1747,253,1334130908,1334132402,0,1,1494
16,1754,35,1335081350,1335081524,0,2,174
16,1754,640,1335092221,1335092281,0,2,60
16,1756,35,1335353556,1335353616,0,1,60
16,1759,35,1336100967,1336101266,0,2,299
16,1759,253,1336101266,1336101862,0,2,596
16,1763,640,1336894723,1336904363,0,1,9640
16,1768,253,1338268069,1338268129,0,1,60
16,1778,640,1342255652,1342255712,0,1,60
16,1779,640,1343564264,1343564324,0,1,60
16,1788,253,1351332265,1351332325,0,1,60
16,1793,640,1351845119,1351845402,0,1,283
16,1797,35,1353056931,1353056991,0,1,60
16,1799,35,1353445101,1353445161,0,1,60
16,1804,35,1354954913,1354958032,0,1,3119
16,1805,640,1355411076,1355411136,0,1,60
16,1806,35,1355561521,1355561581,0,1,60
16,1807,253,1355645114,1355645174,0,1,60
16,1808,603,1355730543,1355730603,0,1,60
16,1811,35,1356845937,1356845997,0,1,60
16,1813,35,1357099925,1357099985,0,1,60
17,1828,651,1333875484,1333881796,0,1,6312
17,1832,261,1334187497,1334200677,0,1,13180
17,1834,8,1334317832,1334328213,0,1,10381
17,1835,449,1334451115,1334451229,0,1,114
17,1850,35,1336520265,1336520720,0,1,455
17,1854,651,1336796382,1336809412,0,1,13030
17,1870,651,1337943661,1337944692,0,1,1031
17,1909,651,1341483324,1341492757,0,1,9433
17,1935,5,1343636875,1343643480,0,1,6605
17,1943,428,1345271875,1345273804,0,2,1929
17,1943,765,1345274709,1345287079,0,2,12370
18,1952,603,1333497897,1333500029,0,2,2132
18,1952,71,1333500029,1333509033,0,2,9004
18,1953,35,1333542772,1333542832,0,1,60
18,1954,603,1333543342,1333543402,0,1,60
18,1955,603,1333584428,1333584488,0,1,60
18,1956,603,1333719079,1333719139,0,1,60
18,1957,603,1333848190,1333849351,0,2,1161
18,1957,21,1333849351,1333849411,0,2,60
18,1958,603,1333871087,1333871147,0,1,60
18,1959,603,1333926885,1333928740,0,2,1855
18,1959,71,1333928740,1333928800,0,2,60
18,1960,603,1333975736,1333975796,0,1,60
18,1961,603,1334015732,1334015792,0,1,60
18,1962,603,1334102383,1334104119,0,2,1736
18,1962,71,1334104119,1334113946,0,2,9827
18,1963,5,1334135845,1334137796,0,2,1951
18,1963,8,1334137796,1334139238,0,2,1442
18,1964,603,1334188733,1334190795,0,2,2062
18,1964,71,1334190795,1334200480,0,2,9685
18,1965,21,1334228415,1334229611,0,3,1196
18,1965,35,1334229611,1334231969,0,3,2358
18,1965,603,1334231969,1334232029,0,3,60
18,1966,71,1334277288,1334286828,0,1,9540
18,1967,35,1334316984,1334317809,0,2,825
18,1967,603,1334318704,1334318764,0,2,60
18,1968,603,1334369941,1334373228,0,2,3287
18,1968,875,1334382311,1334382371,0,2,60
18,1970,603,1334496947,1334497007,0,1,60
18,1971,603,1334575821,1334575881,0,1,60
18,1972,603,1334670796,1334670856,0,1,60
18,1973,603,1334707512,1334707572,0,1,60
18,1974,603,1334793756,1334805154,0,1,11398
18,1975,5,1334831013,1334832236,0,2,1223
18,1975,603,1334835261,1334835321,0,2,60
18,1976,603,1334880122,1334881735,0,2,1613
18,1976,71,1334881735,1334891631,0,2,9896
18,1977,5,1334916879,1334917167,0,2,288
18,1977,603,1334921398,1334921458,0,2,60
18,1978,35,1334974782,1334988078,0,2,13296
18,1978,603,1334988078,1334988138,0,2,60
18,1979,71,1335400543,1335400603,0,1,60
18,1980,5,1335431625,1335435697,0,2,4072
18,1980,603,1335439875,1335439935,0,2,60
18,1981,5,1335520690,1335521074,0,2,384
18,1981,603,1335525859,1335525919,0,2,60
18,1982,5,1335596500,1335596613,0,2,113
18,1982,8,1335596613,1335600413,0,2,3800
18,1983,765,1335608714,1335610263,0,1,1549
18,1984,765,1336344368,1336345918,0,3,1550
18,1984,603,1336349142,1336350801,0,3,1659
18,1984,71,1336350801,1336360292,0,3,9491
18,1985,603,1336385684,1336386937,0,1,1253
18,1986,8,1336473886,1336476680,0,1,2794
18,1987,603,1336521937,1336523822,0,2,1885
18,1987,71,1336523822,1336533211,0,2,9389
18,1988,5,1336555849,1336561081,0,2,5232
18,1988,603,1336567534,1336567594,0,2,60
18,1989,71,1336610476,1336610536,0,1,60
18,1990,603,1336694710,1336696560,0,2,1850
18,1990,71,1336696560,1336705860,0,2,9300
18,1991,603,1336735471,1336735794,0,1,323
18,1992,603,1336794122,1336795219,0,1,1097
18,1993,253,1336818811,1336819904,0,2,1093
18,1993,603,1336819904,1336820459,0,2,555
18,1994,603,1336878957,1336879301,0,1,344
18,1995,35,1336920175,1336920842,0,2,667
18,1995,603,1336920842,1336920902,0,2,60
18,1996,603,1336953864,1336955942,0,2,2078
18,1996,71,1336955942,1336964933,0,2,8991
18,1997,603,1336994942,1336995362,0,1,420
18,1998,603,1337040215,1337041861,0,2,1646
18,1998,71,1337041861,1337041921,0,2,60
18,1999,603,1337083522,1337084300,0,1,778
18,2000,603,1337126594,1337137862,0,1,11268
18,2001,5,1337160154,1337172048,0,2,11894
18,2001,603,1337173679,1337173739,0,2,60
18,2002,603,1337212977,1337214903,0,2,1926
18,2002,71,1337214903,1337224486,0,2,9583
18,2003,5,1337249611,1337249980,0,2,369
18,2003,603,1337254553,1337254613,0,2,60
18,2004,603,1337342889,1337342949,0,1,60
18,2005,35,1337391293,1337393090,0,2,1797
18,2005,253,1337393090,1337404140,0,2,11050
18,2006,603,1337419609,1337419669,0,1,60
18,2007,5,1337593265,1337598508,0,2,5243
18,2007,603,1337600420,1337600480,0,2,60
18,2008,603,1337644956,1337646671,0,2,1715
18,2008,71,1337646671,1337656426,0,2,9755
18,2009,5,1337680017,1337680391,0,2,374
18,2009,603,1337686053,1337687273,0,2,1220
18,2010,603,1337817909,1337828831,0,1,10922
18,2011,21,1337853654,1337853714,0,1,60
18,2012,5,1337939634,1337939983,0,2,349
18,2012,603,1337944983,1337945043,0,2,60
18,2013,35,1338018617,1338019952,0,2,1335
18,2013,603,1338021026,1338021086,0,2,60
18,2015,603,1338163721,1338174895,0,1,11174
18,2016,5,1338200006,1338200168,0,1,162
18,2017,603,1338250023,1338251592,0,2,1569
18,2017,71,1338251592,1338261051,0,2,9459
18,2018,603,1338291723,1338291783,0,1,60
18,2019,603,1338346445,1338348384,0,2,1939
18,2019,71,1338348384,1338348444,0,2,60
18,2020,603,1338553562,1338553622,0,1,60
18,2021,875,1338699002,1338699062,0,1,60
18,2022,603,1338768484,1338768544,0,1,60
18,2023,603,1338812843,1338812903,0,1,60
18,2024,603,1338854898,1338854958,0,1,60
18,2025,603,1338899180,1338899669,0,1,489
18,2026,5,1338974948,1338980249,0,3,5301
18,2026,8,1338980249,1338984423,0,3,4174
18,2026,603,1338984423,1338984780,0,3,357
18,2027,603,1339027688,1339029301,0,2,1613
18,2027,71,1339029301,1339038658,0,2,9357
18,2028,603,1339068721,1339068781,0,1,60
18,2029,603,1339114844,1339116419,0,2,1575
18,2029,71,1339116419,1339116479,0,2,60
18,2030,35,1339170440,1339171509,0,2,1069
18,2030,603,1339171509,1339171569,0,2,60
18,2032,35,1339304592,1339307595,0,2,3003
18,2032,603,1339321953,1339322013,0,2,60
18,2033,603,1339372386,1339384230,0,1,11844
18,2034,603,1339414822,1339414882,0,1,60
18,2035,71,1339460730,1339470412,0,1,9682
18,2036,603,1339501513,1339502302,0,1,789
18,2037,603,1339545784,1339547326,0,2,1542
18,2037,71,1339547326,1339547386,0,2,60
18,2038,5,1339579439,1339581927,0,2,2488
18,2038,603,1339587038,1339587098,0,2,60
18,2039,71,1339634081,1339643816,0,1,9735
18,2040,5,1339753902,1339754327,0,2,425
18,2040,603,1339760845,1339760905,0,2,60
18,2042,8,1339920633,1339923033,0,1,2400
18,2043,603,1339943838,1339943898,0,1,60
18,2044,71,1339979588,1339979648,0,1,60
18,2045,603,1340019472,1340019532,0,1,60
18,2046,603,1340099119,1340099179,0,1,60
18,2047,71,1340238729,1340238789,0,1,60
18,2048,5,1340272475,1340272737,0,3,262
18,2048,8,1340275336,1340276940,0,3,1604
18,2048,603,1340278632,1340278692,0,3,60
18,2049,603,1340624578,1340624638,0,1,60
18,2050,603,1340755605,1340757203,0,2,1598
18,2050,71,1340757203,1340767171,0,2,9968
18,2051,5,1340788521,1340788687,0,2,166
18,2051,8,1340792017,1340794490,0,2,2473
18,2052,603,1341108397,1341109374,0,1,977
18,2054,603,1341273915,1341275604,0,2,1689
18,2054,71,1341275604,1341284816,0,2,9212
18,2055,603,1341315954,1341316884,0,1,930
18,2056,603,1341360333,1341361438,0,2,1105
18,2056,71,1341362025,1341362085,0,2,60
18,2057,21,1341394508,1341395014,0,2,506
18,2057,603,1341403800,1341404099,0,2,299
18,2058,603,1341446654,1341448244,0,2,1590
18,2058,71,1341448244,1341448304,0,2,60
18,2059,5,1341482913,1341488578,0,2,5665
18,2059,603,1341488578,1341488638,0,2,60
18,2060,603,1341533087,1341544244,0,1,11157
18,2061,5,1341568746,1341569305,0,2,559
18,2061,603,1341575937,1341577013,0,2,1076
18,2062,640,1341624650,1341625025,0,4,375
18,2062,284,1341625025,1341640063,0,4,15038
18,2062,284,1341645093,1341645691,0,4,598
18,2062,35,1341645691,1341645751,0,4,60
18,2063,603,1341659559,1341659619,0,1,60
18,2064,35,1341712044,1341712803,0,2,759
18,2064,603,1341732085,1341732145,0,2,60
18,2065,603,1341792108,1341793921,0,2,1813
18,2065,71,1341793921,1341793981,0,2,60
18,2066,5,1341828930,1341829373,0,2,443
18,2066,603,1341834534,1341834594,0,2,60
18,2067,603,1341879106,1341879166,0,1,60
18,2068,603,1341965003,1341966656,0,2,1653
18,2068,71,1341966656,1341976077,0,2,9421
18,2069,5,1341999980,1342004784,0,2,4804
18,2069,603,1342007629,1342007689,0,2,60
18,2070,603,1342051551,1342062694,0,1,11143
18,2071,5,1342089049,1342089122,0,2,73
18,2071,603,1342093992,1342094052,0,2,60
18,2072,603,1342137908,1342139616,0,2,1708
18,2072,71,1342139616,1342139676,0,2,60
18,2073,5,1342172933,1342173328,0,2,395
18,2073,603,1342192471,1342192531,0,2,60
18,2074,35,1342225467,1342225527,0,1,60
18,2075,253,1342413705,1342422105,0,2,8400
18,2075,603,1342422802,1342430270,0,2,7468
18,2077,603,1342483701,1342485220,0,2,1519
18,2077,71,1342485220,1342494820,0,2,9600
18,2078,603,1342529642,1342530238,0,1,596
18,2079,603,1342568866,1342570625,0,2,1759
18,2079,71,1342570625,1342570685,0,2,60
18,2080,603,1342834212,1342834272,0,1,60
18,2081,603,1342967234,1342967294,0,1,60
18,2082,603,1343130208,1343130268,0,1,60
18,2084,603,1343520970,1343522384,0,2,1414
18,2084,21,1343522384,1343523635,0,2,1251
18,2085,603,1343549198,1343549258,0,1,60
18,2086,71,1343608627,1343608687,0,1,60
18,2087,603,1343648220,1343648280,0,1,60
18,2088,603,1344153427,1344153487,0,1,60
18,2089,71,1344213502,1344222399,0,1,8897
18,2090,603,1344255740,1344255800,0,1,60
18,2091,5,1344508247,1344514156,0,2,5909
18,2091,603,1344515868,1344516897,0,2,1029
18,2092,1005,1344547662,1344547722,0,1,60
18,2093,765,1345335554,1345337673,0,2,2119
18,2093,603,1345337673,1345351114,0,2,13441
18,2094,71,1345422739,1345422799,0,1,60
18,2095,5,1345457371,1345457620,0,2,249
18,2095,603,1345462108,1345462168,0,2,60
18,2096,5,1346839998,1346840253,0,3,255
18,2096,8,1346843083,1346845306,0,3,2223
18,2096,603,1346846784,1346846844,0,3,60
18,2098,603,1347235453,1347237224,0,2,1771
18,2098,71,1347237224,1347237284,0,2,60
18,2099,603,1347665864,1347667421,0,1,1557
18,2100,603,1347687791,1347687957,0,2,166
18,2100,1005,1347694044,1347695500,0,2,1456
18,2101,603,1350000128,1350000188,0,1,60
18,2104,5,1350466463,1350467159,0,1,696
18,2105,71,1350607191,1350607251,0,1,60
18,2106,603,1350647195,1350647255,0,1,60
18,2107,603,1350950754,1350952342,0,2,1588
18,2107,71,1350952342,1350952402,0,2,60
18,2108,21,1350995435,1350995495,0,1,60
18,2109,71,1351038737,1351048571,0,1,9834
18,2110,5,1351071096,1351071316,0,3,220
18,2110,8,1351075069,1351081792,0,3,6723
18,2110,603,1351081792,1351081852,0,3,60
18,2111,603,1351123408,1351134509,0,1,11101
18,2112,603,1351169709,1351169769,0,1,60
18,2114,603,1351260034,1351261051,0,1,1017
18,2118,603,1351469162,1351480093,0,1,10931
18,2119,603,1351599781,1351599841,0,1,60
18,2120,603,1351641741,1351653346,0,1,11605
18,2121,603,1351689110,1351689170,0,1,60
18,2122,71,1351729927,1351729987,0,1,60
18,2123,603,1351775587,1351775647,0,1,60
18,2124,603,1351814614,1351825862,0,1,11248
18,2125,603,1351862354,1351862414,0,1,60
18,2126,603,1352160336,1352171195,0,1,10859
18,2127,5,1352196954,1352200099,0,3,3145
18,2127,8,1352200099,1352201523,0,3,1424
18,2127,603,1352203207,1352204357,0,3,1150
18,2129,5,1352280287,1352283568,0,2,3281
18,2129,603,1352289710,1352289770,0,2,60
18,2130,603,1352377609,1352377669,0,1,60
18,2131,603,1352466315,1352466375,0,1,60
18,2132,603,1352590133,1352590193,0,1,60
18,2133,603,1352638062,1352638122,0,1,60
18,2134,603,1352723026,1352723086,0,1,60
18,2136,603,1352808892,1352808952,0,1,60
18,2137,603,1353024289,1353024349,0,1,60
18,2138,875,1353133613,1353143671,0,1,10058
18,2139,603,1353225880,1353225940,0,1,60
18,2140,71,1353371404,1353371464,0,1,60
18,2141,603,1353417155,1353417215,0,1,60
18,2142,603,1353456406,1353458204,0,2,1798
18,2142,71,1353458204,1353458264,0,2,60
18,2143,5,1353489749,1353490300,0,2,551
18,2143,603,1353503367,1353503427,0,2,60
18,2144,603,1353542839,1353544442,0,2,1603
18,2144,71,1353544442,1353553770,0,2,9328
18,2145,5,1353580320,1353583266,0,2,2946
18,2145,603,1353585204,1353585264,0,2,60
18,2147,35,1353723480,1353724147,0,2,667
18,2147,253,1353724147,1353725039,0,2,892
18,2150,603,1353847906,1353847966,0,1,60
18,2151,603,1353890665,1353890725,0,1,60
18,2152,603,1353934900,1353934960,0,1,60
18,2154,603,1354060970,1354061030,0,1,60
18,2155,71,1354149248,1354149308,0,1,60
18,2156,603,1354361406,1354361466,0,1,60
18,2157,603,1354408393,1354410305,0,1,1912
18,2158,5,1354431621,1354437429,0,1,5808
18,2159,603,1354454424,1354454484,0,1,60
18,2160,71,1354754055,1354757275,0,2,3220
18,2160,603,1354757275,1354757335,0,2,60
18,2161,603,1355028314,1355031360,0,2,3046
18,2161,449,1355031360,1355040218,0,2,8858
18,2162,71,1355100580,1355109124,0,1,8544
18,2163,603,1355184115,1355184175,0,1,60
18,2164,5,1355219003,1355227279,0,2,8276
18,2164,603,1355227279,1355227339,0,2,60
18,2165,603,1355270729,1355272666,0,2,1937
18,2165,71,1355272666,1355281749,0,2,9083
18,2166,71,1355358727,1355368413,0,1,9686
18,2167,5,1355392704,1355398723,0,2,6019
18,2167,603,1355398723,1355398783,0,2,60
18,2168,603,1355485159,1355485219,0,1,60
18,2169,253,1355538041,1355543828,0,1,5787
18,2170,603,1355559685,1355561360,0,1,1675
18,2171,603,1355628849,1355631940,0,1,3091
18,2173,71,1355704644,1355704704,0,1,60
18,2174,5,1355740202,1355741831,0,2,1629
18,2174,8,1355741831,1355743668,0,2,1837
18,2175,603,1355789116,1355791100,0,2,1984
18,2175,71,1355791100,1355791160,0,2,60
18,2176,8,1355827142,1355832037,0,2,4895
18,2176,603,1355832037,1355832097,0,2,60
18,2177,603,1355875484,1355875544,0,1,60
18,2178,5,1355909172,1355909909,0,2,737
18,2178,8,1355909909,1355912228,0,2,2319
18,2180,603,1356048280,1356050065,0,2,1785
18,2180,71,1356050065,1356050125,0,2,60
18,2181,603,1356092112,1356092172,0,1,60
18,2182,35,1356145742,1356147588,0,1,1846
18,2184,5,1356238638,1356238886,0,3,248
18,2184,8,1356238886,1356247760,0,3,8874
18,2184,603,1356247760,1356247820,0,3,60
18,2185,603,1356605354,1356605414,0,1,60
18,2186,603,1356652989,1356654766,0,2,1777
18,2186,71,1356654766,1356654826,0,2,60
18,2187,263,1356767175,1356771854,0,2,4679
18,2187,261,1356771854,1356771914,0,2,60
18,2188,35,1356845357,1356848350,0,2,2993
18,2188,603,1356848350,1356848866,0,2,516
18,2189,603,1356944225,1356944795,0,1,570
18,2190,5,1357280188,1357280783,0,1,595
18,2191,603,1357303575,1357303635,0,1,60
18,2192,35,1357350757,1357361965,0,2,11208
18,2192,603,1357361965,1357362025,0,2,60
18,2195,603,1357555278,1357555338,0,1,60
18,2196,603,1357603754,1357603814,0,1,60
18,2197,5,1357638272,1357638772,0,2,500
18,2197,603,1357643223,1357643283,0,2,60
18,2198,71,1357691716,1357700841,0,1,9125
18,2200,8,1357811837,1357814943,0,2,3106
18,2200,603,1357816193,1357816253,0,2,60
18,2201,603,1357862747,1357864418,0,2,1671
18,2201,71,1357864418,1357874086,0,2,9668
18,2202,603,1357904142,1357904202,0,1,60
18,2203,35,1357955977,1357968952,0,1,12975
18,2207,5,1358327790,1358334994,0,2,7204
18,2207,603,1358334994,1358335029,0,2,35
18,2208,71,1358382782,1358392084,0,1,9302
18,2210,71,1358469455,1358469515,0,1,60
18,2211,5,1358506847,1358510665,0,1,3818
18,2213,603,1358854680,1358854740,0,1,60
18,2214,603,1359030857,1359030917,0,1,60
18,2215,603,1359072308,1359074300,0,2,1992
18,2215,71,1359074300,1359074360,0,2,60
18,2216,603,1359113676,1359113736,0,1,60
18,2217,603,1359248591,1359253477,0,1,4886
18,2219,603,1359375754,1359375814,0,1,60
18,2220,603,1359459421,1359459481,0,1,60
18,2221,71,1359506314,1359515549,0,1,9235
18,2222,5,1359538522,1359541582,0,3,3060
18,2222,8,1359541582,1359545063,0,3,3481
18,2222,603,1359546711,1359546771,0,3,60
18,2223,603,1359594392,1359594452,0,1,60
18,2225,603,1359718706,1359718766,0,1,60
18,2227,603,1359793322,1359793382,0,1,60
18,2228,603,1359852051,1359863065,0,2,11014
18,2228,449,1359863065,1359863125,0,2,60
18,2229,449,1359893582,1359893642,0,1,60
18,2230,603,1359978427,1359978487,0,1,60
18,2231,603,1360022703,1360022763,0,1,60
18,2232,5,1360058521,1360065336,0,2,6815
18,2232,603,1360065336,1360066051,0,2,715
18,2233,603,1360109067,1360111042,0,1,1975
18,2234,8,1360146425,1360150294,0,2,3869
18,2234,603,1360150294,1360150354,0,2,60
18,2235,71,1360197333,1360206422,0,1,9089
18,2236,5,1360232915,1360233826,0,2,911
18,2236,35,1360236090,1360236207,0,2,117
18,2237,603,1360282233,1360284217,0,2,1984
18,2237,71,1360284217,1360284277,0,2,60
18,2238,603,1360541365,1360541425,0,1,60
18,2239,603,1360572660,1360572682,0,1,22
18,2240,603,1360627400,1360627460,0,1,60
18,2241,603,1360670456,1360670516,0,1,60
18,2242,603,1360714000,1360715623,0,2,1623
18,2242,71,1360715623,1360715683,0,2,60
18,2243,5,1360747810,1360748079,0,3,269
18,2243,8,1360749533,1360754334,0,3,4801
18,2243,603,1360755600,1360755660,0,3,60
18,2244,71,1360802399,1360802459,0,1,60
18,2245,5,1360835035,1360835961,0,1,926
20,2373,8,1341402423,1341402483,0,1,60
21,2448,351,1334399982,1334401491,0,1,1509
21,2449,35,1334442913,1334443629,0,3,716
21,2449,284,1334443629,1334444252,0,3,623
21,2449,351,1334444252,1334444813,0,3,561
21,2457,5,1334986170,1334986335,0,2,165
21,2457,8,1334986335,1334987653,0,2,1318
21,2458,5,1335011493,1335013470,0,1,1977
21,2469,5,1335606869,1335607525,0,1,656
21,2470,5,1335643366,1335645086,0,1,1720
21,2476,5,1336388672,1336390297,0,1,1625
21,2483,5,1336796804,1336797779,0,2,975
21,2483,5,1336809633,1336811132,0,2,1499
21,2487,5,1336991085,1336991127,0,1,42
21,2500,351,1338072571,1338073164,0,1,593
21,2518,28,1339240665,1339241811,0,1,1146
21,2519,5,1339301434,1339301622,0,3,188
21,2519,8,1339302085,1339303881,0,3,1796
21,2519,5,1339303881,1339305261,0,3,1380
21,2529,351,1339902897,1339903528,0,2,631
21,2529,351,1339922499,1339922553,0,2,54
21,2536,5,1341119760,1341119899,0,2,139
21,2536,8,1341119899,1341120792,0,2,893
21,2553,351,1342084637,1342085220,0,1,583
21,2554,351,1342183370,1342184449,0,1,1079
21,2555,351,1342215776,1342216405,0,2,629
21,2555,21,1342220018,1342220078,0,2,60
21,2556,21,1342407357,1342408917,0,1,1560
21,2562,5,1343461947,1343462756,0,2,809
21,2562,5,1343470399,1343472364,0,2,1965
21,2567,5,1344248217,1344250457,0,1,2240
21,2568,5,1344507184,1344508841,0,1,1657
21,2570,5,1344941452,1344943406,0,1,1954
21,2575,5,1345457877,1345459802,0,1,1925
21,2576,5,1346840169,1346842128,0,1,1959
21,2577,5,1347532398,1347534459,0,3,2061
21,2577,5,1347534459,1347534927,0,3,468
21,2577,21,1347534927,1347538866,0,3,3939
21,2578,351,1347627650,1347629489,0,2,1839
21,2578,35,1347629489,1347629549,0,2,60
21,2579,5,1349689421,1349691034,0,1,1613
21,2582,5,1350037245,1350037467,0,2,222
21,2582,5,1350039793,1350041895,0,2,2102
21,2583,5,1350079223,1350079283,0,1,60
21,2584,5,1350135890,1350135950,0,1,60
21,2585,5,1350382819,1350383261,0,2,442
21,2585,5,1350385263,1350386818,0,2,1555
21,2593,5,1351247115,1351247434,0,3,319
21,2593,8,1351251667,1351252959,0,3,1292
21,2593,5,1351252959,1351254716,0,3,1757
21,2594,5,1351308731,1351309355,0,2,624
21,2594,5,1351321464,1351323093,0,2,1629
21,2595,5,1351400108,1351400229,0,2,121
21,2595,5,1351405945,1351407600,0,2,1655
21,2597,5,1351506046,1351506746,0,1,700
21,2599,5,1351678816,1351679372,0,1,556
21,2607,8,1352458981,1352459910,0,2,929
21,2607,5,1352462855,1352464614,0,2,1759
21,2612,21,1353059976,1353062580,0,2,2604
21,2612,5,1353062580,1353065496,0,2,2916
21,2613,5,1353137750,1353139664,0,1,1914
21,2614,5,1353205684,1353209486,0,6,3802
21,2614,5,1353210189,1353210920,0,6,731
21,2614,297,1353210920,1353220238,0,6,9318
21,2614,297,1353220238,1353220256,0,6,18
21,2614,5,1353223943,1353225269,0,6,1326
21,2614,8,1353225269,1353225329,0,6,60
21,2619,35,1353755500,1353756711,0,3,1211
21,2619,5,1353756711,1353757094,0,3,383
21,2619,5,1353757310,1353759134,0,3,1824
21,2620,5,1353817228,1353821489,0,3,4261
21,2620,5,1353822933,1353824012,0,3,1079
21,2620,351,1353824012,1353824695,0,3,683
21,2627,5,1354330664,1354330724,0,1,60
21,2637,5,1354926915,1354927502,0,1,587
21,2639,5,1355220835,1355220895,0,1,60
21,2642,5,1355480282,1355482119,0,1,1837
21,2645,5,1355739303,1355741296,0,1,1993
21,2646,5,1355786149,1355786209,0,1,60
21,2647,35,1355837213,1355838995,0,1,1782
21,2649,5,1355906425,1355908419,0,1,1994
21,2652,5,1356165516,1356166571,0,1,1055
21,2654,5,1356233805,1356233865,0,1,60
21,2661,5,1357559610,1357559670,0,1,60
21,2672,5,1359370674,1359378925,0,1,8251
21,2677,5,1359699693,1359700616,0,2,923
21,2677,8,1359701920,1359704611,0,2,2691
22,2691,35,1335056886,1335062979,0,1,6093
22,2699,35,1336894745,1336894815,0,1,70
22,2702,35,1337595874,1337595934,0,1,60
22,2703,35,1338693400,1338695212,0,1,1812
22,2704,35,1338804679,1338805370,0,1,691
22,2707,261,1339300607,1339300848,0,1,241
22,2708,1,1339318978,1339320881,0,3,1903
22,2708,284,1339320881,1339321439,0,3,558
22,2708,640,1339322411,1339323453,0,3,1042
22,2713,35,1341471484,1341471665,0,1,181
22,2714,35,1341625602,1341625703,0,1,101
22,2716,35,1341711338,1341711368,0,1,30
22,2728,71,1343529751,1343530997,0,1,1246
22,2733,603,1353224989,1353225506,0,1,517
22,2738,35,1353730177,1353730211,0,2,34
22,2738,104,1353739834,1353741071,0,2,1237
22,2739,875,1353814027,1353815499,0,1,1472
22,2743,35,1354957515,1354957516,0,1,1
22,2745,35,1355532904,1355532942,0,2,38
22,2745,35,1355532942,1355532967,0,2,25
22,2746,875,1357184831,1357185417,0,1,586
23,2749,875,1358048757,1358053363,0,1,4606
23,2750,35,1333491808,1333491868,0,1,60
23,2751,35,1333536540,1333536600,0,1,60
23,2752,35,1333843379,1333843439,0,1,60
23,2753,35,1333923546,1333923606,0,1,60
23,2754,35,1334143154,1334143214,0,1,60
23,2755,35,1334325875,1334325935,0,1,60
23,2756,35,1334528308,1334528368,0,1,60
23,2757,35,1334667672,1334667732,0,1,60
23,2758,35,1334701458,1334701518,0,1,60
23,2759,35,1334787975,1334788643,0,2,668
23,2759,35,1334802950,1334803010,0,2,60
23,2761,35,1334874332,1334874392,0,1,60
23,2764,35,1335355625,1335355632,0,1,7
23,2765,35,1335392573,1335392633,0,1,60
23,2766,35,1335596302,1335602374,0,1,6072
23,2767,35,1335911175,1335911235,0,1,60
23,2768,35,1335959062,1335959798,0,1,736
23,2770,35,1336429065,1336429125,0,1,60
23,2771,35,1336515479,1336515539,0,1,60
23,2772,35,1336559026,1336559086,0,1,60
23,2773,35,1336688308,1336688368,0,1,60
23,2774,35,1336737042,1336737102,0,1,60
23,2775,35,1336947538,1336947598,0,1,60
23,2776,35,1336991710,1336991770,0,1,60
23,2777,35,1337033994,1337034054,0,1,60
23,2778,35,1337173620,1337173680,0,1,60
23,2780,35,1337261032,1337261092,0,1,60
23,2781,35,1337347933,1337347993,0,1,60
23,2783,35,1337639223,1337639283,0,1,60
23,2784,35,1337686953,1337687013,0,1,60
23,2785,35,1338157193,1338157253,0,1,60
23,2787,35,1338244007,1338265116,0,1,21109
23,2788,35,1338330464,1338330524,0,1,60
23,2790,35,1338503081,1338503141,0,1,60
23,2791,35,1338556301,1338556600,0,1,299
23,2792,35,1338762286,1338762346,0,1,60
23,2793,35,1338815942,1338816002,0,1,60
23,2794,35,1338989781,1338989841,0,1,60
23,2795,35,1339076780,1339076840,0,1,60
23,2796,35,1339158401,1339158461,0,1,60
23,2798,35,1339417386,1339417446,0,1,60
23,2799,35,1339453553,1339453613,0,1,60
23,2800,35,1339539958,1339540018,0,1,60
23,2801,35,1339586283,1339586343,0,1,60
23,2802,35,1339626266,1339626326,0,1,60
23,2803,35,1340025983,1340026002,0,1,19
23,2804,35,1340102066,1340102126,0,1,60
23,2805,35,1340622219,1340622279,0,1,60
23,2806,35,1340750765,1340750825,0,1,60
23,2807,35,1340803548,1340803608,0,1,60
23,2808,2151,1341217211,1341217271,0,1,60
23,2809,35,1341318488,1341318548,0,1,60
23,2810,35,1341440706,1341440766,0,1,60
23,2811,35,1341526961,1341527021,0,1,60
23,2813,35,1341836044,1341836104,0,1,60
23,2814,35,1341873315,1341873375,0,1,60
23,2815,35,1341959031,1341959091,0,1,60
23,2816,35,1342007817,1342007877,0,1,60
23,2817,35,1342045465,1342045525,0,1,60
23,2819,35,1342563779,1342563859,0,1,80
23,2820,35,1342650310,1342650370,0,1,60
23,2821,284,1343465269,1343465547,0,1,278
23,2823,35,1344205029,1344205089,0,1,60
23,2825,35,1344675927,1344678754,0,1,2827
23,2826,35,1344896615,1344896675,0,1,60
23,2827,35,1344983111,1344983171,0,1,60
23,2828,35,1345414637,1345414697,0,1,60
23,2829,35,1347229104,1347229164,0,1,60
23,2830,21,1350050622,1350051887,0,2,1265
23,2830,35,1350051887,1350053078,0,2,1191
23,2831,35,1350137486,1350137546,0,1,60
23,2839,35,1358259064,1358259124,0,1,60
24,2841,35,1334053012,1334053751,0,2,739
24,2841,284,1334053751,1334054616,0,2,865
24,2842,35,1334317244,1334319445,0,1,2201
24,2845,35,1334496170,1334496230,0,1,60
24,2846,21,1334756386,1334756446,0,1,60
24,2847,35,1335243980,1335245859,0,1,1879
24,2848,35,1335275224,1335275284,0,1,60
24,2849,35,1335526008,1335527572,0,2,1564
24,2849,297,1335527572,1335531921,0,2,4349
24,2850,297,1335690645,1335692419,0,2,1774
24,2850,35,1335692419,1335692479,0,2,60
24,2851,35,1336051617,1336051677,0,1,60
24,2852,35,1336391349,1336397432,0,1,6083
24,2854,21,1336830225,1336830285,0,1,60
24,2855,35,1337076972,1337078485,0,1,1513
24,2856,35,1337166093,1337166380,0,2,287
24,2856,35,1337177691,1337177751,0,2,60
24,2857,35,1337682722,1337683137,0,2,415
24,2857,284,1337684048,1337684108,0,2,60
24,2858,35,1339902569,1339903615,0,2,1046
24,2858,480,1339903615,1339908826,0,2,5211
24,2860,35,1340012243,1340012303,0,1,60
24,2862,480,1341559408,1341559876,0,2,468
24,2862,35,1341568386,1341568446,0,2,60
24,2865,284,1342178368,1342190130,0,1,11762
24,2866,35,1342492354,1342492414,0,1,60
24,2867,28,1343124074,1343125469,0,2,1395
24,2867,35,1343125469,1343125529,0,2,60
24,2868,284,1344172589,1344173434,0,1,845
24,2870,253,1345259742,1345265091,0,1,5349
24,2872,284,1346840467,1346841214,0,1,747
24,2874,11,1350382233,1350383366,0,1,1133
24,2876,260,1351149428,1351150685,0,1,1257
24,2878,35,1351753307,1351757922,0,1,4615
24,2879,21,1352368128,1352368188,0,1,60
24,2881,449,1353636809,1353656536,0,1,19727
24,2883,21,1353740423,1353740483,0,1,60
24,2884,35,1353914359,1353915180,0,1,821
24,2888,35,1357128570,1357129837,0,1,1267
24,2889,35,1357623249,1357628148,0,1,4899
24,2890,35,1357973078,1357973138,0,1,60
24,2891,253,1358244745,1358244805,0,1,60
25,2900,351,1334305181,1334317207,0,1,12026
25,2910,5,1336098391,1336103170,0,1,4779
25,2917,21,1336822054,1336824363,0,1,2309
25,2920,8,1337416455,1337417467,0,1,1012
25,2979,8,1358069318,1358073222,0,1,3904
26,2991,284,1333515476,1333515536,0,1,60
26,2992,253,1333541131,1333542186,0,2,1055
26,2992,284,1333542186,1333542718,0,2,532
26,2994,284,1333856464,1333857583,0,4,1119
26,2994,11,1333857583,1333858225,0,4,642
26,2994,1,1333868810,1333870608,0,4,1798
26,2994,11,1333872881,1333873748,0,4,867
26,3002,284,1334291710,1334293957,0,1,2247
26,3003,284,1334317640,1334318854,0,1,1214
26,3004,284,1334359367,1334359792,0,2,425
26,3004,640,1334359792,1334359852,0,2,60
26,3009,21,1334753486,1334754404,0,1,918
26,3024,284,1335659544,1335659604,0,1,60
26,3025,284,1335689898,1335690696,0,1,798
26,3026,35,1335952195,1335952855,0,2,660
26,3026,284,1335952855,1335954367,0,2,1512
26,3027,284,1335957997,1335959418,0,1,1421
26,3028,284,1336180217,1336180277,0,1,60
26,3029,253,1336489116,1336498830,0,1,9714
26,3030,284,1336509416,1336510342,0,1,926
26,3031,253,1336722716,1336724625,0,1,1909
26,3033,253,1336774719,1336776025,0,2,1306
26,3033,284,1336776025,1336777665,0,2,1640
26,3038,284,1337221457,1337222341,0,3,884
26,3038,284,1337224100,1337225004,0,3,904
26,3038,253,1337225004,1337225969,0,3,965
26,3039,253,1337252738,1337253218,0,2,480
26,3039,253,1337253218,1337256358,0,2,3140
26,3042,284,1337649416,1337650537,0,3,1121
26,3042,253,1337650537,1337656467,0,3,5930
26,3042,253,1337656467,1337658054,0,3,1587
26,3043,284,1337689988,1337691040,0,1,1052
26,3044,284,1338011870,1338011930,0,1,60
26,3045,284,1338170027,1338170686,0,2,659
26,3045,35,1338170686,1338175403,0,2,4717
26,3046,35,1338194474,1338200839,0,1,6365
26,3047,284,1338263812,1338270505,0,1,6693
26,3050,284,1338784996,1338785679,0,1,683
26,3051,35,1338815156,1338816410,0,2,1254
26,3051,284,1338816410,1338817709,0,2,1299
26,3055,253,1339155069,1339156108,0,2,1039
26,3055,253,1339166265,1339169565,0,2,3300
26,3056,253,1339284711,1339285177,0,1,466
26,3057,284,1339329649,1339330643,0,1,994
26,3058,284,1339390381,1339391220,0,2,839
26,3058,35,1339391220,1339392555,0,2,1335
26,3059,284,1339420699,1339422269,0,1,1570
26,3060,284,1339461601,1339462009,0,2,408
26,3060,640,1339462009,1339462450,0,2,441
26,3062,253,1339646850,1339647818,0,1,968
26,3067,284,1340001364,1340002409,0,2,1045
26,3067,253,1340002409,1340004577,0,2,2168
26,3069,284,1340270381,1340271146,0,1,765
26,3070,284,1340617210,1340617913,0,1,703
26,3071,253,1340723246,1340725182,0,1,1936
26,3072,284,1340762014,1340763059,0,6,1045
26,3072,28,1340763059,1340764755,0,6,1696
26,3072,1,1340764755,1340765888,0,6,1133
26,3072,28,1340768892,1340769122,0,6,230
26,3072,35,1340776282,1340776997,0,6,715
26,3072,35,1340782657,1340783384,0,6,727
26,3074,284,1341117542,1341117602,0,1,60
26,3075,284,1341285563,1341287610,0,3,2047
26,3075,253,1341300019,1341301905,0,3,1886
26,3075,284,1341301905,1341304225,0,3,2320
26,3076,284,1341318759,1341320025,0,1,1266
26,3077,284,1341467238,1341467967,0,3,729
26,3077,284,1341470688,1341471620,0,3,932
26,3077,253,1341471620,1341482573,0,3,10953
26,3081,284,1341701035,1341701774,0,2,739
26,3081,35,1341701774,1341701834,0,2,60
26,3082,284,1341742671,1341744253,0,1,1582
26,3083,21,1341973300,1341976910,0,3,3610
26,3083,21,1341976910,1341976974,0,3,64
26,3083,336,1341979026,1341979086,0,3,60
26,3084,253,1342009386,1342011723,0,1,2337
26,3085,284,1342158442,1342158961,0,2,519
26,3085,284,1342167534,1342168042,0,2,508
26,3087,284,1342340791,1342342881,0,2,2090
26,3087,284,1342357103,1342358210,0,2,1107
26,3088,21,1342488643,1342489012,0,1,369
26,3089,284,1342536425,1342536485,0,1,60
26,3090,35,1342796401,1342796977,0,2,576
26,3090,284,1342796977,1342797037,0,2,60
26,3091,284,1342967713,1342968660,0,1,947
26,3092,284,1343462207,1343463680,0,1,1473
26,3094,284,1343614560,1343615705,0,2,1145
26,3094,284,1343630703,1343631429,0,2,726
26,3097,284,1344754097,1344754669,0,2,572
26,3097,284,1344768644,1344769706,0,2,1062
26,3099,284,1344827008,1344827068,0,1,60
26,3100,253,1356836323,1356836383,0,1,60
26,3101,284,1356875572,1356877143,0,1,1571
26,3102,284,1356940831,1356941985,0,2,1154
26,3102,284,1356959705,1356959765,0,2,60
26,3103,284,1356999594,1357000207,0,1,613
26,3104,284,1357108290,1357111579,0,1,3289
26,3105,284,1357139645,1357139705,0,1,60
26,3106,284,1357195020,1357195080,0,1,60
27,3116,104,1334054175,1334055159,0,1,984
27,3161,253,1338004781,1338005425,0,1,644
27,3227,253,1351326946,1351330521,0,1,3575
27,3259,104,1357280830,1357281922,0,1,1092
28,3290,35,1334306502,1334310427,0,2,3925
28,3290,35,1334326484,1334326544,0,2,60
28,3292,35,1335611103,1335611237,0,1,134
28,3293,35,1336132973,1336134060,0,2,1087
28,3293,35,1336144128,1336144188,0,2,60
28,3294,35,1336734649,1336735914,0,1,1265
28,3295,35,1336942393,1336942453,0,1,60
28,3296,35,1337247745,1337247805,0,1,60
28,3298,35,1337939515,1337939575,0,1,60
28,3299,35,1338090013,1338093362,0,1,3349
28,3301,35,1339159920,1339162087,0,1,2167
28,3302,35,1339358887,1339358947,0,1,60
28,3303,253,1339940677,1339940737,0,1,60
28,3305,35,1341640276,1341641220,0,1,944
28,3307,35,1342229372,1342231943,0,2,2571
28,3307,21,1342238211,1342243695,0,2,5484
28,3310,35,1343483224,1343484640,0,2,1416
28,3310,21,1343484640,1343484700,0,2,60
28,3311,35,1345281106,1345281691,0,1,585
28,3312,35,1345322099,1345335326,0,1,13227
28,3313,8,1346910401,1346911183,0,2,782
28,3313,5,1346911183,1346912582,0,2,1399
28,3314,35,1347678366,1347680307,0,2,1941
28,3314,28,1347685676,1347685868,0,2,192
28,3316,35,1350037001,1350047030,0,1,10029
28,3317,284,1350100725,1350100785,0,1,60
28,3318,875,1350118214,1350118274,0,1,60
28,3320,35,1351855190,1351856128,0,2,938
28,3320,480,1351856128,1351856188,0,2,60
28,3321,35,1352725954,1352726014,0,1,60
28,3322,35,1353113654,1353114949,0,1,1295
28,3323,35,1353362989,1353363049,0,1,60
28,3324,480,1353939489,1353939549,0,1,60
28,3325,21,1354341407,1354341467,0,1,60
28,3326,35,1354396809,1354396869,0,1,60
28,3327,35,1354519016,1354519076,0,1,60
28,3328,284,1354583713,1354583773,0,1,60
28,3330,284,1355118664,1355119845,0,2,1181
28,3330,253,1355124994,1355125056,0,2,62
28,3345,28,1360676706,1360676766,0,1,60
29,3346,284,1360703723,1360703783,0,1,60
29,3348,253,1333538037,1333540290,0,1,2253
29,3349,253,1333581000,1333581060,0,1,60
29,3354,253,1333975177,1333976370,0,1,1193
29,3355,253,1334013851,1334015952,0,1,2101
29,3357,253,1334100708,1334102420,0,1,1712
29,3358,253,1334140906,1334141858,0,1,952
29,3360,253,1334227888,1334235050,0,2,7162
29,3360,651,1334235050,1334235110,0,2,60
29,3363,253,1334377766,1334378400,0,1,634
29,3364,284,1334454054,1334455209,0,2,1155
29,3364,5,1334455209,1334466220,0,2,11011
29,3365,284,1334490707,1334490767,0,1,60
29,3367,651,1334658548,1334666948,0,1,8400
29,3368,253,1334705886,1334705946,0,1,60
29,3370,253,1334829427,1334840303,0,1,10876
29,3371,253,1334877964,1334879001,0,1,1037
29,3372,284,1334916241,1334916257,0,1,16
29,3373,284,1335000875,1335002008,0,2,1133
29,3373,253,1335002008,1335002324,0,2,316
29,3374,253,1335019900,1335022829,0,1,2929
29,3376,253,1335174767,1335188145,0,1,13378
29,3380,253,1335397244,1335403562,0,1,6318
29,3381,253,1335433714,1335453337,0,1,19623
29,3382,253,1335520958,1335521422,0,1,464
29,3384,253,1335600064,1335600683,0,1,619
29,3385,253,1335624784,1335624844,0,1,60
29,3387,5,1335686776,1335687081,0,2,305
29,3387,284,1335708050,1335708110,0,2,60
29,3389,253,1335917577,1335919411,0,1,1834
29,3390,253,1335951639,1335951931,0,1,292
29,3392,284,1336117109,1336117146,0,1,37
29,3393,284,1336144258,1336145865,0,1,1607
29,3394,284,1336195360,1336195732,0,1,372
29,3395,35,1336229256,1336232239,0,1,2983
29,3397,253,1336346879,1336348338,0,1,1459
29,3398,253,1336384349,1336393621,0,1,9272
29,3401,284,1336518823,1336519647,0,2,824
29,3401,253,1336519647,1336521979,0,2,2332
29,3402,253,1336562343,1336562458,0,2,115
29,3402,253,1336571640,1336574598,0,2,2958
29,3403,253,1336606419,1336607766,0,1,1347
29,3404,253,1336692215,1336693431,0,1,1216
29,3405,253,1336733433,1336734256,0,2,823
29,3405,428,1336734272,1336734332,0,2,60
29,3406,449,1336739886,1336742226,0,1,2340
29,3407,284,1336789101,1336790007,0,2,906
29,3407,5,1336790552,1336790656,0,2,104
29,3408,5,1336832402,1336834192,0,2,1790
29,3408,284,1336834192,1336835723,0,2,1531
29,3409,284,1336857047,1336858979,0,1,1932
29,3410,253,1336951529,1336952931,0,1,1402
29,3413,253,1337037994,1337039477,0,1,1483
29,3414,284,1337094862,1337094922,0,1,60
29,3416,253,1337125426,1337126687,0,1,1261
29,3417,253,1337166382,1337166832,0,1,450
29,3418,59,1337174307,1337178026,0,1,3719
29,3419,253,1337210710,1337211707,0,1,997
29,3420,253,1337247237,1337248958,0,2,1721
29,3420,651,1337248958,1337255501,0,2,6543
29,3423,253,1337395856,1337395916,0,1,60
29,3424,284,1337410552,1337414261,0,2,3709
29,3424,284,1337426259,1337427515,0,2,1256
29,3425,253,1337594334,1337610037,0,1,15703
29,3426,253,1337642728,1337643297,0,1,569
29,3429,253,1337815716,1337816926,0,1,1210
29,3430,253,1337852617,1337852677,0,1,60
29,3431,253,1337939723,1337939930,0,2,207
29,3431,253,1337939930,1337940188,0,2,258
29,3433,284,1338016416,1338017831,0,2,1415
29,3433,5,1338017831,1338017986,0,2,155
29,3436,253,1338162097,1338162571,0,1,474
29,3437,253,1338199401,1338208755,0,1,9354
29,3438,253,1338247911,1338248893,0,1,982
29,3439,253,1338290053,1338290620,0,1,567
29,3440,253,1338335135,1338335873,0,1,738
29,3444,253,1338547287,1338551582,0,1,4295
29,3446,35,1338707699,1338708608,0,2,909
29,3446,284,1338708608,1338708937,0,2,329
29,3447,253,1338765909,1338766945,0,1,1036
29,3448,253,1338804734,1338819306,0,1,14572
29,3449,253,1338853864,1338854625,0,1,761
29,3450,253,1338891757,1338891850,0,1,93
29,3451,253,1338991341,1338993763,0,1,2422
29,3452,253,1339025106,1339026328,0,1,1222
29,3455,284,1339168235,1339169472,0,1,1237
29,3461,253,1339371191,1339372300,0,1,1109
29,3462,253,1339407975,1339408035,0,1,60
29,3463,253,1339423245,1339426245,0,1,3000
29,3464,253,1339457086,1339458082,0,1,996
29,3465,253,1339498302,1339500519,0,1,2217
29,3466,253,1339546433,1339547399,0,1,966
29,3468,253,1339581020,1339581377,0,2,357
29,3468,253,1339587657,1339591197,0,2,3540
29,3469,253,1339629975,1339630771,0,1,796
29,3470,253,1339668248,1339668291,0,1,43
29,3471,253,1339756958,1339763641,0,2,6683
29,3471,253,1339763641,1339767209,0,2,3568
29,3472,284,1339900753,1339901611,0,2,858
29,3472,35,1339901611,1339902578,0,2,967
29,3473,35,1339940312,1339941595,0,1,1283
29,3474,253,1339976047,1339977250,0,1,1203
29,3475,253,1340012039,1340012253,0,1,214
29,3476,253,1340028109,1340032247,0,1,4138
29,3477,253,1340101862,1340101922,0,1,60
29,3478,253,1340235705,1340236893,0,1,1188
29,3479,253,1340272733,1340272749,0,2,16
29,3479,253,1340283651,1340285449,0,2,1798
29,3481,253,1340618666,1340618726,0,1,60
29,3482,253,1340753973,1340755122,0,1,1149
29,3483,253,1340793554,1340794814,0,2,1260
29,3483,260,1340794838,1340812114,0,2,17276
29,3486,253,1341221742,1341222862,0,1,1120
29,3488,253,1341309261,1341310117,0,2,856
29,3488,35,1341311107,1341312122,0,2,1015
29,3489,253,1341358288,1341359597,0,1,1309
29,3490,253,1341411757,1341411817,0,1,60
29,3493,253,1341485653,1341486065,0,2,412
29,3493,253,1341490178,1341494535,0,2,4357
29,3494,253,1341529787,1341530880,0,1,1093
29,3496,253,1341571054,1341578212,0,2,7158
29,3496,253,1341579350,1341582691,0,2,3341
29,3497,35,1341647151,1341647184,0,1,33
29,3498,284,1341673972,1341674264,0,2,292
29,3498,284,1341674283,1341676234,0,2,1951
29,3500,284,1341714275,1341716282,0,1,2007
29,3501,284,1341749136,1341751157,0,1,2021
29,3502,284,1341789098,1341789916,0,2,818
29,3502,253,1341789916,1341791429,0,2,1513
29,3503,253,1341828538,1341828598,0,1,60
29,3506,253,1341962746,1341964355,0,1,1609
29,3507,253,1342014015,1342018365,0,1,4350
29,3509,253,1342087099,1342101114,0,1,14015
29,3510,253,1342135505,1342136447,0,1,942
29,3511,253,1342176916,1342177196,0,1,280
29,3514,480,1342256670,1342256710,0,1,40
29,3516,284,1342357965,1342359447,0,1,1482
29,3519,651,1342519930,1342529579,0,1,9649
29,3522,253,1342655044,1342655789,0,1,745
29,3523,253,1342794539,1342794599,0,1,60
29,3526,253,1343123397,1343124146,0,1,749
29,3527,253,1343345000,1343346120,0,1,1120
29,3530,284,1343525599,1343526372,0,1,773
29,3531,284,1343548991,1343550403,0,1,1412
29,3532,253,1343604260,1343605441,0,1,1181
29,3533,253,1343648012,1343651786,0,1,3774
29,3536,284,1344208015,1344210066,0,1,2051
29,3537,253,1344252612,1344256342,0,1,3730
29,3539,253,1344514228,1344514288,0,1,60
29,3540,253,1344554419,1344555724,0,1,1305
29,3541,253,1344594644,1344598916,0,1,4272
29,3544,253,1344697205,1344697265,0,1,60
29,3545,284,1344751970,1344752571,0,3,601
29,3545,284,1344763880,1344766323,0,3,2443
29,3545,35,1344766323,1344766446,0,3,123
29,3550,253,1344986479,1344987418,0,1,939
29,3552,253,1345267250,1345275120,0,2,7870
29,3552,253,1345282085,1345284908,0,2,2823
29,3555,253,1345418646,1345419692,0,1,1046
29,3556,253,1345457846,1345460384,0,2,2538
29,3556,651,1345460384,1345473801,0,2,13417
29,3557,253,1346846830,1346850220,0,1,3390
29,3563,651,1347623806,1347629459,0,1,5653
29,3564,253,1347690521,1347701961,0,2,11440
29,3564,284,1347701961,1347702754,0,2,793
29,3565,35,1347710872,1347710887,0,2,15
29,3565,35,1347717937,1347717997,0,2,60
29,3567,253,1349997909,1349999557,0,1,1648
29,3568,253,1350040751,1350042182,0,1,1431
29,3570,284,1350114846,1350116294,0,1,1448
29,3572,253,1350390830,1350391730,0,1,900
29,3573,253,1350466927,1350467693,0,2,766
29,3573,651,1350468075,1350468135,0,2,60
29,3574,253,1350603436,1350604302,0,1,866
29,3576,253,1350898847,1350899136,0,3,289
29,3576,651,1350901854,1350910535,0,3,8681
29,3576,253,1350910535,1350910940,0,3,405
29,3578,253,1350986589,1350994826,0,1,8237
29,3579,253,1351034733,1351036033,0,1,1300
29,3581,253,1351085506,1351088339,0,1,2833
29,3583,253,1351161481,1351164639,0,1,3158
29,3584,253,1351207515,1351210650,0,1,3135
29,3587,284,1351301694,1351303000,0,1,1306
29,3589,284,1351342918,1351349264,0,1,6346
29,3590,253,1351375260,1351376107,0,1,847
29,3592,253,1351424349,1351427726,0,1,3377
29,3593,253,1351467690,1351467750,0,1,60
29,3594,253,1351503517,1351504557,0,2,1040
29,3594,651,1351504557,1351504617,0,2,60
29,3597,253,1351639505,1351639565,0,1,60
29,3601,253,1351763531,1351766190,0,2,2659
29,3601,651,1351766190,1351773520,0,2,7330
29,3603,253,1351848504,1351849717,0,3,1213
29,3603,284,1351849717,1351850683,0,3,966
29,3603,284,1351863624,1351865356,0,3,1732
29,3604,253,1352107825,1352108311,0,1,486
29,3607,284,1352204494,1352205322,0,1,828
29,3609,253,1352280996,1352282350,0,3,1354
29,3609,651,1352282350,1352295387,0,3,13037
29,3609,253,1352295387,1352296636,0,3,1249
29,3610,253,1352368958,1352377789,0,2,8831
29,3610,253,1352377789,1352378559,0,2,770
29,3611,253,1352456193,1352459430,0,1,3237
29,3613,253,1352617614,1352618184,0,1,570
29,3614,253,1352636110,1352638226,0,1,2116
29,3615,253,1352676471,1352677181,0,1,710
29,3616,253,1352713793,1352725269,0,1,11476
29,3617,253,1352762589,1352763599,0,1,1010
29,3618,253,1352806683,1352806970,0,1,287
29,3621,253,1353065330,1353067953,0,1,2623
29,3622,253,1353121649,1353122505,0,1,856
29,3623,284,1353140991,1353141898,0,1,907
29,3625,284,1353223093,1353225335,0,2,2242
29,3625,253,1353226009,1353233800,0,2,7791
29,3626,253,1353367335,1353369130,0,1,1795
29,3627,253,1353410742,1353413551,0,1,2809
29,3628,253,1353453893,1353454612,0,1,719
29,3630,253,1354663242,1354665919,0,1,2677
29,3631,253,1354708160,1354711204,0,1,3044
29,3633,253,1354790970,1354791905,0,2,935
29,3633,260,1354791905,1354792576,0,2,671
29,3639,35,1355096365,1355096542,0,2,177
29,3639,253,1355096542,1355096602,0,2,60
29,3642,35,1355219768,1355219828,0,1,60
29,3645,253,1355392798,1355402637,0,1,9839
29,3646,284,1355539652,1355539751,0,1,99
29,3647,284,1355581836,1355582878,0,1,1042
29,3649,253,1355644983,1355653864,0,2,8881
29,3649,253,1355657755,1355659777,0,2,2022
29,3651,253,1355787593,1355789061,0,1,1468
29,3654,253,1355908828,1355910364,0,2,1536
29,3654,651,1355913367,1355922097,0,2,8730
29,3656,253,1356046947,1356050752,0,1,3805
29,3657,253,1356099566,1356102923,0,1,3357
29,3663,651,1356606239,1356615243,0,2,9004
29,3663,253,1356615243,1356615303,0,2,60
29,3665,284,1356691799,1356693022,0,2,1223
29,3665,284,1356707175,1356707235,0,2,60
29,3666,284,1356755855,1356756595,0,2,740
29,3666,284,1356766648,1356766708,0,2,60
29,3667,284,1356778302,1356780386,0,2,2084
29,3667,284,1356787490,1356787550,0,2,60
29,3668,253,1356850370,1356851330,0,1,960
29,3669,253,1356877781,1356877841,0,1,60
29,3670,875,1356934932,1356936867,0,1,1935
29,3672,284,1357192459,1357195437,0,4,2978
29,3672,253,1357196750,1357207824,0,4,11074
29,3672,5,1357207824,1357209518,0,4,1694
29,3672,284,1357211312,1357212381,0,4,1069
29,3674,253,1357292192,1357292592,0,1,400
29,3675,5,1357379703,1357380791,0,2,1088
29,3675,5,1357384294,1357387767,0,2,3473
29,3676,284,1357397454,1357399276,0,1,1822
29,3677,284,1357445239,1357447031,0,4,1792
29,3677,428,1357447031,1357448252,0,4,1221
29,3677,428,1357465127,1357466337,0,4,1210
29,3677,284,1357466337,1357466816,0,4,479
29,3679,253,1357514868,1357514928,0,1,60
29,3680,253,1357551097,1357552563,0,3,1466
29,3680,651,1357552563,1357569796,0,3,17233
29,3680,253,1357569796,1357569856,0,3,60
29,3681,253,1357602199,1357603079,0,1,880
29,3683,253,1357687613,1357698239,0,1,10626
29,3684,651,1357728862,1357738309,0,2,9447
29,3684,253,1357738309,1357741105,0,2,2796
29,3686,253,1357811322,1357811382,0,1,60
29,3689,284,1357906198,1357906521,0,1,323
29,3690,253,1357975981,1357976041,0,1,60
29,3691,284,1357988832,1357989433,0,2,601
29,3691,284,1358003405,1358005445,0,2,2040
29,3692,253,1358079594,1358080049,0,1,455
29,3694,253,1358206775,1358207893,0,1,1118
29,3695,428,1358226759,1358231387,0,2,4628
29,3695,253,1358231387,1358245290,0,2,13903
29,3696,253,1358292312,1358293816,0,1,1504
29,3697,253,1358332241,1358332301,0,1,60
29,3698,253,1358380360,1358381731,0,1,1371
29,3699,651,1358423978,1358424038,0,1,60
29,3700,651,1358463404,1358465715,0,2,2311
29,3700,253,1358465715,1358466716,0,2,1001
29,3701,253,1358503482,1358503542,0,1,60
29,3703,253,1358763949,1358772489,0,2,8540
29,3703,253,1358772489,1358772549,0,2,60
29,3704,253,1358812606,1358813392,0,1,786
29,3705,253,1358847542,1358859861,0,1,12319
29,3707,253,1360573000,1360573068,0,2,68
29,3707,284,1360574872,1360575103,0,2,231
29,3710,253,1360679946,1360683217,0,1,3271
29,3712,253,1360753875,1360754922,0,2,1047
29,3712,651,1360754922,1360761100,0,2,6178
30,3714,253,1360834721,1360834781,0,1,60
30,3715,351,1334929811,1334930899,0,2,1088
30,3715,35,1334930899,1334931083,0,2,184
30,3716,765,1335095348,1335095851,0,3,503
30,3716,5,1335096754,1335096857,0,3,103
30,3716,11,1335096857,1335097300,0,3,443
30,3717,351,1335585656,1335585685,0,2,29
30,3717,35,1335587061,1335587121,0,2,60
30,3719,284,1335952406,1335952432,0,2,26
30,3719,351,1335954109,1335954125,0,2,16
30,3721,351,1336103711,1336104668,0,2,957
30,3721,35,1336104668,1336104709,0,2,41
30,3722,35,1336382528,1336384947,0,2,2419
30,3722,351,1336384947,1336385007,0,2,60
30,3724,35,1336803053,1336803932,0,1,879
30,3725,35,1336986758,1336988122,0,2,1364
30,3725,351,1336988122,1336988460,0,2,338
30,3726,35,1337245844,1337245865,0,3,21
30,3726,284,1337246564,1337247481,0,3,917
30,3726,351,1337247527,1337247587,0,3,60
30,3727,284,1337351173,1337351958,0,2,785
30,3727,351,1337351958,1337352018,0,2,60
30,3728,351,1337593034,1337593094,0,1,60
30,3729,35,1337679706,1337680356,0,4,650
30,3729,640,1337680356,1337689505,0,4,9149
30,3729,284,1337689505,1337690628,0,4,1123
30,3729,351,1337690685,1337690955,0,4,270
30,3730,284,1338004645,1338004705,0,1,60
30,3731,351,1338106145,1338107319,0,5,1174
30,3731,284,1338107319,1338108101,0,5,782
30,3731,640,1338108101,1338108359,0,5,258
30,3731,640,1338119015,1338120399,0,5,1384
30,3731,351,1338120399,1338120459,0,5,60
30,3732,35,1338544741,1338546211,0,2,1470
30,3732,351,1338546211,1338546271,0,2,60
30,3733,260,1338731375,1338731815,0,3,440
30,3733,21,1338731815,1338732982,0,3,1167
30,3733,351,1338733528,1338733588,0,3,60
30,3734,640,1339247994,1339248054,0,1,60
30,3735,11,1340012044,1340012153,0,1,109
30,3738,351,1341659560,1341660701,0,2,1141
30,3738,35,1341660701,1341660761,0,2,60
30,3739,351,1341723924,1341724836,0,3,912
30,3739,35,1341724836,1341741511,0,3,16675
30,3739,35,1341741978,1341742038,0,3,60
30,3741,351,1342339758,1342340602,0,3,844
30,3741,35,1342340602,1342340741,0,3,139
30,3741,35,1342352865,1342354261,0,3,1396
30,3743,35,1343539891,1343541412,0,2,1521
30,3743,104,1343541412,1343541472,0,2,60
30,3744,284,1343640155,1343640655,0,1,500
30,3745,351,1344247346,1344247406,0,1,60
30,3747,253,1344741156,1344741552,0,3,396
30,3747,428,1344741552,1344748655,0,3,7103
30,3747,21,1344748655,1344748715,0,3,60
30,3748,351,1344926704,1344927157,0,3,453
30,3748,284,1344927178,1344927440,0,3,262
30,3748,35,1344927440,1344927787,0,3,347
30,3750,253,1347631473,1347632393,0,1,920
30,3751,284,1347710598,1347711871,0,2,1273
30,3751,351,1347711871,1347711931,0,2,60
30,3754,351,1350119964,1350121086,0,3,1122
30,3754,284,1350121086,1350121497,0,3,411
30,3754,640,1350121497,1350121557,0,3,60
30,3756,35,1350949308,1350949368,0,1,60
30,3757,35,1350994453,1350995817,0,2,1364
30,3757,351,1350995817,1350995877,0,2,60
30,3758,35,1351070265,1351071569,0,2,1304
30,3758,351,1351071569,1351071629,0,2,60
30,3759,21,1351245090,1351252566,0,1,7476
30,3760,351,1351330168,1351331428,0,2,1260
30,3760,640,1351331428,1351331488,0,2,60
30,3761,351,1351410689,1351410749,0,1,60
30,3762,35,1351677384,1351677722,0,2,338
30,3762,640,1351677722,1351677782,0,2,60
30,3764,35,1352109624,1352109684,0,1,60
30,3766,35,1353128047,1353128107,0,1,60
30,3767,603,1353223581,1353223917,0,2,336
30,3767,35,1353223917,1353223977,0,2,60
30,3769,35,1353584623,1353584683,0,1,60
30,3770,35,1353653082,1353653142,0,1,60
30,3771,35,1353677338,1353677398,0,1,60
30,3772,351,1353712492,1353716074,0,1,3582
30,3774,351,1353885943,1353889810,0,1,3867
30,3775,35,1353917128,1353917188,0,1,60
30,3776,351,1354435569,1354437129,0,2,1560
30,3776,284,1354437129,1354437189,0,2,60
30,3777,351,1354614252,1354614312,0,1,60
30,3778,21,1354699796,1354699896,0,1,100
30,3779,35,1355480035,1355480095,0,1,60
30,3780,35,1355913234,1355913614,0,1,380
30,3781,351,1356873165,1356873225,0,1,60
30,3782,35,1357116044,1357116104,0,1,60
30,3783,284,1357640100,1357640801,0,2,701
30,3783,351,1357640801,1357640861,0,2,60
30,3784,35,1357722684,1357722744,0,1,60
30,3785,35,1357775321,1357775381,0,1,60
31,3787,35,1359105361,1359106056,0,1,695
31,3790,5,1334914459,1334914718,0,2,259
31,3790,21,1334914718,1334919581,0,2,4863
31,3791,71,1334991158,1334991344,0,3,186
31,3791,21,1334991344,1334991808,0,3,464
31,3791,11,1334991808,1334997711,0,3,5903
31,3792,11,1335061851,1335061911,0,1,60
31,3793,21,1335146251,1335148476,0,2,2225
31,3793,428,1335153851,1335153911,0,2,60
31,3794,428,1335249055,1335250673,0,3,1618
31,3794,21,1335250673,1335251144,0,3,471
31,3794,11,1335251144,1335252094,0,3,950
31,3795,21,1335423551,1335424179,0,2,628
31,3795,11,1335424179,1335427214,0,2,3035
31,3796,21,1335536939,1335536999,0,1,60
31,3804,11,1337074473,1337083504,0,1,9031
31,3807,11,1338092286,1338092346,0,1,60
31,3813,428,1339047851,1339050016,0,1,2165
31,3816,428,1340001849,1340001909,0,1,60
31,3822,21,1341579980,1341580040,0,1,60
31,3823,21,1342060760,1342060820,0,1,60
31,3833,11,1350975176,1350975236,0,1,60
31,3836,11,1351236587,1351236647,0,1,60
31,3838,428,1351765005,1351765065,0,1,60
31,3848,21,1355641735,1355641795,0,1,60
31,3853,428,1357607784,1357609218,0,1,1434
31,3858,59,1359257301,1359262469,0,1,5168
31,3859,428,1359615029,1359615089,0,1,60
31,3864,11,1360536496,1360538481,0,1,1985
31,3866,428,1360737688,1360738451,0,2,763
31,3866,11,1360739157,1360739217,0,2,60
32,3869,59,1336386795,1336386855,0,1,60
32,3870,59,1336555744,1336555804,0,1,60
32,3871,59,1336721387,1336721447,0,1,60
32,3873,59,1336987794,1336987854,0,1,60
32,3874,59,1337165315,1337165375,0,1,60
32,3875,59,1337253185,1337253245,0,1,60
32,3876,59,1337346890,1337346950,0,1,60
32,3880,59,1337957841,1337957901,0,1,60
32,3882,59,1338297269,1338297329,0,1,60
32,3883,59,1338903574,1338903634,0,1,60
32,3884,59,1339068170,1339068230,0,1,60
32,3885,59,1339161588,1339161648,0,1,60
32,3887,59,1339419495,1339419555,0,1,60
32,3888,59,1339503645,1339503705,0,1,60
32,3890,59,1339572990,1339573050,0,1,60
32,3891,59,1339768139,1339768199,0,1,60
32,3893,59,1340016181,1340016241,0,1,60
32,3894,59,1340285572,1340285632,0,1,60
32,3895,59,1340623823,1340623883,0,1,60
32,3896,59,1340788438,1340788498,0,1,60
32,3897,59,1341220784,1341220844,0,1,60
32,3898,59,1341307131,1341307191,0,1,60
32,3899,59,1341397001,1341397061,0,1,60
32,3900,59,1341492099,1341492159,0,1,60
32,3901,59,1341586039,1341586099,0,1,60
32,3904,59,1341833097,1341833157,0,1,60
32,3905,59,1341977151,1341977211,0,1,60
32,3906,59,1342175283,1342175343,0,1,60
32,3909,59,1342527588,1342527648,0,1,60
32,3910,59,1342796716,1342796776,0,1,60
32,3912,59,1344520193,1344520253,0,1,60
32,3913,59,1344611461,1344611521,0,1,60
32,3914,59,1344939790,1344939850,0,1,60
32,3915,59,1345467807,1345467867,0,1,60
32,3917,59,1347543709,1347543769,0,1,60
32,3919,59,1349962888,1349962948,0,1,60
32,3921,59,1350470682,1350470742,0,1,60
32,3923,59,1351083169,1351083229,0,1,60
32,3925,59,1351506976,1351507036,0,1,60
32,3926,59,1351664680,1351664740,0,1,60
32,3927,59,1351774166,1351774226,0,1,60
32,3928,59,1352117887,1352117947,0,1,60
32,3929,59,1352192908,1352192968,0,1,60
32,3931,59,1353493557,1353493617,0,1,60
32,3932,59,1353594026,1353594086,0,1,60
32,3935,59,1353932707,1353932767,0,1,60
32,3936,59,1354057767,1354057827,0,1,60
32,3937,59,1354609047,1354609107,0,1,60
32,3938,59,1354712558,1354712618,0,1,60
32,3945,1005,1355365812,1355370273,0,1,4461
32,3947,59,1355830638,1355830698,0,1,60
32,3948,59,1355910124,1355910184,0,1,60
32,3949,59,1356085320,1356085380,0,1,60
32,3950,8,1356168277,1356171001,0,1,2724
32,3953,59,1357562322,1357562382,0,1,60
32,3955,59,1357832114,1357832174,0,1,60
32,3958,59,1358510798,1358510858,0,1,60
32,3959,59,1358774061,1358774121,0,1,60
32,3961,59,1359467460,1359467520,0,1,60
32,3962,59,1359536640,1359540703,0,1,4063
32,3963,59,1359728393,1359728453,0,1,60
32,3964,59,1360056304,1360056364,0,1,60
32,3965,59,1360154943,1360155003,0,1,60
33,3966,59,1360763871,1360763931,0,1,60
33,3969,449,1339630287,1339632717,0,2,2430
33,3969,5,1339632717,1339632777,0,2,60
33,3970,449,1339759391,1339759451,0,1,60
33,3971,449,1339975775,1339978046,0,2,2271
33,3971,5,1339978046,1339978106,0,2,60
33,3972,5,1340022531,1340027976,0,2,5445
33,3972,449,1340027976,1340028036,0,2,60
33,3973,5,1340101283,1340101343,0,1,60
33,3974,71,1340236578,1340236638,0,1,60
33,3976,449,1340752464,1340752524,0,1,60
33,3977,449,1341110302,1341111740,0,1,1438
33,3978,5,1341311280,1341313611,0,2,2331
33,3978,449,1341313611,1341313671,0,2,60
33,3980,449,1341644299,1341646065,0,3,1766
33,3980,5,1341646065,1341648912,0,3,2847
33,3980,449,1341648912,1341649902,0,3,990
33,3981,5,1341792506,1341810752,0,1,18246
33,3982,449,1341875739,1341875799,0,1,60
33,3984,449,1342135425,1342135485,0,1,60
33,3985,5,1342614689,1342614749,0,1,60
33,3986,449,1342654054,1342654114,0,1,60
33,3987,449,1342827492,1342829926,0,2,2434
33,3987,5,1342829926,1342829986,0,2,60
33,3988,449,1343345089,1343345149,0,1,60
33,3989,5,1343455967,1343458451,0,1,2484
33,3990,5,1343607048,1343607108,0,1,60
33,3991,449,1344691768,1344691828,0,1,60
33,3993,449,1344900407,1344900467,0,1,60
33,3994,5,1345261499,1345261559,0,1,60
33,3995,260,1345295819,1345295879,0,1,60
33,3998,449,1345419074,1345419134,0,1,60
33,4000,449,1347675889,1347678470,0,1,2581
33,4001,449,1349998838,1350001050,0,2,2212
33,4001,5,1350001050,1350001110,0,2,60
33,4002,449,1350046568,1350046628,0,1,60
33,4004,8,1350382822,1350382882,0,1,60
33,4007,5,1350989353,1350989413,0,1,60
33,4008,449,1351086120,1351086180,0,1,60
33,4009,5,1351163873,1351163933,0,1,60
33,4010,5,1351303892,1351305382,0,1,1490
33,4012,449,1351638599,1351642289,0,3,3690
33,4012,875,1351649582,1351651596,0,3,2014
33,4012,5,1351651596,1351651656,0,3,60
33,4013,449,1351727256,1351729769,0,2,2513
33,4013,5,1351729769,1351729829,0,2,60
33,4014,449,1351813615,1351813675,0,1,60
33,4016,449,1352159802,1352161745,0,2,1943
33,4016,5,1352161745,1352161805,0,2,60
33,4018,449,1352627409,1352627469,0,1,60
33,4019,449,1352729072,1352729132,0,1,60
33,4020,5,1352802971,1352805347,0,1,2376
33,4021,449,1353022833,1353022893,0,1,60
33,4022,5,1353370826,1353371271,0,1,445
33,4023,5,1353831555,1353833459,0,2,1904
33,4023,449,1353833459,1353833519,0,2,60
33,4024,5,1353889254,1353889314,0,1,60
33,4027,5,1354494821,1354494881,0,1,60
33,4028,449,1354535802,1354535862,0,1,60
33,4030,449,1354665386,1354665446,0,1,60
33,4031,5,1354753187,1354753657,0,1,470
33,4032,449,1356602701,1356602761,0,1,60
33,4035,449,1357956608,1357958334,0,1,1726
33,4036,260,1358153690,1358153750,0,1,60
33,4038,5,1358860035,1358860272,0,1,237
33,4041,5,1359332398,1359332913,0,1,515
33,4046,449,1360068249,1360068309,0,1,60
33,4047,5,1360669363,1360671136,0,2,1773
33,4047,449,1360671136,1360671633,0,2,497
34,4052,253,1339227710,1339229457,0,1,1747
34,4056,35,1339919763,1339925345,0,1,5582
34,4107,253,1351777878,1351778788,0,1,910
34,4119,35,1357811244,1357811547,0,1,303
35,4121,651,1338768733,1338781560,0,1,12827
35,4132,651,1339234419,1339234902,0,1,483
35,4137,35,1339482621,1339482642,0,3,21
35,4137,480,1339482642,1339482692,0,3,50
35,4137,35,1339490146,1339491201,0,3,1055
35,4138,253,1339560526,1339561183,0,2,657
35,4138,253,1339564347,1339565664,0,2,1317
35,4140,651,1339632919,1339632949,0,2,30
35,4140,651,1339645831,1339645891,0,2,60
35,4141,5,1339647847,1339648369,0,1,522
35,4142,35,1339761908,1339762808,0,3,900
35,4142,253,1339762808,1339762829,0,3,21
35,4142,59,1339762829,1339764805,0,3,1976
35,4147,261,1340243410,1340243470,0,1,60
35,4148,5,1340256628,1340256923,0,2,295
35,4148,77,1340274900,1340274960,0,2,60
35,4149,77,1340619975,1340621019,0,1,1044
35,4150,651,1340756409,1340765461,0,2,9052
35,4150,5,1340767769,1340767829,0,2,60
35,4165,284,1341977287,1341979308,0,1,2021
35,4170,263,1342178970,1342186580,0,1,7610
35,4176,5,1343119274,1343128373,0,1,9099
35,4178,253,1346840200,1346841895,0,1,1695
35,4184,5,1350015560,1350015682,0,1,122
35,4191,603,1350972388,1350972570,0,3,182
35,4191,35,1350983447,1350984186,0,3,739
35,4191,253,1350984186,1350986270,0,3,2084
35,4196,640,1351215088,1351216240,0,2,1152
35,4196,284,1351226058,1351226118,0,2,60
35,4197,253,1351242914,1351243376,0,1,462
35,4200,5,1351468148,1351469207,0,2,1059
35,4200,5,1351482491,1351483671,0,2,1180
35,4201,297,1351492607,1351492643,0,1,36
35,4211,253,1352108797,1352113323,0,1,4526
35,4213,1,1352194827,1352195478,0,1,651
35,4215,77,1352288773,1352288795,0,1,22
35,4216,5,1352365236,1352366374,0,1,1138
35,4220,5,1352719132,1352720980,0,2,1848
35,4220,253,1352720980,1352721040,0,2,60
35,4222,5,1352783472,1352785232,0,1,1760
35,4223,603,1353058865,1353058905,0,2,40
35,4223,35,1353068414,1353070263,0,2,1849
35,4228,260,1353571142,1353572608,0,3,1466
35,4228,263,1353572608,1353581436,0,3,8828
35,4228,449,1353581436,1353583227,0,3,1791
35,4229,77,1353745878,1353748151,0,2,2273
35,4229,71,1353748151,1353748187,0,2,36
35,4231,253,1353914187,1353914247,0,1,60
35,4234,640,1354166298,1354166358,0,1,60
35,4241,77,1354789568,1354789628,0,1,60
35,4242,351,1354846625,1354855784,0,2,9159
35,4242,284,1354855784,1354857972,0,2,2188
35,4251,253,1355826538,1355826598,0,1,60
35,4255,253,1356084639,1356084699,0,1,60
35,4257,253,1356610228,1356610288,0,1,60
35,4262,253,1358419732,1358421446,0,1,1714
35,4267,59,1359330847,1359330864,0,2,17
35,4267,253,1359330864,1359337352,0,2,6488
35,4268,253,1359361227,1359361287,0,1,60
35,4274,261,1360037113,1360037173,0,1,60
35,4278,253,1360566198,1360567221,0,1,1023
36,4283,765,1333503463,1333503523,0,1,60
36,4285,11,1333618698,1333621191,0,1,2493
36,4287,253,1333881930,1333882541,0,1,611
36,4288,284,1334026529,1334026589,0,1,60
36,4289,35,1334114387,1334129426,0,1,15039
36,4290,284,1334232101,1334232161,0,1,60
36,4291,284,1334290970,1334291000,0,2,30
36,4291,35,1334305567,1334305627,0,2,60
36,4296,351,1334566766,1334567170,0,2,404
36,4296,351,1334567986,1334568046,0,2,60
36,4298,284,1334919741,1334919801,0,1,60
36,4299,253,1334968841,1334969692,0,1,851
36,4300,253,1335008976,1335009131,0,1,155
36,4301,253,1335054982,1335055429,0,1,447
36,4302,253,1335095993,1335096053,0,1,60
36,4303,284,1335142425,1335142449,0,1,24
36,4304,640,1335184827,1335184887,0,1,60
36,4305,35,1335247257,1335248339,0,1,1082
36,4306,35,1335532094,1335532154,0,1,60
36,4307,351,1335571122,1335572161,0,2,1039
36,4307,35,1335572161,1335572432,0,2,271
36,4308,35,1335612506,1335612566,0,1,60
36,4309,35,1335659638,1335659698,0,1,60
36,4310,284,1335704851,1335705945,0,2,1094
36,4310,351,1335705945,1335706005,0,2,60
36,4311,284,1335919216,1335919241,0,1,25
36,4312,651,1335941050,1335943170,0,4,2120
36,4312,651,1335943194,1335943871,0,4,677
36,4312,336,1335943871,1335943886,0,4,15
36,4312,253,1335950738,1335950798,0,4,60
36,4313,284,1336129321,1336129336,0,2,15
36,4313,351,1336142845,1336142905,0,2,60
36,4315,21,1336215495,1336216876,0,2,1381
36,4315,11,1336218464,1336218524,0,2,60
36,4316,11,1336264748,1336264808,0,1,60
36,4317,351,1336351640,1336351657,0,2,17
36,4317,284,1336351657,1336351690,0,2,33
36,4319,351,1336609980,1336610040,0,1,60
36,4320,351,1336696560,1336697290,0,2,730
36,4320,284,1336697307,1336698162,0,2,855
36,4321,284,1336736144,1336736204,0,1,60
36,4322,253,1336785073,1336786964,0,1,1891
36,4323,253,1336827293,1336827353,0,1,60
36,4324,253,1336873006,1336873072,0,1,66
36,4325,284,1336917151,1336917211,0,1,60
36,4326,284,1336984682,1336985728,0,1,1046
36,4327,35,1337034330,1337034345,0,1,15
36,4328,35,1337050584,1337050644,0,1,60
36,4329,284,1337162705,1337162729,0,1,24
36,4330,11,1337215442,1337216443,0,1,1001
36,4331,11,1337256504,1337256564,0,1,60
36,4335,253,1337945392,1337945991,0,3,599
36,4335,35,1337945991,1337946052,0,3,61
36,4335,35,1337951771,1337951831,0,3,60
36,4336,35,1337990020,1337991956,0,1,1936
36,4337,35,1338076429,1338076886,0,1,457
36,4338,284,1338123144,1338123204,0,1,60
36,4339,284,1338166304,1338166327,0,2,23
36,4339,253,1338181882,1338183067,0,2,1185
36,4340,263,1338197035,1338199107,0,3,2072
36,4340,263,1338200494,1338200509,0,3,15
36,4340,351,1338203558,1338203618,0,3,60
36,4341,253,1338253765,1338255045,0,1,1280
36,4342,284,1338300509,1338301401,0,2,892
36,4342,351,1338301401,1338301461,0,2,60
36,4343,284,1338364715,1338366659,0,1,1944
36,4344,253,1338558167,1338558227,0,1,60
36,4345,253,1338687417,1338687477,0,1,60
36,4346,284,1338727119,1338727179,0,1,60
36,4347,351,1338855607,1338856780,0,2,1173
36,4347,284,1338856780,1338856804,0,2,24
36,4348,2151,1338884367,1338884427,0,1,60
36,4349,35,1338906607,1338906667,0,1,60
36,4353,284,1339980610,1339980620,0,1,10
36,4357,253,1341108122,1341122676,0,1,14554
36,4358,284,1341214270,1341214297,0,1,27
36,4359,351,1341237829,1341237889,0,1,60
36,4360,284,1341448680,1341448740,0,1,60
36,4361,284,1341485627,1341485687,0,1,60
36,4362,284,1341535720,1341536492,0,1,772
36,4364,284,1341751287,1341751347,0,1,60
36,4368,284,1342008842,1342008902,0,1,60
36,4371,351,1342138892,1342139865,0,2,973
36,4371,284,1342139865,1342139879,0,2,14
36,4372,284,1342174907,1342185741,0,3,10834
36,4372,284,1342185741,1342185777,0,3,36
36,4372,351,1342185777,1342185837,0,3,60
36,4374,284,1342265470,1342266824,0,1,1354
36,4375,284,1342358201,1342358523,0,2,322
36,4375,284,1342358523,1342358583,0,2,60
36,4376,284,1342396362,1342396583,0,1,221
36,4378,284,1342536966,1342538481,0,1,1515
36,4382,284,1343563640,1343563700,0,1,60
36,4383,284,1343609573,1343609584,0,1,11
36,4384,284,1343643769,1343647166,0,1,3397
36,4385,351,1344212636,1344215005,0,1,2369
36,4386,284,1344253520,1344253580,0,1,60
36,4387,253,1344515344,1344515404,0,1,60
36,4389,253,1345167329,1345168385,0,1,1056
36,4390,11,1345241002,1345241736,0,2,734
36,4390,21,1345241736,1345241796,0,2,60
36,4391,21,1345379909,1345380334,0,3,425
36,4391,5,1345380404,1345381113,0,3,709
36,4391,11,1345381113,1345381173,0,3,60
36,4392,284,1345451417,1345451993,0,2,576
36,4392,284,1345464465,1345464525,0,2,60
36,4393,11,1346855072,1346855132,0,1,60
36,4394,284,1346909839,1346910881,0,2,1042
36,4394,351,1346910881,1346910941,0,2,60
36,4395,253,1347671624,1347671636,0,1,12
36,4396,253,1347707599,1347707659,0,1,60
36,4397,253,1347757490,1347757827,0,1,337
36,4398,253,1349701489,1349701549,0,1,60
36,4399,11,1350088293,1350088313,0,2,20
36,4399,5,1350088313,1350088373,0,2,60
36,4400,5,1350126353,1350127033,0,2,680
36,4400,11,1350127033,1350127093,0,2,60
36,4402,11,1351297410,1351298170,0,2,760
36,4402,651,1351298170,1351298230,0,2,60
37,4403,651,1351335468,1351335528,0,1,60
37,4404,77,1333506070,1333507547,0,2,1477
37,4404,77,1333524834,1333524894,0,2,60
37,4405,77,1334043264,1334045834,0,1,2570
37,4407,77,1334194081,1334198733,0,1,4652
37,4408,77,1334279966,1334287498,0,1,7532
37,4409,77,1334379366,1334379426,0,1,60
37,4410,77,1334573669,1334573729,0,1,60
37,4411,77,1334798627,1334798687,0,1,60
37,4412,77,1334893336,1334902085,0,1,8749
37,4413,77,1334972087,1334972365,0,2,278
37,4413,77,1334980769,1334981077,0,2,308
37,4416,77,1335930457,1335930517,0,1,60
37,4418,77,1336555124,1336555184,0,1,60
37,4419,77,1336797658,1336797718,0,1,60
37,4420,35,1336884724,1336890691,0,2,5967
37,4420,284,1336902684,1336902744,0,2,60
37,4421,77,1336980995,1336986810,0,1,5815
37,4423,77,1337219638,1337219698,0,1,60
37,4424,77,1337650787,1337650847,0,1,60
37,4425,35,1338010269,1338010780,0,1,511
37,4426,35,1338017858,1338019430,0,1,1572
37,4428,77,1338775664,1338775680,0,2,16
37,4428,253,1338776673,1338777404,0,2,731
37,4432,77,1339298310,1339298370,0,1,60
37,4433,77,1339471296,1339471356,0,1,60
37,4434,77,1339580490,1339580512,0,1,22
37,4436,77,1341640060,1341640120,0,1,60
37,4438,35,1342171647,1342171707,0,1,60
37,4439,35,1342790661,1342790721,0,1,60
37,4440,77,1343632738,1343639502,0,1,6764
37,4441,253,1344238200,1344238918,0,1,718
37,4442,35,1345258875,1345258935,0,1,60
37,4443,35,1345280918,1345283478,0,2,2560
37,4443,77,1345283478,1345283538,0,2,60
37,4444,11,1345470941,1345471630,0,2,689
37,4444,21,1345471630,1345472502,0,2,872
37,4445,35,1347713496,1347713556,0,1,60
37,4446,35,1347756474,1347756534,0,1,60
37,4447,35,1350478024,1350478084,0,1,60
37,4450,35,1351309794,1351309854,0,1,60
37,4451,35,1351342600,1351342660,0,1,60
37,4452,35,1351429697,1351429757,0,1,60
37,4453,253,1351497585,1351497920,0,1,335
37,4454,35,1352120290,1352120350,0,1,60
37,4455,35,1352724560,1352724620,0,1,60
37,4456,35,1353145182,1353146429,0,1,1247
37,4458,35,1353245258,1353245318,0,1,60
37,4459,651,1353570653,1353583538,0,2,12885
37,4459,21,1353583538,1353583598,0,2,60
37,4460,651,1353639341,1353639401,0,1,60
37,4462,21,1354927842,1354928648,0,1,806
37,4463,428,1354955456,1354955577,0,1,121
38,4473,5,1333719918,1333719958,0,2,40
38,4473,480,1333720466,1333723229,0,2,2763
38,4478,5,1335535610,1335537381,0,1,1771
38,4479,5,1335692469,1335692529,0,1,60
38,4483,35,1336606658,1336606718,0,1,60
38,4487,5,1337955693,1337956863,0,2,1170
38,4487,35,1337956863,1337956923,0,2,60
38,4490,5,1338810602,1338810662,0,1,60
38,4491,5,1338895805,1338895865,0,1,60
38,4492,5,1339062229,1339062289,0,1,60
38,4496,449,1341868755,1341869282,0,1,527
38,4497,5,1342094365,1342095393,0,2,1028
38,4497,35,1342095393,1342095453,0,2,60
38,4503,5,1343605639,1343605699,0,1,60
38,4504,5,1343643603,1343644518,0,2,915
38,4504,35,1343644518,1343644578,0,2,60
38,4505,5,1344235421,1344236683,0,2,1262
38,4505,297,1344236683,1344239712,0,2,3029
38,4507,5,1344817275,1344817335,0,1,60
38,4509,104,1345378323,1345378383,0,1,60
38,4511,260,1347714326,1347715028,0,1,702
38,4512,21,1349689867,1349689927,0,1,60
38,4513,260,1350021930,1350022502,0,3,572
38,4513,21,1350022502,1350023003,0,3,501
38,4513,5,1350024830,1350024890,0,3,60
38,4515,35,1350390659,1350390719,0,1,60
38,4517,5,1351079856,1351079916,0,1,60
38,4519,260,1351502093,1351502992,0,3,899
38,4519,21,1351502992,1351508928,0,3,5936
38,4519,5,1351508928,1351508988,0,3,60
38,4520,5,1351759718,1351759778,0,1,60
38,4524,5,1352281274,1352288967,0,2,7693
38,4524,35,1352288967,1352289027,0,2,60
38,4526,212,1352462808,1352462868,0,1,60
38,4527,35,1352603323,1352603383,0,1,60
38,4528,35,1352816346,1352816406,0,1,60
38,4532,35,1353418869,1353418929,0,1,60
38,4533,5,1353588412,1353588472,0,1,60
38,4535,5,1354011354,1354015835,0,2,4481
38,4535,8,1354017554,1354017614,0,2,60
38,4538,8,1354527311,1354527371,0,1,60
38,4548,21,1356605021,1356607551,0,1,2530
38,4550,5,1357256725,1357256785,0,1,60
38,4561,5,1359535271,1359535331,0,1,60
38,4565,5,1360058053,1360058113,0,1,60
38,4566,35,1360108831,1360108891,0,1,60
38,4569,5,1360749500,1360749560,0,1,60
39,4570,5,1360838882,1360838942,0,1,60
39,4644,640,1358758859,1358758872,0,1,13
40,4667,5,1333515446,1333516233,0,1,787
40,4670,35,1334823655,1334823663,0,1,8
40,4672,35,1335428246,1335429440,0,1,1194
40,4678,35,1336637531,1336637591,0,1,60
40,4683,5,1337682965,1337684813,0,1,1848
40,4686,35,1338971700,1338972024,0,2,324
40,4686,284,1338972375,1338975448,0,2,3073
40,4687,35,1339056817,1339057812,0,1,995
40,4688,35,1339662148,1339663412,0,1,1264
40,4689,5,1340267538,1340268057,0,1,519
40,4691,35,1341476983,1341477623,0,1,640
40,4692,449,1341565822,1341565882,0,2,60
40,4692,35,1341573912,1341573954,0,2,42
40,4696,253,1342339036,1342342023,0,1,2987
40,4703,253,1345277605,1345279381,0,1,1776
40,4706,253,1347689360,1347690624,0,1,1264
40,4708,35,1351241437,1351255949,0,2,14512
40,4708,603,1351255949,1351258033,0,2,2084
40,4709,253,1351760002,1351761136,0,1,1134
40,4712,253,1353565711,1353569716,0,1,4005
40,4715,35,1354702547,1354702607,0,1,60
40,4717,253,1356082097,1356082460,0,1,363
40,4718,284,1356602238,1356603489,0,1,1251
40,4720,71,1357905845,1357905905,0,1,60
40,4723,5,1359186874,1359186934,0,1,60
40,4726,253,1360229618,1360229913,0,1,295
40,4728,5,1360745386,1360746089,0,1,703
41,4729,253,1360834443,1360834503,0,1,60
41,4733,77,1333616183,1333616243,0,1,60
41,4736,77,1333924225,1333924608,0,1,383
41,4739,77,1334097273,1334098184,0,1,911
41,4740,77,1334134656,1334138364,0,1,3708
41,4741,77,1334183538,1334183797,0,1,259
41,4743,77,1334270113,1334270301,0,1,188
41,4746,77,1334448006,1334450131,0,1,2125
41,4751,77,1334788237,1334788691,0,1,454
41,4755,77,1335133889,1335134317,0,1,428
41,4756,77,1335169230,1335169251,0,1,21
41,4757,77,1335220556,1335220662,0,1,106
41,4758,263,1335256052,1335256073,0,1,21
41,4760,77,1335393148,1335393464,0,1,316
41,4766,77,1335935123,1335935137,0,1,14
41,4768,2151,1336190991,1336191030,0,1,39
41,4771,77,1336343716,1336343982,0,1,266
41,4773,77,1336429636,1336429934,0,2,298
41,4773,77,1336429934,1336429984,0,2,50
41,4774,77,1336516192,1336516698,0,1,506
41,4776,77,1336602399,1336603019,0,1,620
41,4778,77,1336689027,1336689489,0,1,462
41,4784,77,1336948545,1336948855,0,1,310
41,4790,77,1337121335,1337121558,0,1,223
41,4792,77,1337206902,1337207416,0,1,514
41,4797,77,1337399305,1337399336,0,1,31
41,4802,449,1337937197,1337937490,0,1,293
41,4812,77,1338503663,1338503983,0,1,320
42,4829,449,1339403900,1339403932,0,2,32
42,4829,449,1339415763,1339415777,0,2,14
42,4851,253,1334829758,1334829980,0,1,222
42,4852,5,1334899337,1334900828,0,2,1491
42,4852,8,1334900828,1334903355,0,2,2527
42,4864,104,1335528426,1335537070,0,1,8644
42,4867,253,1335654815,1335656162,0,2,1347
42,4867,35,1335663210,1335663671,0,2,461
42,4874,35,1336120976,1336121036,0,1,60
43,4882,5,1334310653,1334310713,0,1,60
43,4884,765,1335669995,1335670009,0,3,14
43,4884,260,1335670009,1335670932,0,3,923
43,4884,5,1335670932,1335675154,0,3,4222
43,4886,260,1336884265,1336885303,0,2,1038
43,4886,5,1336885303,1336891148,0,2,5845
43,4888,1005,1338102705,1338103849,0,2,1144
43,4888,5,1338103849,1338104142,0,2,293
43,4891,5,1338893144,1338893519,0,1,375
43,4892,5,1339293075,1339308925,0,1,15850
43,4894,5,1339909262,1339909478,0,3,216
43,4894,284,1339912615,1339917577,0,3,4962
43,4894,5,1339917577,1339917593,0,3,16
43,4896,260,1341095355,1341095384,0,2,29
43,4896,1005,1341095384,1341095444,0,2,60
43,4897,5,1342238944,1342239004,0,1,60
43,4900,5,1345259277,1345259337,0,1,60
43,4901,260,1347686179,1347686896,0,2,717
43,4901,5,1347686896,1347686956,0,2,60
43,4902,5,1347713588,1347713648,0,1,60
43,4903,5,1351245946,1351246006,0,1,60
43,4905,5,1351410182,1351410242,0,1,60
43,4906,5,1352513408,1352515728,0,1,2320
43,4907,5,1353578166,1353579211,0,1,1045
43,4908,1005,1353722619,1353722634,0,3,15
43,4908,260,1353722634,1353737529,0,3,14895
43,4908,5,1353737529,1353737955,0,3,426
43,4910,260,1354330580,1354331465,0,2,885
43,4910,5,1354331465,1354345744,0,2,14279
43,4913,5,1356084235,1356084295,0,1,60
43,4917,5,1356854898,1356857581,0,1,2683
43,4918,71,1357962249,1357962309,0,1,60
43,4920,1005,1359250536,1359251479,0,3,943
43,4920,5,1359251479,1359257825,0,3,6346
43,4920,8,1359257825,1359261930,0,3,4105
43,4921,1005,1359773479,1359780342,0,1,6863
43,4922,35,1360526069,1360526129,0,1,60
44,4923,253,1360748700,1360756942,0,3,8242
44,4923,5,1360758187,1360762645,0,3,4458
44,4923,5,1360762645,1360762705,0,3,60
44,4925,253,1333613996,1333614056,0,1,60
44,4926,71,1333867416,1333867476,0,1,60
44,4929,253,1334137796,1334137856,0,1,60
44,4937,449,1335074547,1335076437,0,1,1890
44,4940,253,1335257976,1335259891,0,1,1915
44,4944,253,1335594011,1335594071,0,1,60
44,4946,253,1335954691,1335956682,0,1,1991
44,4947,253,1336105793,1336106470,0,1,677
44,4954,253,1336812567,1336812857,0,1,290
44,4959,253,1337128727,1337140114,0,1,11387
44,4969,651,1341110073,1341110133,0,1,60
44,4978,253,1341991198,1341991258,0,1,60
44,4981,253,1342167915,1342167975,0,1,60
44,4982,253,1342243613,1342246489,0,1,2876
44,4984,253,1342510522,1342510582,0,1,60
44,4987,253,1343116871,1343116931,0,1,60
44,4988,253,1343551645,1343554176,0,1,2531
44,4994,336,1345278950,1345279010,0,1,60
45,5026,284,1341218201,1341220760,0,3,2559
45,5026,8,1341222469,1341223201,0,3,732
45,5026,5,1341223201,1341223261,0,3,60
45,5028,253,1341468604,1341468812,0,2,208
45,5028,8,1341476491,1341480911,0,2,4420
45,5031,5,1341750697,1341750873,0,2,176
45,5031,8,1341750873,1341752472,0,2,1599
45,5033,253,1341837146,1341837466,0,1,320
45,5034,8,1342075740,1342077820,0,2,2080
45,5034,5,1342077820,1342078117,0,2,297
45,5035,5,1342414365,1342414863,0,3,498
45,5035,8,1342418294,1342419340,0,3,1046
45,5035,1,1342420182,1342422704,0,3,2522
45,5036,1,1342438956,1342439016,0,1,60
45,5037,5,1342510538,1342511584,0,1,1046
45,5038,8,1343121511,1343122361,0,2,850
45,5038,5,1343122361,1343122421,0,2,60
45,5040,8,1344238181,1344240261,0,1,2080
45,5045,35,1344928523,1344929046,0,1,523
45,5048,253,1349690931,1349690991,0,1,60
45,5049,5,1350477258,1350477383,0,2,125
45,5049,8,1350477383,1350477443,0,2,60
45,5052,8,1351341789,1351341849,0,1,60
45,5056,5,1353134375,1353139731,0,1,5356
46,5060,651,1333970774,1333974035,0,1,3261
46,5061,651,1334017132,1334029142,0,1,12010
46,5063,71,1334152467,1334154359,0,1,1892
46,5064,651,1334186661,1334188553,0,1,1892
46,5065,651,1334227887,1334230908,0,1,3021
46,5067,651,1334574448,1334574508,0,1,60
46,5068,651,1334658481,1334658541,0,1,60
46,5070,651,1334791292,1334793830,0,1,2538
46,5071,253,1334919986,1334920046,0,1,60
46,5075,651,1335183990,1335185746,0,1,1756
46,5076,651,1335263065,1335264765,0,1,1700
46,5079,284,1335582845,1335583372,0,1,527
46,5086,651,1336350332,1336361180,0,1,10848
46,5087,651,1336385472,1336387669,0,1,2197
46,5089,651,1336558943,1336559003,0,1,60
46,5090,651,1336692028,1336692088,0,1,60
46,5094,651,1336954201,1336955404,0,1,1203
46,5095,651,1336986893,1336988341,0,1,1448
46,5096,651,1337127647,1337129057,0,1,1410
46,5099,651,1337259958,1337260018,0,1,60
46,5100,651,1337595901,1337599261,0,1,3360
46,5101,651,1337671235,1337671295,0,1,60
46,5102,651,1337941740,1337944796,0,1,3056
46,5103,284,1338003678,1338006851,0,1,3173
46,5106,651,1338250176,1338251588,0,1,1412
46,5107,651,1338288345,1338289969,0,1,1624
46,5108,651,1338337376,1338338468,0,1,1092
47,5111,253,1338003920,1338003980,0,1,60
47,5115,35,1338976839,1338976899,0,1,60
47,5117,35,1339502642,1339502863,0,1,221
47,5118,35,1339759212,1339759563,0,1,351
47,5119,35,1340012916,1340012976,0,1,60
47,5120,35,1340099387,1340099447,0,1,60
47,5121,297,1340271727,1340272742,0,3,1015
47,5121,263,1340272742,1340276297,0,3,3555
47,5121,263,1340276297,1340276357,0,3,60
47,5122,35,1340622594,1340622654,0,1,60
47,5123,35,1340753296,1340753356,0,1,60
47,5124,35,1340801315,1340801424,0,1,109
47,5125,35,1341225925,1341225985,0,1,60
47,5126,35,1341271479,1341271539,0,1,60
47,5127,35,1341309877,1341310288,0,1,411
47,5128,35,1341395522,1341396082,0,1,560
47,5129,35,1341444168,1341444228,0,1,60
47,5130,35,1341487000,1341487284,0,1,284
47,5132,35,1341569365,1341569425,0,1,60
47,5134,35,1341833865,1341833925,0,1,60
47,5135,35,1341962544,1341962604,0,1,60
47,5136,35,1342003546,1342003606,0,1,60
47,5137,35,1342091374,1342091434,0,1,60
47,5138,35,1342135367,1342135427,0,1,60
47,5139,35,1342176357,1342176417,0,1,60
47,5140,35,1342480953,1342481013,0,1,60
47,5141,35,1342960387,1342960447,0,1,60
47,5142,35,1343123309,1343123369,0,1,60
47,5143,35,1343604210,1343604270,0,1,60
47,5144,35,1344209473,1344209533,0,1,60
47,5145,35,1344250554,1344250614,0,1,60
47,5146,35,1344510563,1344510623,0,1,60
47,5147,35,1344595153,1344595213,0,1,60
47,5150,35,1344814110,1344814170,0,1,60
47,5151,35,1344900058,1344900118,0,1,60
47,5152,35,1344947931,1344947991,0,1,60
47,5153,35,1344986789,1344986849,0,1,60
47,5154,35,1345159275,1345159335,0,1,60
47,5155,35,1346887611,1346887671,0,1,60
47,5156,35,1347232858,1347232918,0,1,60
47,5157,35,1349997695,1349997755,0,1,60
47,5158,35,1350387781,1350387841,0,1,60
47,5159,35,1350603439,1350603499,0,1,60
47,5160,35,1351034568,1351034628,0,1,60
47,5161,35,1351121426,1351121486,0,1,60
47,5162,35,1351172217,1351172277,0,1,60
47,5163,35,1351207176,1351207236,0,1,60
47,5165,35,1351517240,1351517300,0,1,60
47,5166,35,1351597428,1351597488,0,1,60
47,5167,35,1352119839,1352119899,0,1,60
47,5169,35,1352206264,1352206324,0,1,60
47,5170,35,1352290574,1352290634,0,1,60
47,5171,35,1352461347,1352461407,0,1,60
47,5173,35,1352676160,1352688258,0,3,12098
47,5173,297,1352688351,1352689340,0,3,989
47,5173,263,1352689340,1352689400,0,3,60
47,5174,35,1352813202,1352813262,0,1,60
47,5175,35,1353367338,1353367398,0,1,60
47,5176,35,1353411772,1353411832,0,1,60
47,5177,35,1353453553,1353453613,0,1,60
47,5178,35,1353502778,1353502838,0,1,60
47,5179,35,1353583267,1353583327,0,1,60
47,5181,35,1353927096,1353927156,0,1,60
47,5182,35,1354144850,1354144910,0,1,60
47,5184,35,1354621373,1354621433,0,1,60
47,5185,35,1355095768,1355095828,0,1,60
47,5186,35,1355181745,1355181805,0,1,60
47,5187,35,1355404380,1355404440,0,1,60
47,5188,35,1355835577,1355835637,0,1,60
47,5189,35,1355873511,1355873571,0,1,60
47,5190,35,1355912332,1355912392,0,1,60
47,5191,35,1355976659,1355976719,0,1,60
47,5192,35,1356086286,1356086346,0,1,60
47,5194,35,1356606193,1356606253,0,1,60
47,5195,35,1356650908,1356650968,0,1,60
47,5196,35,1357343419,1357343479,0,1,60
47,5197,35,1357365973,1357366033,0,1,60
47,5198,35,1357558308,1357558368,0,1,60
47,5199,35,1357822237,1357822297,0,1,60
47,5202,35,1358250613,1358250673,0,1,60
47,5203,35,1358335970,1358336030,0,1,60
47,5204,35,1358424265,1358424325,0,1,60
47,5205,35,1358465354,1358465414,0,1,60
47,5206,35,1358505490,1358505550,0,1,60
47,5207,35,1358766977,1358767037,0,1,60
47,5208,35,1359092108,1359092168,0,1,60
47,5209,35,1359125817,1359125877,0,1,60
47,5210,35,1359159251,1359159311,0,1,60
47,5211,35,1359182232,1359182292,0,1,60
47,5212,35,1359329345,1359329405,0,1,60
47,5213,35,1359375013,1359375073,0,1,60
47,5214,35,1359548161,1359548221,0,1,60
47,5215,35,1359641769,1359641829,0,1,60
47,5216,35,1360193777,1360193837,0,1,60
47,5217,35,1360247047,1360247107,0,1,60
47,5218,35,1360279626,1360279686,0,1,60
47,5219,35,1360625375,1360625435,0,1,60
47,5220,35,1360711722,1360711782,0,1,60
48,5221,35,1360842235,1360842295,0,1,60
48,5244,35,1335579982,1335584260,0,1,4278
48,5272,480,1338007415,1338007475,0,1,60
48,5283,35,1338723061,1338724069,0,2,1008
48,5283,480,1338724069,1338729143,0,2,5074
48,5302,253,1340723490,1340726257,0,1,2767
48,5322,21,1342108959,1342110565,0,1,1606
48,5324,35,1342249263,1342249488,0,1,225
48,5349,480,1344770200,1344770886,0,1,686
48,5355,480,1345288493,1345289202,0,1,709
48,5360,480,1346856789,1346857976,0,1,1187
48,5366,5,1347714064,1347714856,0,1,792
48,5369,253,1350037321,1350041915,0,1,4594
48,5382,5,1351314395,1351314555,0,2,160
48,5382,5,1351331177,1351332078,0,2,901
48,5383,5,1351418067,1351418320,0,1,253
48,5392,253,1352111445,1352122767,0,1,11322
48,5408,480,1353152024,1353152084,0,1,60
48,5410,5,1353219999,1353220492,0,2,493
48,5410,5,1353233026,1353233086,0,2,60
48,5415,5,1353550218,1353550519,0,2,301
48,5415,8,1353550519,1353554963,0,2,4444
48,5424,253,1354014360,1354016663,0,1,2303
48,5426,253,1354346269,1354348221,0,1,1952
48,5427,480,1354360325,1354361022,0,1,697
48,5440,253,1355050774,1355052771,0,1,1997
48,5441,8,1355103527,1355116377,0,1,12850
48,5443,35,1355199427,1355203675,0,1,4248
48,5449,480,1355575634,1355575694,0,1,60
48,5451,5,1355655333,1355656137,0,1,804
48,5453,35,1355827242,1355827310,0,1,68
48,5454,35,1355901177,1355902148,0,1,971
48,5458,35,1356252434,1356253599,0,2,1165
48,5458,5,1356263614,1356264621,0,2,1007
48,5461,5,1356772505,1356773009,0,2,504
48,5461,5,1356785623,1356786582,0,2,959
48,5463,5,1356927949,1356930419,0,2,2470
48,5463,5,1356949495,1356949555,0,2,60
48,5465,284,1357206904,1357208658,0,1,1754
48,5466,480,1357277102,1357277789,0,2,687
48,5466,480,1357293121,1357293181,0,2,60
48,5467,5,1357388778,1357389642,0,1,864
48,5468,480,1357470764,1357470824,0,1,60
48,5472,21,1357815293,1357815353,0,1,60
48,5473,5,1357865175,1357865235,0,1,60
48,5478,35,1358407252,1358407312,0,1,60
48,5480,35,1358503739,1358504531,0,1,792
48,5481,480,1358757594,1358758180,0,1,586
48,5485,5,1359283848,1359284574,0,1,726
49,5515,765,1333725425,1333725485,0,1,60
49,5517,77,1333845215,1333852545,0,2,7330
49,5517,104,1333852654,1333853307,0,2,653
49,5518,104,1333868196,1333869216,0,1,1020
49,5519,77,1334362862,1334365540,0,3,2678
49,5519,104,1334365703,1334373980,0,3,8277
49,5519,104,1334378145,1334379520,0,3,1375
49,5521,253,1334464295,1334464624,0,1,329
49,5522,104,1335074595,1335074805,0,1,210
49,5523,104,1335090419,1335090616,0,1,197
49,5524,35,1335617771,1335617794,0,2,23
49,5524,104,1335619128,1335619594,0,2,466
49,5525,21,1335659462,1335659940,0,1,478
49,5526,5,1335692249,1335692283,0,4,34
49,5526,8,1335692283,1335699379,0,4,7096
49,5526,5,1335699379,1335699534,0,4,155
49,5526,35,1335700915,1335700975,0,4,60
49,5527,21,1336194631,1336194653,0,4,22
49,5527,212,1336197211,1336198564,0,4,1353
49,5527,212,1336198564,1336200722,0,4,2158
49,5527,212,1336211159,1336212827,0,4,1668
49,5529,71,1336795790,1336800016,0,2,4226
49,5529,71,1336814852,1336815605,0,2,753
49,5530,284,1336830740,1336832642,0,1,1902
49,5531,284,1336877052,1336877112,0,1,60
49,5532,35,1337404463,1337407337,0,3,2874
49,5532,35,1337419647,1337419657,0,3,10
49,5532,104,1337421379,1337421978,0,3,599
49,5534,35,1338007368,1338008891,0,1,1523
49,5535,5,1338078183,1338088456,0,1,10273
49,5536,8,1338100388,1338105874,0,4,5486
49,5536,5,1338105874,1338108796,0,4,2922
49,5536,35,1338108796,1338111149,0,4,2353
49,5536,35,1338118294,1338118354,0,4,60
49,5539,71,1339220475,1339220566,0,2,91
49,5539,765,1339220566,1339221725,0,2,1159
49,5542,253,1339921016,1339926192,0,2,5176
49,5542,253,1339926192,1339926267,0,2,75
49,5543,449,1341233608,1341233668,0,1,60
49,5545,875,1341628832,1341630419,0,2,1587
49,5545,253,1341648397,1341648457,0,2,60
49,5546,71,1342236923,1342238082,0,1,1159
49,5547,59,1342412649,1342412657,0,4,8
49,5547,253,1342412657,1342413441,0,4,784
49,5547,104,1342414456,1342414601,0,4,145
49,5547,104,1342423943,1342424910,0,4,967
49,5548,104,1342443629,1342444986,0,3,1357
49,5548,253,1342445711,1342445755,0,3,44
49,5548,59,1342445755,1342445815,0,3,60
49,5550,21,1344598670,1344598730,0,1,60
49,5552,297,1344777769,1344777829,0,1,60
49,5553,59,1345261773,1345262542,0,1,769
49,5555,104,1347716081,1347717177,0,2,1096
49,5555,77,1347718634,1347718694,0,2,60
49,5556,59,1350035834,1350037087,0,3,1253
49,5556,104,1350037943,1350038310,0,3,367
49,5556,104,1350051662,1350052051,0,3,389
49,5557,5,1350106906,1350109962,0,1,3056
49,5560,59,1353650991,1353653256,0,1,2265
49,5561,104,1353756462,1353757095,0,1,633
49,5568,253,1357289067,1357294404,0,2,5337
49,5568,253,1357307855,1357307915,0,2,60
49,5569,35,1357998734,1357998794,0,1,60
49,5570,104,1358066802,1358068940,0,1,2138
49,5571,765,1358090315,1358090375,0,1,60
49,5572,35,1359163260,1359163320,0,1,60
50,5574,21,1359854713,1359860879,0,1,6166
50,5597,5,1335003742,1335014747,0,1,11005
50,5637,212,1338083664,1338085839,0,2,2175
50,5637,104,1338097282,1338099213,0,2,1931
50,5647,11,1338865317,1338865949,0,1,632
50,5666,1,1341285289,1341285349,0,1,60
50,5765,77,1357371354,1357371414,0,1,60
50,5786,21,1360803900,1360808505,0,1,4605
51,5793,71,1334221803,1334221837,0,1,34
51,5802,35,1334998157,1334999057,0,1,900
51,5803,35,1335067345,1335068535,0,1,1190
51,5811,35,1335599654,1335600043,0,1,389
51,5817,35,1336783723,1336785849,0,1,2126
51,5822,5,1337183027,1337183087,0,1,60
51,5824,284,1337247016,1337249330,0,1,2314
51,5832,336,1338183623,1338183848,0,1,225
51,5854,35,1340788535,1340789282,0,1,747
51,5862,5,1341645118,1341646135,0,1,1017
51,5865,5,1342015774,1342015834,0,1,60
51,5874,480,1343533975,1343534800,0,3,825
51,5874,35,1343534800,1343534822,0,3,22
51,5874,351,1343549947,1343553017,0,3,3070
51,5876,260,1344245199,1344245221,0,2,22
51,5876,1005,1344245221,1344246423,0,2,1202
51,5886,11,1347768831,1347768891,0,1,60
51,5888,351,1350118135,1350118563,0,1,428
51,5892,336,1351070943,1351071291,0,1,348
51,5908,603,1353490281,1353490341,0,1,60
51,5912,253,1353818426,1353819210,0,1,784
51,5926,28,1354952440,1354970952,0,1,18512
51,5939,11,1356600770,1356600788,0,1,18
51,5946,11,1357722875,1357722979,0,1,104
51,5948,5,1357817766,1357817826,0,1,60
51,5955,35,1358241030,1358242157,0,1,1127
51,5963,260,1359173853,1359173913,0,1,60
51,5971,11,1359710261,1359710280,0,1,19
52,5977,1005,1333537514,1333537574,0,1,60
52,5978,1005,1333718124,1333718184,0,1,60
52,5979,1005,1333974413,1333974473,0,1,60
52,5982,1005,1334233052,1334233112,0,1,60
52,5983,1005,1334327746,1334327806,0,1,60
52,5984,1005,1334582341,1334582401,0,1,60
52,5986,1005,1334842123,1334842183,0,1,60
52,5987,1005,1334928365,1334929412,0,1,1047
52,5988,1005,1335186009,1335186647,0,1,638
52,5989,1005,1335267380,1335267440,0,1,60
52,5991,1005,1335450010,1335450070,0,1,60
52,5992,1005,1335533378,1335533438,0,1,60
52,5999,1005,1336391209,1336391269,0,1,60
52,6000,1005,1336477825,1336478465,0,1,640
52,6001,1005,1336568507,1336568567,0,1,60
52,6002,1005,1336739337,1336740474,0,1,1137
52,6003,1005,1336994405,1336994465,0,1,60
52,6004,1005,1337081975,1337082035,0,1,60
52,6006,1005,1337349210,1337349270,0,1,60
52,6007,1005,1337599505,1337599565,0,1,60
52,6008,1005,1337684264,1337685354,0,1,1090
52,6010,261,1337960478,1337960538,0,1,60
52,6011,1005,1338207779,1338207839,0,1,60
52,6012,1005,1338297943,1338298003,0,1,60
52,6013,1005,1338554574,1338554634,0,1,60
52,6015,1005,1338807694,1338807754,0,1,60
52,6016,1005,1338898810,1338898870,0,1,60
52,6017,1005,1338976692,1338976752,0,1,60
52,6018,1005,1339070931,1339070991,0,1,60
52,6019,1005,1339153420,1339153480,0,1,60
52,6021,1005,1340100182,1340100242,0,1,60
52,6022,1005,1340276763,1340276823,0,1,60
52,6023,1005,1340626120,1340626180,0,1,60
52,6024,1005,1340792183,1340792243,0,1,60
52,6025,1005,1341228922,1341228982,0,1,60
52,6026,1005,1341374668,1341374728,0,1,60
52,6027,1005,1341570656,1341570716,0,1,60
52,6029,1005,1341651031,1341652690,0,1,1659
52,6031,1005,1341842510,1341842570,0,1,60
52,6034,1005,1342064642,1342064702,0,1,60
52,6035,1005,1342182506,1342182566,0,1,60
52,6037,5,1342360104,1342361435,0,2,1331
52,6037,1005,1342361435,1342361495,0,2,60
52,6038,1005,1342532201,1342532261,0,1,60
52,6039,1005,1342792476,1342792536,0,1,60
52,6045,1005,1344510293,1344510353,0,1,60
52,6047,1005,1344941280,1344943307,0,1,2027
52,6048,1005,1345459720,1345459780,0,1,60
52,6049,1005,1346849269,1346849329,0,1,60
52,6050,1005,1347532671,1347533742,0,1,1071
52,6052,1005,1349697782,1349698505,0,1,723
52,6053,1005,1350040119,1350040179,0,1,60
52,6058,1005,1350989045,1350989105,0,1,60
52,6059,1005,1351074642,1351074702,0,1,60
52,6065,1005,1351513629,1351513689,0,1,60
52,6066,1005,1351679726,1351679786,0,1,60
52,6067,1005,1351765033,1351765093,0,1,60
52,6070,1005,1352111610,1352111670,0,1,60
52,6072,1005,1352284729,1352285458,0,1,729
52,6073,1005,1352370244,1352370304,0,1,60
52,6077,1005,1352719539,1352719599,0,1,60
52,6078,1005,1352804109,1352804169,0,1,60
52,6080,261,1353152557,1353152617,0,1,60
52,6081,1005,1353200792,1353204274,0,1,3482
52,6083,1005,1353500352,1353501026,0,1,674
52,6084,1005,1353585235,1353585295,0,1,60
52,6089,1005,1354014357,1354014417,0,1,60
52,6094,1005,1354617928,1354617988,0,1,60
52,6095,1005,1354702841,1354715356,0,1,12515
52,6096,1005,1354790242,1354790302,0,1,60
52,6097,1005,1354878601,1354879230,0,1,629
52,6098,1005,1354957219,1354957992,0,1,773
52,6100,1005,1355495546,1355496544,0,1,998
52,6101,1005,1355629863,1355634036,0,1,4173
52,6102,1005,1355659432,1355659807,0,1,375
52,6104,1005,1355832486,1355832546,0,1,60
52,6105,1005,1355912561,1355912621,0,1,60
52,6115,1005,1357641918,1357641978,0,1,60
52,6117,1005,1357817175,1357817235,0,1,60
52,6118,1005,1357900758,1357900818,0,1,60
52,6121,1005,1358247987,1358248047,0,1,60
52,6123,1005,1358422165,1358422225,0,1,60
52,6124,1005,1358506175,1358506235,0,1,60
52,6127,1005,1359024042,1359025637,0,1,1595
52,6130,1005,1359372005,1359372065,0,1,60
52,6131,1005,1359457297,1359457357,0,1,60
52,6132,1005,1359541546,1359541606,0,1,60
52,6133,1005,1359629303,1359629363,0,1,60
52,6136,1005,1359856961,1359858318,0,1,1357
52,6137,1005,1359888561,1359889199,0,1,638
52,6138,1005,1359974816,1359974876,0,1,60
52,6139,1005,1360060498,1360060558,0,1,60
52,6141,1005,1360151909,1360151969,0,1,60
52,6143,1005,1360234170,1360234230,0,1,60
52,6144,1005,1360321243,1360321303,0,1,60
52,6146,1005,1360751043,1360751103,0,1,60
53,6147,1005,1360840338,1360840398,0,1,60
53,6148,253,1333495533,1333495593,0,1,60
53,6149,35,1333928644,1333928704,0,1,60
53,6153,28,1334228583,1334228643,0,1,60
53,6156,28,1334574943,1334575003,0,1,60
53,6157,253,1334654905,1334654965,0,1,60
53,6163,35,1335226659,1335226719,0,1,60
53,6166,28,1335525560,1335525620,0,1,60
53,6167,71,1335593662,1335596422,0,1,2760
53,6174,35,1336780659,1336780719,0,1,60
53,6182,284,1338014006,1338014066,0,1,60
53,6184,28,1338285553,1338285613,0,1,60
53,6185,253,1338356248,1338356308,0,1,60
53,6197,253,1339542186,1339542246,0,1,60
53,6200,28,1340098199,1340098259,0,1,60
53,6214,253,1342160634,1342160694,0,1,60
53,6231,263,1351327269,1351327329,0,1,60
54,6235,71,1356872810,1356872870,0,1,60
54,6249,2151,1334908056,1334908116,0,1,60
54,6280,2151,1343571045,1343571105,0,1,60
54,6296,35,1359616534,1359617209,0,1,675
55,6303,260,1336519568,1336520911,0,2,1343
55,6303,71,1336520911,1336522627,0,2,1716
55,6304,71,1336607533,1336607593,0,1,60
55,6305,428,1336692955,1336694822,0,1,1867
55,6306,71,1336729245,1336729314,0,1,69
55,6307,253,1336988035,1336989106,0,2,1071
55,6307,260,1336989106,1336989166,0,2,60
55,6309,449,1337936803,1337936863,0,1,60
55,6311,35,1338198120,1338198540,0,2,420
55,6311,260,1338205765,1338205825,0,2,60
55,6313,71,1338803104,1338803538,0,1,434
55,6314,449,1338860547,1338866697,0,2,6150
55,6314,449,1338866697,1338869281,0,2,2584
55,6315,480,1338887915,1338893314,0,2,5399
55,6315,21,1338893531,1338893591,0,2,60
55,6316,35,1339202124,1339203313,0,3,1189
55,6316,603,1339203313,1339203325,0,3,12
55,6316,35,1339214893,1339214953,0,3,60
55,6318,77,1339543713,1339543913,0,1,200
55,6321,260,1340017702,1340017762,0,1,60
55,6322,480,1340272938,1340272998,0,1,60
55,6323,5,1340277291,1340278062,0,2,771
55,6323,21,1340278062,1340278122,0,2,60
55,6324,35,1340617018,1340623831,0,1,6813
55,6325,428,1346848717,1346849151,0,2,434
55,6325,260,1346849151,1346849211,0,2,60
55,6326,260,1350380918,1350380978,0,1,60
55,6327,260,1350468582,1350468642,0,1,60
55,6328,260,1350949305,1350949757,0,2,452
55,6328,297,1350949757,1350949817,0,2,60
55,6329,260,1351003141,1351003201,0,1,60
55,6332,260,1351244320,1351244380,0,1,60
55,6333,260,1351385110,1351385748,0,1,638
55,6335,260,1351500994,1351501054,0,1,60
55,6336,35,1351670150,1351670210,0,1,60
55,6338,260,1351762531,1351762591,0,1,60
55,6339,253,1352108527,1352109529,0,3,1002
55,6339,253,1352118442,1352120330,0,3,1888
55,6339,260,1352120330,1352120390,0,3,60
55,6341,260,1352455092,1352455152,0,1,60
55,6346,260,1353385270,1353385330,0,1,60
55,6348,260,1353492739,1353492799,0,1,60
55,6350,71,1353580778,1353592866,0,1,12088
55,6355,260,1354114656,1354114716,0,1,60
55,6357,260,1354531769,1354531829,0,1,60
55,6359,260,1354617232,1354617292,0,1,60
55,6360,35,1354665151,1354666956,0,2,1805
55,6360,603,1354680657,1354681047,0,2,390
55,6362,35,1354800717,1354800777,0,1,60
55,6365,35,1355219133,1355219993,0,4,860
55,6365,480,1355219993,1355220408,0,4,415
55,6365,480,1355226919,1355227286,0,4,367
55,6365,21,1355227286,1355227346,0,4,60
55,6368,260,1355738760,1355738820,0,1,60
55,6370,21,1356084878,1356084938,0,1,60
55,6372,35,1356685871,1356685931,0,1,60
55,6378,21,1357729171,1357729231,0,1,60
55,6382,260,1358220083,1358220143,0,1,60
55,6388,260,1358848796,1358848856,0,1,60
55,6389,253,1359023503,1359023563,0,1,60
55,6393,260,1359505818,1359508320,0,1,2502
55,6394,651,1359613148,1359613358,0,3,210
55,6394,71,1359613358,1359614034,0,3,676
55,6394,260,1359624190,1359624250,0,3,60
55,6395,253,1359711163,1359711959,0,2,796
55,6395,35,1359712884,1359712944,0,2,60
55,6396,35,1359729057,1359729117,0,1,60
55,6397,253,1359973080,1359973140,0,1,60
55,6398,260,1360058745,1360058805,0,1,60
55,6399,253,1360146180,1360146240,0,1,60
55,6400,253,1360193934,1360202417,0,1,8483
55,6401,260,1360222674,1360223215,0,2,541
55,6401,260,1360228740,1360228800,0,2,60
56,6407,260,1360836238,1360836298,0,1,60
56,6408,21,1333534901,1333534961,0,1,60
56,6409,21,1333621601,1333621661,0,1,60
56,6411,21,1334051308,1334051368,0,1,60
56,6413,21,1334226646,1334226706,0,1,60
56,6415,21,1334492098,1334492158,0,1,60
56,6416,71,1334567655,1334567715,0,1,60
56,6417,21,1334656691,1334656751,0,1,60
56,6421,71,1335132173,1335132886,0,2,713
56,6421,71,1335152444,1335152504,0,2,60
56,6422,21,1335363442,1335363502,0,1,60
56,6423,21,1335432150,1335432210,0,1,60
56,6424,21,1335536196,1335536256,0,1,60
56,6425,21,1336388967,1336389027,0,1,60
56,6426,21,1336571618,1336571678,0,1,60
56,6427,77,1336734400,1336734460,0,1,60
56,6428,71,1336950033,1336950624,0,1,591
56,6429,21,1336987235,1336987295,0,1,60
56,6430,21,1337075642,1337075702,0,1,60
56,6431,21,1337214385,1337214445,0,1,60
56,6433,21,1337609713,1337609773,0,1,60
56,6434,21,1337692226,1337692286,0,1,60
56,6438,21,1338209056,1338209116,0,1,60
56,6439,21,1338469926,1338469986,0,1,60
56,6440,21,1338555108,1338555168,0,1,60
56,6441,21,1338808866,1338808926,0,1,60
56,6442,21,1338895494,1338895554,0,1,60
56,6443,21,1338982832,1338982892,0,1,60
56,6444,21,1339067465,1339067525,0,1,60
56,6445,21,1339160997,1339161057,0,1,60
56,6446,21,1339584899,1339584959,0,1,60
56,6448,21,1339762693,1339762753,0,1,60
56,6449,71,1339892152,1339892774,0,1,622
56,6450,21,1339935097,1339935157,0,1,60
56,6451,21,1340028486,1340028546,0,1,60
56,6452,21,1340098351,1340098411,0,1,60
56,6453,21,1340273556,1340273616,0,1,60
56,6454,21,1341236944,1341237004,0,1,60
56,6456,21,1341413311,1341413371,0,1,60
56,6457,21,1341498228,1341498288,0,1,60
56,6458,21,1341584493,1341584553,0,1,60
56,6459,21,1341834266,1341834326,0,1,60
56,6460,21,1342000808,1342000868,0,1,60
56,6461,21,1342092550,1342092610,0,1,60
56,6462,21,1342571032,1342571092,0,1,60
56,6464,21,1343134389,1343134449,0,1,60
56,6465,21,1343599553,1343600289,0,1,736
56,6466,21,1343645792,1343645852,0,1,60
56,6467,21,1344256537,1344256597,0,1,60
56,6468,21,1344514353,1344514413,0,1,60
56,6469,21,1344549926,1344549986,0,1,60
56,6470,21,1344592131,1344592191,0,1,60
56,6471,21,1344942578,1344942638,0,1,60
56,6472,21,1347539240,1347539300,0,1,60
56,6473,21,1349695982,1349696042,0,1,60
56,6474,21,1350393729,1350393789,0,1,60
56,6475,21,1350480342,1350480402,0,1,60
56,6476,21,1350653077,1350653137,0,1,60
56,6477,21,1351173984,1351174044,0,1,60
56,6478,21,1351254939,1351254999,0,1,60
56,6480,21,1351342384,1351342444,0,1,60
56,6481,21,1351606418,1351606478,0,1,60
56,6482,21,1352201631,1352201691,0,1,60
56,6483,21,1352290724,1352290784,0,1,60
56,6484,21,1352457637,1352457697,0,1,60
56,6485,253,1352513094,1352513154,0,1,60
56,6486,21,1352801112,1352801172,0,1,60
56,6487,71,1353226427,1353226487,0,1,60
56,6490,71,1353596276,1353596336,0,1,60
56,6491,21,1354110774,1354110834,0,1,60
56,6492,21,1354541066,1354541126,0,1,60
56,6493,21,1354800253,1354800313,0,1,60
56,6494,21,1354887433,1354887493,0,1,60
56,6496,21,1355405268,1355405328,0,1,60
56,6497,21,1355497146,1355497206,0,1,60
56,6501,21,1355923818,1355923878,0,1,60
56,6502,21,1356099975,1356100035,0,1,60
56,6503,21,1356701352,1356701412,0,1,60
56,6504,21,1357300446,1357300506,0,1,60
56,6505,21,1357647360,1357647420,0,1,60
56,6506,21,1357824156,1357824216,0,1,60
56,6507,21,1358775273,1358775333,0,1,60
56,6509,21,1358851756,1358851816,0,1,60
56,6510,21,1359028169,1359028229,0,1,60
56,6511,21,1359122724,1359122784,0,1,60
56,6512,21,1359239440,1359239500,0,1,60
56,6513,21,1359285216,1359285276,0,1,60
56,6514,21,1359553835,1359553895,0,1,60
56,6515,21,1359637130,1359637190,0,1,60
56,6518,21,1359980888,1359980948,0,1,60
57,6519,21,1360673594,1360673654,0,1,60
57,6522,35,1357601653,1357602125,0,1,472
57,6523,5,1357647107,1357647989,0,1,882
57,6525,35,1357730034,1357731778,0,1,1744
57,6527,5,1357825313,1357825373,0,1,60
57,6537,5,1358336056,1358336583,0,1,527
57,6538,35,1358380085,1358394635,0,1,14550
57,6539,5,1358424680,1358425132,0,1,452
57,6543,5,1358859907,1358860313,0,1,406
57,6547,5,1359202685,1359204227,0,1,1542
57,6550,35,1359368455,1359369649,0,2,1194
57,6550,5,1359369649,1359370077,0,2,428
57,6554,35,1359541341,1359543084,0,2,1743
57,6554,5,1359543084,1359543573,0,2,489
57,6558,5,1359720088,1359720493,0,1,405
57,6560,5,1359811185,1359812196,0,1,1011
57,6561,35,1359890439,1359891783,0,2,1344
57,6561,5,1359891783,1359892225,0,2,442
57,6565,21,1360575591,1360585053,0,2,9462
57,6565,5,1360585053,1360586183,0,2,1130
57,6566,21,1360659302,1360663377,0,3,4075
57,6566,35,1360667393,1360669124,0,3,1731
57,6566,5,1360669124,1360669184,0,3,60
57,6567,35,1360751222,1360752962,0,2,1740
57,6567,5,1360752962,1360753400,0,2,438
57,6568,35,1360833218,1360833278,0,1,60
58,6573,449,1333924826,1333926014,0,2,1188
58,6573,71,1333926014,1333926081,0,2,67
58,6574,449,1334011243,1334026322,0,1,15079
58,6575,71,1334051612,1334052573,0,2,961
58,6575,449,1334052573,1334052633,0,2,60
58,6577,71,1334139450,1334140905,0,2,1455
58,6577,449,1334140905,1334140965,0,2,60
58,6578,449,1334184137,1334201015,0,1,16878
58,6579,71,1334224893,1334226243,0,2,1350
58,6579,449,1334226243,1334226456,0,2,213
58,6581,71,1334310656,1334311733,0,2,1077
58,6581,449,1334311733,1334312132,0,2,399
58,6583,71,1334569034,1334570210,0,2,1176
58,6583,449,1334570210,1334570270,0,2,60
58,6584,71,1334656829,1334658282,0,2,1453
58,6584,449,1334658282,1334658342,0,2,60
58,6585,449,1334702364,1334703664,0,2,1300
58,6585,71,1334703664,1334703724,0,2,60
58,6586,5,1334795780,1334795840,0,1,60
58,6587,28,1334827100,1334829711,0,2,2611
58,6587,449,1334829711,1334829771,0,2,60
58,6588,449,1334875157,1334876355,0,2,1198
58,6588,71,1334876355,1334876415,0,2,60
58,6589,71,1334924067,1334925143,0,2,1076
58,6589,449,1334925143,1334925203,0,2,60
58,6590,651,1334994037,1334994097,0,1,60
58,6591,449,1335009207,1335009267,0,1,60
58,6593,449,1335134673,1335135767,0,2,1094
58,6593,71,1335135767,1335152861,0,2,17094
58,6594,71,1335180589,1335182062,0,2,1473
58,6594,449,1335182062,1335182122,0,2,60
58,6595,449,1335220848,1335221943,0,1,1095
58,6596,71,1335262146,1335263572,0,2,1426
58,6596,449,1335263572,1335263632,0,2,60
58,6597,449,1335307186,1335308371,0,2,1185
58,6597,71,1335308371,1335308431,0,2,60
58,6598,71,1335360135,1335360195,0,1,60
58,6599,449,1335393691,1335394739,0,2,1048
58,6599,71,1335394739,1335413109,0,2,18370
58,6601,71,1335520633,1335521701,0,2,1068
58,6601,449,1335521701,1335522291,0,2,590
58,6602,71,1336345291,1336361195,0,1,15904
58,6603,449,1336396816,1336397461,0,1,645
58,6604,449,1336430577,1336430637,0,1,60
58,6605,71,1336482862,1336483803,0,2,941
58,6605,449,1336483803,1336484277,0,2,474
58,6606,449,1336516879,1336517984,0,2,1105
58,6606,71,1336517984,1336536199,0,2,18215
58,6607,71,1336557188,1336558481,0,2,1293
58,6607,449,1336558481,1336558541,0,2,60
58,6608,449,1336603278,1336604246,0,2,968
58,6608,71,1336604246,1336604306,0,2,60
58,6612,449,1336948890,1336949854,0,2,964
58,6612,71,1336949854,1336965787,0,2,15933
58,6613,71,1336987879,1336988932,0,2,1053
58,6613,449,1336988932,1336988992,0,2,60
58,6614,449,1337035289,1337035349,0,1,60
58,6615,71,1337080574,1337082049,0,2,1475
58,6615,449,1337082049,1337082109,0,2,60
58,6616,449,1337121484,1337122567,0,2,1083
58,6616,71,1337122567,1337136882,0,2,14315
58,6617,71,1337159739,1337160758,0,2,1019
58,6617,449,1337160758,1337161031,0,2,273
58,6618,71,1337209015,1337226757,0,1,17742
58,6619,71,1337251177,1337252551,0,2,1374
58,6619,449,1337252551,1337252611,0,2,60
58,6620,71,1337295591,1337295651,0,1,60
58,6621,71,1337340812,1337342026,0,2,1214
58,6621,449,1337342026,1337344348,0,2,2322
58,6622,449,1337397978,1337412927,0,2,14949
58,6622,449,1337412927,1337414975,0,2,2048
58,6623,71,1337606967,1337608300,0,2,1333
58,6623,449,1337608300,1337608360,0,2,60
58,6624,449,1337639836,1337640961,0,2,1125
58,6624,71,1337640961,1337657139,0,2,16178
58,6625,71,1337680962,1337682258,0,2,1296
58,6625,449,1337682258,1337682318,0,2,60
58,6626,71,1337813990,1337814050,0,1,60
58,6627,71,1337939681,1337940973,0,2,1292
58,6627,449,1337940973,1337941033,0,2,60
58,6630,21,1338109425,1338111192,0,2,1767
58,6630,449,1338111192,1338111252,0,2,60
58,6631,449,1338158406,1338159629,0,2,1223
58,6631,71,1338159629,1338176279,0,2,16650
58,6632,71,1338202736,1338204201,0,2,1465
58,6632,449,1338204201,1338204261,0,2,60
58,6633,71,1338246213,1338262554,0,1,16341
58,6634,71,1338291481,1338292947,0,2,1466
58,6634,449,1338292947,1338293007,0,2,60
58,6635,71,1338332259,1338348474,0,1,16215
58,6636,449,1338504108,1338504168,0,1,60
58,6637,71,1338548102,1338549103,0,2,1001
58,6637,449,1338549103,1338549163,0,2,60
58,6639,449,1338763203,1338764341,0,2,1138
58,6639,71,1338764341,1338764401,0,2,60
58,6640,71,1338812965,1338814350,0,2,1385
58,6640,449,1338814350,1338814410,0,2,60
58,6641,449,1338849579,1338850527,0,2,948
58,6641,71,1338850527,1338868635,0,2,18108
58,6642,71,1338897967,1338898939,0,2,972
58,6642,449,1338898939,1338898999,0,2,60
58,6643,71,1338974219,1338975660,0,2,1441
58,6643,449,1338975660,1338975720,0,2,60
58,6644,449,1339023464,1339040141,0,1,16677
58,6645,71,1339062848,1339064085,0,2,1237
58,6645,449,1339064085,1339064145,0,2,60
58,6646,449,1339108835,1339110073,0,2,1238
58,6646,71,1339110073,1339110133,0,2,60
58,6649,449,1339328819,1339329036,0,2,217
58,6649,449,1339329036,1339329096,0,2,60
58,6650,449,1339368007,1339369135,0,2,1128
58,6650,71,1339369135,1339369195,0,2,60
58,6651,71,1339493209,1339494248,0,2,1039
58,6651,449,1339494248,1339494308,0,2,60
58,6652,449,1339540824,1339542019,0,2,1195
58,6652,71,1339542019,1339557437,0,2,15418
58,6653,449,1339579433,1339579493,0,1,60
58,6654,449,1339627269,1339628403,0,2,1134
58,6654,71,1339628403,1339628463,0,2,60
58,6655,71,1339665151,1339666354,0,2,1203
58,6655,449,1339666354,1339666414,0,2,60
58,6656,449,1339753530,1339755185,0,1,1655
58,6657,71,1339973991,1339991448,0,1,17457
58,6658,71,1340011393,1340012680,0,2,1287
58,6658,449,1340012680,1340013288,0,2,608
58,6659,449,1340097800,1340097860,0,1,60
58,6660,71,1340271305,1340271365,0,1,60
58,6661,449,1340272684,1340272744,0,1,60
58,6662,449,1340618847,1340618869,0,1,22
58,6663,449,1340750816,1340751544,0,2,728
58,6663,71,1340751544,1340751604,0,2,60
58,6664,71,1340791815,1340793305,0,2,1490
58,6664,449,1340793305,1340793364,0,2,59
58,6666,449,1341235854,1341235914,0,1,60
58,6667,449,1341268891,1341269991,0,2,1100
58,6667,71,1341269991,1341287665,0,2,17674
58,6668,71,1341314934,1341316375,0,2,1441
58,6668,449,1341316375,1341317004,0,2,629
58,6669,449,1341355317,1341356442,0,2,1125
58,6669,71,1341356442,1341372462,0,2,16020
58,6670,71,1341400974,1341402106,0,2,1132
58,6670,449,1341402106,1341402916,0,2,810
58,6671,71,1341442781,1341460215,0,1,17434
58,6672,71,1341483407,1341484897,0,2,1490
58,6672,449,1341484897,1341484957,0,2,60
58,6673,449,1341528144,1341529190,0,2,1046
58,6673,71,1341529190,1341544705,0,2,15515
58,6677,449,1341787343,1341788330,0,2,987
58,6677,71,1341788330,1341804995,0,2,16665
58,6678,71,1341828939,1341829937,0,2,998
58,6678,449,1341829937,1341829997,0,2,60
58,6679,449,1341873542,1341874756,0,2,1214
58,6679,71,1341874756,1341874816,0,2,60
58,6680,449,1341960010,1341961145,0,2,1135
58,6680,71,1341961145,1341976462,0,2,15317
58,6681,71,1342001495,1342002756,0,2,1261
58,6681,449,1342002756,1342003427,0,2,671
58,6682,71,1342047989,1342063801,0,1,15812
58,6683,260,1342074022,1342094823,0,1,20801
58,6684,449,1342098187,1342098247,0,1,60
58,6685,449,1342133035,1342133987,0,2,952
58,6685,71,1342133987,1342149572,0,2,15585
58,6686,71,1342170569,1342171999,0,2,1430
58,6686,449,1342171999,1342172059,0,2,60
58,6690,71,1342479589,1342495204,0,1,15615
58,6691,71,1342529000,1342530053,0,2,1053
58,6691,449,1342530053,1342530113,0,2,60
58,6692,449,1342564854,1342565958,0,2,1104
58,6692,71,1342565958,1342566018,0,2,60
58,6693,449,1342651127,1342652237,0,2,1110
58,6693,71,1342652237,1342652297,0,2,60
58,6694,449,1342916067,1342916127,0,1,60
58,6695,71,1343124003,1343125406,0,2,1403
58,6695,449,1343125406,1343125466,0,2,60
58,6696,449,1343342324,1343343593,0,2,1269
58,6696,71,1343343593,1343343653,0,2,60
58,6700,71,1343642882,1343643787,0,2,905
58,6700,449,1343643787,1343643847,0,2,60
58,6701,449,1343687985,1343688045,0,1,60
58,6703,71,1344207768,1344222246,0,1,14478
58,6704,71,1344244651,1344246004,0,2,1353
58,6704,449,1344246004,1344246064,0,2,60
58,6705,71,1344514622,1344516052,0,2,1430
58,6705,449,1344516052,1344516112,0,2,60
58,6706,449,1344550309,1344551593,0,2,1284
58,6706,71,1344551593,1344551653,0,2,60
58,6707,71,1344591238,1344592881,0,2,1643
58,6707,449,1344592881,1344592941,0,2,60
58,6708,449,1345282325,1345283237,0,1,912
58,6710,71,1345416990,1345432544,0,1,15554
58,6711,71,1345456242,1345457455,0,2,1213
58,6711,449,1345457455,1345457515,0,2,60
58,6712,449,1346838303,1346838850,0,1,547
58,6713,449,1346884961,1346905250,0,1,20289
58,6714,71,1347231573,1347231633,0,1,60
58,6715,71,1347531954,1347533679,0,2,1725
58,6715,449,1347533679,1347533739,0,2,60
58,6719,449,1349687608,1349687668,0,1,60
58,6720,449,1349995304,1349996371,0,2,1067
58,6720,71,1349996371,1349996431,0,2,60
58,6721,336,1350033343,1350034188,0,2,845
58,6721,449,1350034188,1350034578,0,2,390
58,6723,71,1350389208,1350390662,0,2,1454
58,6723,449,1350390662,1350390722,0,2,60
58,6724,449,1350478426,1350478471,0,1,45
58,6725,71,1350903261,1350904399,0,2,1138
58,6725,449,1350904399,1350904459,0,2,60
58,6726,71,1350985307,1350986650,0,2,1343
58,6726,449,1350986650,1350986710,0,2,60
58,6727,449,1351034386,1351036689,0,2,2303
58,6727,71,1351048780,1351048840,0,2,60
58,6728,71,1351070480,1351071604,0,2,1124
58,6728,449,1351071604,1351071664,0,2,60
58,6729,449,1351118493,1351119811,0,2,1318
58,6729,71,1351119811,1351136049,0,2,16238
58,6730,71,1351168172,1351168232,0,1,60
58,6731,449,1351204801,1351205809,0,2,1008
58,6731,71,1351205809,1351205869,0,2,60
58,6732,71,1351249345,1351250706,0,2,1361
58,6732,449,1351250706,1351250766,0,2,60
58,6737,449,1351723164,1351724360,0,2,1196
58,6737,71,1351724360,1351742408,0,2,18048
58,6738,71,1351770186,1351771321,0,2,1135
58,6738,449,1351771321,1351773168,0,2,1847
58,6741,71,1352109068,1352110231,0,2,1163
58,6741,449,1352110231,1352110291,0,2,60
58,6742,449,1352155161,1352156204,0,2,1043
58,6742,71,1352156204,1352169787,0,2,13583
58,6743,71,1352195293,1352196828,0,2,1535
58,6743,449,1352196828,1352196888,0,2,60
58,6744,449,1352241776,1352242677,0,3,901
58,6744,260,1352242677,1352243122,0,3,445
58,6744,71,1352243122,1352257272,0,3,14150
58,6745,71,1352280851,1352282242,0,2,1391
58,6745,449,1352282242,1352282302,0,2,60
58,6746,449,1352369527,1352369587,0,1,60
58,6747,71,1352459960,1352461232,0,2,1272
58,6747,449,1352461232,1352461292,0,2,60
58,6749,71,1352674769,1352674829,0,1,60
58,6750,449,1352719409,1352719652,0,1,243
58,6751,449,1352760170,1352761189,0,2,1019
58,6751,71,1352761189,1352761249,0,2,60
58,6752,71,1352801714,1352802878,0,2,1164
58,6752,449,1352802878,1352802938,0,2,60
58,6753,449,1353019268,1353040669,0,1,21401
58,6754,71,1353062440,1353063717,0,2,1277
58,6754,449,1353063717,1353063777,0,2,60
58,6757,449,1353364658,1353365874,0,3,1216
58,6757,71,1353365874,1353366308,0,3,434
58,6757,5,1353366308,1353366368,0,3,60
58,6758,449,1353405887,1353406283,0,1,396
58,6759,71,1353452361,1353452421,0,1,60
58,6760,71,1353507094,1353508298,0,2,1204
58,6760,449,1353508298,1353508734,0,2,436
58,6761,449,1353537482,1353537542,0,1,60
58,6763,449,1353592439,1353592499,0,1,60
58,6768,449,1353883385,1353884400,0,2,1015
58,6768,71,1353884400,1353900160,0,2,15760
58,6769,449,1353935099,1353935159,0,1,60
58,6770,449,1353969748,1353969808,0,1,60
58,6771,71,1354027758,1354027818,0,1,60
58,6775,71,1354531877,1354533175,0,2,1298
58,6775,449,1354533175,1354533235,0,2,60
58,6776,449,1354574630,1354575637,0,2,1007
58,6776,71,1354575637,1354590823,0,2,15186
58,6777,71,1354618207,1354619614,0,2,1407
58,6777,449,1354619614,1354619674,0,2,60
58,6778,449,1354660978,1354662039,0,2,1061
58,6778,71,1354662039,1354662099,0,2,60
58,6779,71,1354704435,1354706084,0,2,1649
58,6779,449,1354706084,1354706144,0,2,60
58,6780,71,1354748628,1354762753,0,1,14125
58,6781,71,1354792126,1354793585,0,2,1459
58,6781,449,1354793585,1354793645,0,2,60
58,6782,71,1354835003,1354835063,0,1,60
58,6783,71,1354880603,1354881764,0,2,1161
58,6783,449,1354881764,1354881824,0,2,60
58,6785,449,1355092985,1355093976,0,2,991
58,6785,71,1355093976,1355094036,0,2,60
58,6786,71,1355180639,1355180699,0,1,60
58,6787,71,1355216851,1355217840,0,2,989
58,6787,449,1355217840,1355217900,0,2,60
58,6788,449,1355265773,1355266789,0,2,1016
58,6788,71,1355266789,1355281268,0,2,14479
58,6789,449,1355352138,1355353180,0,2,1042
58,6789,71,1355353180,1355371342,0,2,18162
58,6790,71,1355390645,1355391932,0,2,1287
58,6790,449,1355391932,1355391992,0,2,60
58,6792,71,1355740832,1355741942,0,3,1110
58,6792,263,1355741942,1355742314,0,3,372
58,6792,449,1355742314,1355742374,0,3,60
58,6793,449,1355784227,1355785410,0,2,1183
58,6793,71,1355785410,1355785470,0,2,60
58,6794,71,1355828766,1355828826,0,1,60
58,6795,449,1355870550,1355871580,0,2,1030
58,6795,71,1355871580,1355888682,0,2,17102
58,6796,71,1355924275,1355924335,0,1,60
58,6797,449,1355969710,1355969770,0,1,60
58,6798,449,1356043415,1356043475,0,1,60
58,6799,71,1356083085,1356084297,0,2,1212
58,6799,449,1356084297,1356084357,0,2,60
58,6800,71,1356606762,1356607919,0,2,1157
58,6800,449,1356607919,1356607979,0,2,60
58,6801,449,1356688068,1356700284,0,1,12216
58,6803,71,1357513157,1357513217,0,1,60
58,6804,71,1357560814,1357560874,0,1,60
58,6807,71,1357725028,1357725088,0,1,60
58,6808,71,1357772391,1357792521,0,1,20130
58,6809,449,1357814513,1357814573,0,1,60
58,6811,449,1357913547,1357913607,0,1,60
58,6813,449,1358202745,1358220838,0,1,18093
58,6814,71,1358244545,1358246129,0,2,1584
58,6814,449,1358246129,1358246189,0,2,60
58,6815,71,1358291018,1358291078,0,1,60
58,6816,71,1358330551,1358331990,0,2,1439
58,6816,449,1358331990,1358332050,0,2,60
58,6817,449,1358376492,1358376552,0,1,60
58,6818,71,1358420017,1358421223,0,2,1206
58,6818,449,1358421223,1358421283,0,2,60
58,6820,71,1358503529,1358503589,0,1,60
58,6821,449,1358763852,1358763912,0,1,60
58,6822,449,1358808050,1358823597,0,1,15547
59,6823,71,1358846845,1358848012,0,2,1167
59,6823,449,1358848012,1358848072,0,2,60
59,6838,253,1334314150,1334315119,0,2,969
59,6838,71,1334315119,1334316122,0,2,1003
59,6839,8,1334574586,1334575149,0,1,563
59,6840,11,1334657671,1334657949,0,3,278
59,6840,5,1334657949,1334658903,0,3,954
59,6840,35,1334660199,1334661551,0,3,1352
59,6847,35,1334979957,1334981039,0,2,1082
59,6847,351,1334981039,1334981099,0,2,60
59,6848,77,1335008053,1335008113,0,1,60
59,6857,640,1335522413,1335522699,0,3,286
59,6857,603,1335522699,1335524093,0,3,1394
59,6857,212,1335524093,1335530218,0,3,6125
59,6883,765,1338007040,1338008282,0,1,1242
59,6917,351,1341316211,1341316271,0,1,60
59,6923,336,1341586554,1341586614,0,1,60
59,6934,71,1345161240,1345161309,0,1,69
60,7008,8,1334382271,1334385381,0,1,3110
60,7046,8,1341232949,1341233009,0,1,60
60,7048,8,1341485733,1341487459,0,1,1726
60,7098,8,1355921431,1355921491,0,1,60
60,7106,8,1357986093,1357986153,0,1,60
61,7133,104,1335584159,1335584219,0,1,60
61,7140,284,1336209069,1336211240,0,1,2171
61,7235,21,1351490568,1351491668,0,1,1100
62,7296,253,1337430899,1337431400,0,2,501
62,7296,875,1337435348,1337447900,0,2,12552
62,7300,480,1339216240,1339218848,0,1,2608
62,7324,8,1355482831,1355500902,0,1,18071
62,7336,253,1359808986,1359811182,0,1,2196
63,7362,253,1334876603,1334877454,0,2,851
63,7362,253,1334885319,1334886381,0,2,1062
63,7365,21,1335001373,1335002171,0,1,798
63,7378,21,1336210339,1336210780,0,2,441
63,7378,5,1336210780,1336210840,0,2,60
63,7379,5,1336216691,1336217261,0,1,570
63,7382,253,1336524730,1336530699,0,1,5969
63,7408,35,1338769205,1338769812,0,4,607
63,7408,603,1338769812,1338778988,0,4,9176
63,7408,603,1338779701,1338780184,0,4,483
63,7408,21,1338780999,1338781138,0,4,139
63,7412,5,1338979756,1338980205,0,1,449
63,7458,428,1347690510,1347691714,0,4,1204
63,7458,603,1347700080,1347700506,0,4,426
63,7458,35,1347700506,1347701673,0,4,1167
63,7458,428,1347701673,1347702807,0,4,1134
63,7462,21,1350110623,1350111212,0,3,589
63,7462,5,1350111212,1350111993,0,3,781
63,7462,8,1350114374,1350115914,0,3,1540
63,7466,253,1350651896,1350653416,0,1,1520
63,7470,253,1351072131,1351072275,0,3,144
63,7470,253,1351077523,1351077965,0,3,442
63,7470,428,1351078444,1351079237,0,3,793
63,7486,21,1352256856,1352256902,0,1,46
63,7489,21,1352454467,1352454523,0,5,56
63,7489,5,1352457120,1352457204,0,5,84
63,7489,8,1352457204,1352459804,0,5,2600
63,7489,5,1352459804,1352460253,0,5,449
63,7489,21,1352460253,1352461036,0,5,783
63,7492,8,1352696065,1352698615,0,1,2550
63,7500,5,1353660839,1353661151,0,6,312
63,7500,21,1353661151,1353661217,0,6,66
63,7500,603,1353662651,1353662831,0,6,180
63,7500,603,1353668067,1353668533,0,6,466
63,7500,35,1353668533,1353670392,0,6,1859
63,7500,428,1353670392,1353671207,0,6,815
63,7501,35,1353769644,1353770669,0,1,1025
63,7513,480,1354774973,1354779750,0,1,4777
63,7514,8,1354786701,1354787353,0,3,652
63,7514,5,1354787353,1354787780,0,3,427
63,7514,21,1354787780,1354788020,0,3,240
63,7541,1,1357111777,1357112908,0,3,1131
63,7541,5,1357112908,1357113099,0,3,191
63,7541,8,1357113099,1357116335,0,3,3236
63,7542,71,1357302713,1357302773,0,1,60
63,7559,71,1359722127,1359724374,0,1,2247
63,7560,253,1359791714,1359792232,0,4,518
63,7560,35,1359792232,1359792711,0,4,479
63,7560,603,1359792711,1359792730,0,4,19
63,7560,35,1359800150,1359802585,0,4,2435
63,7567,21,1360322035,1360322436,0,2,401
63,7567,71,1360322436,1360323583,0,2,1147
64,7570,35,1333490251,1333490311,0,1,60
64,7571,875,1336683547,1336684790,0,2,1243
64,7571,35,1336684790,1336685311,0,2,521
64,7585,765,1341619244,1341619304,0,1,60
64,7594,21,1342792446,1342792506,0,1,60
64,7598,35,1343552958,1343554148,0,1,1190
64,7599,284,1343615026,1343615086,0,1,60
64,7610,875,1347225391,1347241716,0,1,16325
64,7613,21,1349690686,1349693421,0,2,2735
64,7613,875,1349693421,1349693481,0,2,60
64,7617,35,1350469658,1350471288,0,1,1630
64,7627,875,1351260902,1351261525,0,1,623
64,7629,35,1351387200,1351387260,0,1,60
64,7638,21,1352632862,1352634778,0,1,1916
64,7640,35,1352724469,1352727515,0,1,3046
64,7644,35,1353225326,1353226225,0,1,899
64,7653,35,1354012072,1354014306,0,1,2234
64,7654,875,1354051829,1354051889,0,1,60
64,7657,35,1354486102,1354486162,0,1,60
64,7659,35,1354614719,1354614779,0,1,60
64,7661,35,1354702688,1354702748,0,1,60
64,7662,35,1354745576,1354745636,0,1,60
64,7667,35,1355263829,1355282136,0,1,18307
64,7684,35,1357768659,1357768719,0,1,60
65,7694,71,1333532808,1333532824,0,3,16
65,7694,449,1333543813,1333544111,0,3,298
65,7694,449,1333544111,1333544193,0,3,82
65,7696,651,1333617774,1333621947,0,1,4173
65,7699,651,1334049802,1334051705,0,2,1903
65,7699,449,1334051705,1334051822,0,2,117
65,7700,449,1334101110,1334101170,0,1,60
65,7702,449,1334187624,1334189398,0,1,1774
65,7705,449,1334310502,1334310762,0,1,260
65,7706,449,1334447515,1334458521,0,1,11006
65,7708,651,1334571475,1334572894,0,2,1419
65,7708,449,1334572894,1334573155,0,2,261
65,7709,449,1334671215,1334671275,0,1,60
65,7710,651,1334793770,1334795161,0,1,1391
65,7711,651,1334827714,1334829365,0,2,1651
65,7711,449,1334829365,1334830282,0,2,917
65,7712,449,1334915252,1334915312,0,1,60
65,7713,449,1335012311,1335012371,0,1,60
65,7714,263,1335175442,1335175790,0,1,348
65,7715,449,1335224480,1335237644,0,1,13164
65,7717,449,1335311182,1335311242,0,1,60
65,7718,449,1335357390,1335357627,0,1,237
65,7719,651,1335432649,1335433965,0,2,1316
65,7719,449,1335433965,1335434064,0,2,99
65,7720,21,1335536210,1335538510,0,1,2300
65,7721,449,1335607778,1335608496,0,4,718
65,7721,71,1335608496,1335608721,0,4,225
65,7721,21,1335608721,1335609417,0,4,696
65,7721,449,1335625793,1335625853,0,4,60
65,7722,5,1335668233,1335668760,0,1,527
65,7725,449,1335916036,1335916096,0,1,60
65,7726,449,1336095888,1336098246,0,2,2358
65,7726,8,1336098246,1336100049,0,2,1803
65,7728,449,1336197032,1336198618,0,2,1586
65,7728,5,1336198618,1336199263,0,2,645
65,7729,449,1336231772,1336233046,0,1,1274
65,7730,651,1336349347,1336349718,0,1,371
65,7731,651,1336382769,1336385423,0,1,2654
65,7732,449,1336520335,1336522153,0,1,1818
65,7734,449,1336607232,1336607292,0,1,60
65,7736,449,1336744702,1336746226,0,1,1524
65,7738,449,1336829545,1336829788,0,1,243
65,7740,449,1336919880,1336919940,0,1,60
65,7741,651,1336987382,1336989607,0,1,2225
65,7742,21,1337054476,1337054536,0,1,60
65,7743,449,1337085913,1337085973,0,1,60
65,7745,449,1337161490,1337161742,0,1,252
65,7746,253,1337249053,1337249130,0,1,77
65,7747,449,1337403772,1337405590,0,2,1818
65,7747,5,1337405590,1337405882,0,2,292
65,7748,449,1337428447,1337428601,0,1,154
65,7749,651,1337594458,1337594518,0,1,60
65,7750,449,1337687343,1337688102,0,1,759
65,7751,21,1337938216,1337941150,0,3,2934
65,7751,77,1337946542,1337946681,0,3,139
65,7751,449,1337947317,1337947474,0,3,157
65,7754,71,1338112752,1338113031,0,2,279
65,7754,260,1338113031,1338114770,0,2,1739
65,7756,651,1338202379,1338203937,0,1,1558
65,7757,449,1338248648,1338249925,0,2,1277
65,7757,651,1338249925,1338250222,0,2,297
65,7758,449,1338291567,1338291627,0,1,60
65,7759,449,1338540774,1338541666,0,1,892
65,7761,449,1338799313,1338799666,0,1,353
65,7762,651,1338851344,1338862459,0,1,11115
65,7763,263,1338889177,1338889514,0,2,337
65,7763,449,1338889514,1338889739,0,2,225
65,7764,449,1338975105,1338975230,0,1,125
65,7765,651,1339023932,1339036343,0,1,12411
65,7766,449,1339059484,1339059760,0,1,276
65,7767,449,1339108955,1339110360,0,2,1405
65,7767,651,1339110360,1339110420,0,2,60
65,7768,5,1339153781,1339156427,0,2,2646
65,7768,449,1339156427,1339156491,0,2,64
65,7769,449,1339221224,1339221470,0,1,246
65,7771,651,1339405927,1339408311,0,1,2384
65,7773,449,1339495786,1339495954,0,1,168
65,7774,449,1339540913,1339553823,0,1,12910
65,7775,284,1339580131,1339590314,0,2,10183
65,7775,449,1339595371,1339595431,0,2,60
65,7776,449,1339627394,1339640201,0,1,12807
65,7777,260,1339667928,1339669213,0,2,1285
65,7777,449,1339669213,1339669503,0,2,290
65,7780,651,1339974452,1339993782,0,1,19330
65,7781,651,1340007626,1340008755,0,2,1129
65,7781,449,1340008755,1340008815,0,2,60
65,7782,449,1340231923,1340233807,0,1,1884
65,7783,284,1340269977,1340285752,0,3,15775
65,7783,284,1340285752,1340290141,0,3,4389
65,7783,449,1340290141,1340290690,0,3,549
65,7784,651,1340752043,1340763224,0,1,11181
65,7785,449,1340786540,1340786604,0,1,64
65,7786,284,1341231129,1341232102,0,1,973
65,7787,449,1341269473,1341272706,0,2,3233
65,7787,284,1341272706,1341272761,0,2,55
65,7788,21,1341308933,1341309673,0,3,740
65,7788,21,1341317689,1341319547,0,3,1858
65,7788,449,1341319547,1341319607,0,3,60
65,7790,284,1341395756,1341398324,0,2,2568
65,7790,449,1341407182,1341407242,0,2,60
65,7792,260,1341749653,1341750693,0,2,1040
65,7792,449,1341750693,1341750753,0,2,60
65,7793,449,1341839458,1341839518,0,1,60
65,7794,284,1341876974,1341877034,0,1,60
65,7796,263,1342017548,1342017608,0,1,60
65,7798,449,1342093840,1342093900,0,1,60
65,7799,449,1342133373,1342136170,0,2,2797
65,7799,284,1342136170,1342136763,0,2,593
65,7801,263,1342245897,1342247387,0,1,1490
65,7802,603,1342340077,1342341835,0,2,1758
65,7802,71,1342346113,1342346272,0,2,159
65,7805,449,1342531226,1342531372,0,1,146
65,7806,449,1342624364,1342624424,0,1,60
65,7808,35,1343126305,1343128173,0,1,1868
65,7809,449,1343343251,1343346066,0,2,2815
65,7809,284,1343346066,1343346126,0,2,60
65,7810,21,1343456834,1343456996,0,1,162
65,7811,449,1344164560,1344165368,0,1,808
65,7812,449,1344206617,1344210008,0,1,3391
65,7813,449,1344249904,1344250015,0,1,111
65,7814,449,1344585044,1344585774,0,4,730
65,7814,428,1344585774,1344586398,0,4,624
65,7814,253,1344586398,1344586732,0,4,334
65,7814,449,1344602028,1344603343,0,4,1315
65,7815,336,1344639918,1344640565,0,1,647
65,7816,71,1344673203,1344673217,0,2,14
65,7816,449,1344683589,1344683608,0,2,19
65,7817,449,1344725949,1344728658,0,1,2709
65,7818,449,1344773203,1344773263,0,1,60
65,7820,284,1344936109,1344936536,0,5,427
65,7820,35,1344936536,1344936907,0,5,371
65,7820,253,1344936907,1344937031,0,5,124
65,7820,253,1344937031,1344937053,0,5,22
65,7820,449,1344939505,1344939873,0,5,368
65,7821,284,1344987522,1344987639,0,1,117
65,7823,449,1345465174,1345465234,0,1,60
65,7824,449,1346840692,1346842743,0,1,2051
65,7826,21,1347202120,1347202180,0,1,60
65,7827,284,1347528168,1347534983,0,2,6815
65,7827,449,1347534983,1347535337,0,2,354
65,7829,449,1347673197,1347685848,0,1,12651
65,7830,449,1347714831,1347714891,0,1,60
65,7831,449,1350600785,1350604028,0,1,3243
65,7832,449,1350652763,1350654371,0,1,1608
65,7833,263,1350899840,1350900207,0,2,367
65,7833,449,1350900207,1350900874,0,2,667
65,7834,284,1350949160,1350963132,0,3,13972
65,7834,35,1350965174,1350966331,0,3,1157
65,7834,449,1350970421,1350970481,0,3,60
65,7835,449,1351032693,1351048031,0,1,15338
65,7836,449,1351083981,1351084790,0,1,809
65,7837,449,1351119381,1351122734,0,1,3353
65,7838,284,1351157161,1351161384,0,1,4223
65,7839,284,1351208410,1351208453,0,1,43
65,7840,284,1351242010,1351245396,0,3,3386
65,7840,5,1351245396,1351257871,0,3,12475
65,7840,449,1351257871,1351257931,0,3,60
65,7841,11,1351299816,1351299876,0,1,60
65,7842,284,1351323450,1351326195,0,2,2745
65,7842,21,1351327296,1351327675,0,2,379
65,7843,449,1351349408,1351349468,0,1,60
65,7844,449,1351409734,1351410905,0,4,1171
65,7844,260,1351410905,1351412128,0,4,1223
65,7844,35,1351412128,1351412522,0,4,394
65,7844,640,1351412522,1351413419,0,4,897
65,7845,449,1351431820,1351432083,0,1,263
65,7848,449,1351637665,1351640769,0,1,3104
65,7849,449,1351689391,1351689451,0,1,60
65,7850,449,1351723916,1351727581,0,1,3665
65,7851,449,1351765561,1351765621,0,1,60
65,7853,35,1351854208,1351854268,0,1,60
65,7854,449,1352120606,1352121141,0,1,535
65,7856,449,1352200869,1352200929,0,1,60
65,7857,449,1352284312,1352286580,0,1,2268
65,7858,449,1352368674,1352369329,0,1,655
65,7859,449,1352459102,1352461426,0,1,2324
65,7861,449,1352622831,1352622891,0,1,60
65,7862,449,1352675226,1352675286,0,1,60
65,7863,449,1352719089,1352719558,0,1,469
65,7864,449,1352760821,1352776703,0,1,15882
65,7865,5,1352812090,1352816224,0,1,4134
65,7867,449,1353208651,1353210009,0,3,1358
65,7867,77,1353210009,1353212196,0,3,2187
65,7867,284,1353212196,1353212256,0,3,60
65,7868,449,1353232851,1353236048,0,1,3197
65,7869,449,1353366204,1353370232,0,1,4028
65,7870,284,1353402140,1353405382,0,2,3242
65,7870,449,1353405382,1353405519,0,2,137
65,7871,284,1353454911,1353455152,0,1,241
65,7873,284,1353579531,1353582943,0,2,3412
65,7873,449,1353582943,1353583573,0,2,630
65,7874,449,1353731557,1353734536,0,2,2979
65,7874,11,1353734536,1353736413,0,2,1877
65,7875,449,1353752282,1353752334,0,1,52
65,7876,449,1353829362,1353829422,0,1,60
65,7878,449,1353884384,1353904908,0,1,20524
65,7879,449,1353926579,1353926639,0,1,60
65,7880,449,1353970186,1353970246,0,1,60
65,7881,449,1354339527,1354339712,0,1,185
65,7884,449,1354574766,1354574826,0,1,60
65,7887,449,1354704322,1354705056,0,1,734
65,7888,284,1354751169,1354751591,0,1,422
65,7889,449,1354791542,1354791643,0,1,101
65,7890,284,1354837142,1354837202,0,1,60
65,7891,449,1354875696,1354875846,0,1,150
65,7893,449,1355093227,1355096699,0,2,3472
65,7893,284,1355096699,1355096885,0,2,186
65,7895,449,1355179855,1355196750,0,1,16895
65,7896,284,1355217433,1355218164,0,4,731
65,7896,35,1355218235,1355218676,0,4,441
65,7896,253,1355218676,1355218972,0,4,296
65,7896,260,1355219451,1355219511,0,4,60
65,7899,449,1355352905,1355355883,0,2,2978
65,7899,284,1355355883,1355368310,0,2,12427
65,7900,5,1355390605,1355396403,0,2,5798
65,7900,449,1355400487,1355400547,0,2,60
65,7901,449,1355480752,1355480812,0,1,60
65,7902,449,1355525542,1355527892,0,1,2350
65,7903,449,1355569473,1355570558,0,1,1085
65,7904,449,1355625088,1355625148,0,1,60
65,7905,5,1355646969,1355648847,0,2,1878
65,7905,449,1355648847,1355648907,0,2,60
65,7906,449,1355745811,1355745871,0,1,60
65,7908,284,1355821822,1355825051,0,2,3229
65,7908,449,1355825051,1355825225,0,2,174
65,7910,21,1355908952,1355909077,0,2,125
65,7910,21,1355921923,1355924305,0,2,2382
65,7911,284,1355960420,1355960480,0,1,60
65,7912,449,1356044195,1356047059,0,2,2864
65,7912,284,1356047059,1356047378,0,2,319
65,7913,5,1356151470,1356158953,0,2,7483
65,7913,651,1356158953,1356159019,0,2,66
65,7915,284,1356651900,1356651960,0,1,60
65,7916,21,1356695499,1356696760,0,3,1261
65,7916,260,1356696760,1356697603,0,3,843
65,7916,449,1356697603,1356697838,0,3,235
65,7917,449,1356746655,1356763118,0,2,16463
65,7917,5,1356763118,1356763374,0,2,256
65,7918,449,1356820648,1356820708,0,1,60
65,7919,71,1356858062,1356858526,0,2,464
65,7919,449,1356863994,1356864054,0,2,60
65,7920,449,1356907939,1356909338,0,2,1399
65,7920,428,1356909338,1356910679,0,2,1341
65,7921,651,1356945752,1356946588,0,2,836
65,7921,449,1356946588,1356947426,0,2,838
65,7922,449,1357005697,1357007981,0,1,2284
65,7926,449,1357448007,1357449870,0,2,1863
65,7926,5,1357449870,1357451443,0,2,1573
65,7928,284,1357894744,1357894804,0,1,60
65,7934,449,1358503493,1358503831,0,1,338
65,7935,449,1358541467,1358541527,0,1,60
65,7936,449,1358765144,1358765204,0,1,60
65,7937,449,1358851046,1358851071,0,1,25
65,7939,449,1359068246,1359071205,0,1,2959
65,7940,449,1359116406,1359117488,0,1,1082
65,7941,449,1359186811,1359187380,0,1,569
65,7944,449,1359371597,1359371616,0,1,19
65,7945,284,1359416657,1359416965,0,1,308
65,7947,284,1359516951,1359517258,0,2,307
65,7947,284,1359536518,1359536578,0,2,60
65,7948,449,1359540162,1359540362,0,1,200
65,7949,284,1359589366,1359589515,0,1,149
65,7951,449,1359673046,1359674009,0,3,963
65,7951,260,1359674009,1359675841,0,3,1832
65,7951,284,1359675841,1359676025,0,3,184
65,7952,284,1359714388,1359715853,0,3,1465
65,7952,5,1359715853,1359717955,0,3,2102
65,7952,449,1359717955,1359718104,0,3,149
65,7953,449,1359857509,1359859120,0,1,1611
65,7954,449,1359932188,1359935127,0,1,2939
65,7955,284,1359975409,1359979164,0,2,3755
65,7955,449,1359979164,1359979254,0,2,90
65,7956,480,1360020454,1360020518,0,1,64
65,7957,5,1360058397,1360060160,0,2,1763
65,7957,449,1360060160,1360062027,0,2,1867
65,7958,449,1360103748,1360107939,0,2,4191
65,7958,284,1360107939,1360107999,0,2,60
65,7960,449,1360191296,1360194156,0,2,2860
65,7960,284,1360194156,1360194310,0,2,154
65,7961,284,1360226930,1360233526,0,4,6596
65,7961,480,1360235752,1360235907,0,4,155
65,7961,21,1360236057,1360238096,0,4,2039
65,7961,449,1360238096,1360238332,0,4,236
65,7962,284,1360280661,1360280892,0,1,231
65,7963,449,1360317964,1360318230,0,1,266
65,7964,449,1360623410,1360624430,0,3,1020
65,7964,260,1360624430,1360626488,0,3,2058
65,7964,284,1360626488,1360626506,0,3,18
65,7965,284,1360659192,1360660115,0,2,923
65,7965,449,1360666935,1360667143,0,2,208
65,7966,449,1360757572,1360759296,0,1,1724
66,7967,449,1360794861,1360796858,0,2,1997
66,7967,21,1360796858,1360797023,0,2,165
66,7979,21,1335596426,1335596486,0,1,60
66,7980,21,1335700807,1335703758,0,1,2951
66,7982,21,1336204027,1336204087,0,1,60
66,8006,428,1339653545,1339654949,0,1,1404
66,8024,428,1344543861,1344543921,0,1,60
66,8054,336,1356764567,1356765270,0,2,703
66,8054,261,1356765270,1356765330,0,2,60
67,8058,651,1333511291,1333511602,0,2,311
67,8058,651,1333519514,1333519574,0,2,60
67,8059,651,1334029441,1334043299,0,2,13858
67,8059,651,1334043299,1334044750,0,2,1451
67,8060,651,1334116364,1334127978,0,2,11614
67,8060,651,1334127978,1334129479,0,2,1501
67,8063,651,1334817590,1334822552,0,2,4962
67,8063,651,1334822552,1334823980,0,2,1428
67,8064,651,1334912206,1334912661,0,1,455
67,8066,297,1335228179,1335238218,0,2,10039
67,8066,297,1335239844,1335241180,0,2,1336
67,8069,253,1335689610,1335690526,0,2,916
67,8069,253,1335698095,1335699702,0,2,1607
67,8082,651,1339040952,1339041012,0,1,60
67,8083,651,1339062565,1339062625,0,1,60
67,8086,651,1340250672,1340259198,0,1,8526
67,8088,651,1341459275,1341474314,0,2,15039
67,8088,651,1341474314,1341475485,0,2,1171
67,8090,651,1342064617,1342064677,0,1,60
67,8091,651,1342085767,1342085827,0,1,60
67,8102,651,1350950163,1350959357,0,1,9194
67,8104,651,1351216881,1351218661,0,1,1780
67,8106,651,1351732043,1351739945,0,1,7902
67,8110,5,1353222263,1353227826,0,2,5563
67,8110,5,1353227826,1353227886,0,2,60
67,8111,651,1353556226,1353562539,0,2,6313
67,8111,651,1353562539,1353563815,0,2,1276
67,8115,651,1354160115,1354160175,0,1,60
67,8118,253,1355489481,1355489541,0,1,60
67,8119,651,1356601744,1356603215,0,1,1471
67,8124,71,1357894229,1357895204,0,2,975
67,8124,71,1357911997,1357912057,0,2,60
67,8125,253,1358068168,1358069159,0,2,991
67,8125,253,1358074669,1358076282,0,2,1613
67,8130,765,1358503340,1358504092,0,1,752
67,8131,449,1359365535,1359366938,0,1,1403
67,8133,651,1359509839,1359509899,0,1,60
67,8134,449,1359538017,1359539314,0,1,1297
67,8135,651,1359618749,1359634098,0,1,15349
67,8136,449,1359711114,1359712006,0,1,892
67,8140,651,1360234082,1360236166,0,1,2084
68,8144,284,1333810583,1333819350,0,1,8767
68,8145,284,1333853573,1333854238,0,1,665
68,8146,253,1333895911,1333896970,0,3,1059
68,8146,284,1333896970,1333897651,0,3,681
68,8146,284,1333901909,1333905263,0,3,3354
68,8149,297,1340722021,1340722047,0,1,26
68,8150,297,1340786161,1340786487,0,4,326
68,8150,21,1340786487,1340786709,0,4,222
68,8150,5,1340786709,1340786765,0,4,56
68,8150,5,1340806232,1340806292,0,4,60
68,8152,35,1341114407,1341114467,0,1,60
68,8153,35,1341221799,1341222747,0,5,948
68,8153,480,1341222747,1341222853,0,5,106
68,8153,5,1341223109,1341224030,0,5,921
68,8153,5,1341236384,1341236684,0,5,300
68,8153,11,1341236684,1341237000,0,5,316
68,8154,71,1341258360,1341258512,0,2,152
68,8154,297,1341258512,1341258878,0,2,366
68,8155,297,1341294667,1341295075,0,3,408
68,8155,5,1341295075,1341295114,0,3,39
68,8155,8,1341296799,1341306102,0,3,9303
68,8156,11,1341316481,1341317778,0,2,1297
68,8156,5,1341318305,1341319522,0,2,1217
68,8157,297,1341366237,1341369198,0,5,2961
68,8157,5,1341376375,1341377942,0,5,1567
68,8157,5,1341379265,1341380818,0,5,1553
68,8157,297,1341380910,1341382949,0,5,2039
68,8157,28,1341382949,1341384463,0,5,1514
68,8158,260,1341620879,1341620939,0,1,60
68,8159,28,1347687662,1347688926,0,3,1264
68,8159,21,1347688926,1347689775,0,3,849
68,8159,35,1347701986,1347702469,0,3,483
68,8160,5,1347713416,1347713435,0,3,19
68,8160,5,1347721873,1347723057,0,3,1184
68,8160,297,1347723057,1347726564,0,3,3507
68,8161,5,1347759962,1347760542,0,1,580
68,8163,28,1353228073,1353230928,0,2,2855
68,8163,5,1353235034,1353235078,0,2,44
68,8165,35,1353397686,1353398385,0,2,699
68,8165,5,1353416360,1353416420,0,2,60
68,8166,5,1353475274,1353477596,0,2,2322
68,8166,35,1353492284,1353492582,0,2,298
68,8168,11,1353556251,1353556310,0,1,59
68,8172,351,1353725030,1353725090,0,1,60
68,8174,253,1353822705,1353823243,0,1,538
68,8176,351,1353897928,1353904763,0,4,6835
68,8176,253,1353904763,1353905655,0,4,892
68,8176,284,1353905655,1353908934,0,4,3279
68,8176,28,1353908934,1353908994,0,4,60
68,8178,336,1355549490,1355550412,0,3,922
68,8178,21,1355550412,1355555660,0,3,5248
68,8178,21,1355555660,1355555720,0,3,60
68,8179,297,1355586464,1355589981,0,1,3517
68,8180,765,1355620103,1355620313,0,2,210
68,8180,5,1355630685,1355641678,0,2,10993
68,8181,11,1355670593,1355670653,0,1,60
68,8182,284,1355724374,1355724434,0,1,60
68,8183,28,1356678840,1356687658,0,2,8818
68,8183,5,1356687658,1356688727,0,2,1069
68,8186,5,1356762705,1356772819,0,1,10114
68,8188,35,1356844629,1356846244,0,2,1615
68,8188,5,1356862950,1356863010,0,2,60
68,8189,11,1356874806,1356878203,0,1,3397
68,8190,35,1356927167,1356928268,0,4,1101
68,8190,428,1356928268,1356929257,0,4,989
68,8190,21,1356942356,1356943246,0,4,890
68,8190,5,1356943318,1356943354,0,4,36
69,8194,11,1360312203,1360314149,0,2,1946
69,8194,253,1360314149,1360315261,0,2,1112
69,8204,480,1334895254,1334895737,0,1,483
69,8207,8,1335256330,1335256572,0,1,242
69,8212,21,1336544390,1336544450,0,1,60
69,8214,875,1336801971,1336803143,0,1,1172
69,8226,71,1338281001,1338283296,0,1,2295
69,8274,35,1356878545,1356878605,0,1,60
70,8292,5,1333875044,1333875524,0,1,480
70,8294,5,1333978604,1333978664,0,1,60
70,8298,284,1334137512,1334137572,0,1,60
70,8301,11,1334672814,1334672874,0,1,60
70,8303,11,1334755684,1334755744,0,1,60
70,8305,11,1334841734,1334841794,0,1,60
70,8309,8,1335082574,1335084783,0,2,2209
70,8309,351,1335086664,1335086724,0,2,60
70,8317,351,1335524854,1335524914,0,1,60
70,8322,603,1336543498,1336545248,0,1,1750
70,8323,35,1336548664,1336550009,0,2,1345
70,8323,11,1336566152,1336566212,0,2,60
70,8327,11,1336896890,1336896950,0,1,60
70,8331,260,1337145830,1337145890,0,1,60
70,8333,21,1337238942,1337239646,0,2,704
70,8333,11,1337248438,1337248973,0,2,535
70,8335,11,1337347692,1337347752,0,1,60
70,8338,11,1337687068,1337687128,0,1,60
70,8339,8,1337836046,1337836936,0,1,890
70,8340,5,1337936489,1337950289,0,1,13800
70,8342,5,1338162247,1338162385,0,1,138
70,8344,5,1338248336,1338248524,0,1,188
70,8345,603,1338274598,1338278321,0,2,3723
70,8345,5,1338280285,1338280394,0,2,109
70,8346,5,1338335522,1338335608,0,1,86
70,8347,261,1338485186,1338485246,0,1,60
70,8348,284,1338695341,1338696118,0,1,777
70,8349,284,1338727685,1338729588,0,2,1903
70,8349,351,1338729588,1338729648,0,2,60
70,8350,5,1338767208,1338785493,0,1,18285
70,8351,5,1338805058,1338805716,0,2,658
70,8351,11,1338805716,1338805776,0,2,60
70,8352,5,1338853515,1338853883,0,1,368
70,8353,8,1338881826,1338882446,0,2,620
70,8353,5,1338894835,1338894895,0,2,60
70,8355,5,1339026036,1339026231,0,1,195
70,8356,5,1339056380,1339073406,0,2,17026
70,8356,5,1339074329,1339074347,0,2,18
70,8357,5,1339112235,1339112620,0,1,385
70,8360,21,1351034434,1351034494,0,1,60
70,8376,5,1357973523,1357973607,0,1,84
70,8377,5,1358207491,1358207551,0,1,60
70,8379,5,1358469635,1358469695,0,1,60
70,8381,5,1358812154,1358830688,0,1,18534
70,8384,21,1359365877,1359365937,0,1,60
70,8385,449,1359682623,1359682683,0,1,60
70,8390,5,1360712555,1360712626,0,1,71
71,8393,651,1334122565,1334122957,0,1,392
71,8396,21,1334795315,1334796674,0,1,1359
71,8397,21,1334822024,1334822218,0,1,194
71,8398,21,1336367167,1336369631,0,1,2464
71,8399,651,1336383625,1336384577,0,1,952
71,8400,21,1337036434,1337051952,0,2,15518
71,8400,5,1337052284,1337052621,0,2,337
71,8404,21,1337160440,1337160567,0,1,127
71,8406,21,1338867213,1338867273,0,1,60
71,8409,21,1339377410,1339377470,0,1,60
71,8410,21,1339578867,1339578958,0,1,91
71,8411,21,1339661437,1339671155,0,2,9718
71,8411,428,1339671155,1339672700,0,2,1545
71,8412,21,1339755029,1339755294,0,2,265
71,8412,71,1339755294,1339755843,0,2,549
71,8413,21,1340017463,1340017841,0,1,378
71,8419,765,1342169738,1342169890,0,1,152
71,8424,21,1344515998,1344516028,0,1,30
71,8425,21,1346902010,1346902070,0,1,60
71,8428,21,1350900698,1350901828,0,1,1130
71,8434,253,1353057047,1353058156,0,1,1109
71,8435,5,1353378818,1353383440,0,1,4622
71,8436,5,1353417341,1353419905,0,1,2564
71,8437,651,1353466929,1353467285,0,1,356
71,8439,5,1353542888,1353542948,0,1,60
71,8440,5,1353583078,1353583512,0,1,434
71,8443,765,1354722006,1354723432,0,1,1426
71,8445,253,1354784487,1354791571,0,1,7084
72,8471,351,1342045693,1342046680,0,1,987
72,8473,261,1342340317,1342341739,0,2,1422
72,8473,5,1342341739,1342342063,0,2,324
72,8475,261,1342430905,1342433568,0,2,2663
72,8475,284,1342433568,1342433904,0,2,336
72,8480,261,1342915926,1342915986,0,1,60
72,8481,261,1342969427,1342969487,0,1,60
72,8485,261,1343473670,1343476741,0,1,3071
72,8486,11,1343537093,1343538080,0,2,987
72,8486,351,1343538080,1343541041,0,2,2961
72,8489,5,1344162885,1344166281,0,1,3396
72,8490,261,1344209534,1344209594,0,1,60
72,8491,261,1344257497,1344257557,0,1,60
72,8492,284,1344671163,1344671928,0,1,765
72,8499,5,1345280975,1345286122,0,1,5147
72,8502,28,1346846907,1346846967,0,1,60
72,8506,260,1347697421,1347698270,0,2,849
72,8506,253,1347698270,1347699533,0,2,1263
72,8507,253,1347718723,1347718783,0,1,60
72,8508,5,1347749954,1347750480,0,1,526
72,8511,11,1350135699,1350135759,0,1,60
72,8512,428,1350466200,1350469050,0,1,2850
72,8516,5,1351074417,1351077486,0,1,3069
72,8518,261,1351170327,1351173805,0,1,3478
72,8519,5,1351249212,1351250404,0,1,1192
72,8523,5,1351600125,1351600185,0,1,60
72,8544,21,1356678176,1356678236,0,1,60
72,8545,21,1357289605,1357289665,0,1,60
72,8549,875,1359191336,1359191396,0,1,60
72,8551,5,1359775289,1359790104,0,1,14815
72,8558,8,1360545888,1360545948,0,1,60
73,8564,59,1333973633,1333974726,0,1,1093
75,8714,21,1334911709,1334913513,0,2,1804
75,8714,253,1334913513,1334925320,0,2,11807
75,8715,59,1334990387,1334991381,0,1,994
75,8731,59,1336389579,1336389627,0,2,48
75,8731,253,1336389627,1336390864,0,2,1237
75,8754,35,1337957276,1337958969,0,1,1693
75,8757,5,1338183610,1338183670,0,1,60
75,8758,8,1338203237,1338203991,0,1,754
75,8768,59,1338977273,1338978387,0,1,1114
75,8773,59,1339159557,1339161317,0,1,1760
75,8775,59,1339224826,1339226912,0,1,2086
75,8786,59,1342177269,1342178291,0,1,1022
75,8789,59,1342425573,1342425633,0,1,60
75,8815,59,1346843411,1346843471,0,1,60
75,8822,59,1350039295,1350039355,0,1,60
75,8826,253,1351329994,1351338971,0,1,8977
75,8830,765,1351637125,1351637157,0,1,32
75,8846,21,1353420674,1353421419,0,1,745
75,8847,59,1353454397,1353454408,0,1,11
75,8875,297,1355294005,1355294694,0,1,689
75,8886,253,1356251320,1356251380,0,1,60
75,8898,284,1357558625,1357559200,0,3,575
75,8898,35,1357559317,1357559549,0,3,232
75,8898,59,1357560033,1357560093,0,3,60
75,8908,59,1358246415,1358246475,0,1,60
76,8939,71,1333806084,1333806373,0,2,289
76,8939,21,1333806373,1333806433,0,2,60
76,8940,21,1333851977,1333854124,0,1,2147
76,8941,253,1333891291,1333891351,0,1,60
76,8942,253,1333976034,1333977645,0,2,1611
76,8942,21,1333977645,1333977705,0,2,60
76,8943,253,1334374388,1334375099,0,1,711
76,8944,253,1334411980,1334413468,0,2,1488
76,8944,21,1334413468,1334413528,0,2,60
76,8945,21,1334497622,1334497682,0,1,60
76,8946,21,1335100166,1335100226,0,1,60
76,8947,5,1336194767,1336195507,0,1,740
76,8948,5,1336215887,1336217451,0,3,1564
76,8948,35,1336217451,1336218603,0,3,1152
76,8948,336,1336229835,1336229895,0,3,60
76,8950,71,1336788717,1336789193,0,1,476
76,8951,71,1336811022,1336812467,0,2,1445
76,8951,284,1336821086,1336822242,0,2,1156
76,8952,5,1336835029,1336835089,0,1,60
76,8953,449,1337996581,1337997592,0,1,1011
76,8954,71,1338099795,1338100405,0,1,610
76,8955,71,1338122350,1338122645,0,2,295
76,8955,21,1338122645,1338122705,0,2,60
76,8956,21,1338686397,1338686457,0,1,60
76,8957,21,1339482618,1339499831,0,1,17213
76,8958,603,1339507162,1339508751,0,2,1589
76,8958,21,1339508751,1339508811,0,2,60
76,8959,5,1339909692,1339914722,0,1,5030
76,8960,5,1339938456,1339938917,0,2,461
76,8960,21,1339938917,1339938977,0,2,60
76,8963,5,1341651499,1341651776,0,3,277
76,8963,5,1341667863,1341668397,0,3,534
76,8963,21,1341668397,1341668457,0,3,60
76,8965,71,1341740196,1341740950,0,2,754
76,8965,21,1341754614,1341754674,0,2,60
76,8967,21,1342956345,1342957910,0,4,1565
76,8967,71,1342957910,1342959138,0,4,1228
76,8967,71,1342963884,1342964337,0,4,453
76,8967,21,1342964337,1342964397,0,4,60
76,8968,21,1343431574,1343433904,0,1,2330
76,8970,71,1344167331,1344168216,0,2,885
76,8970,21,1344174744,1344174804,0,2,60
76,8973,5,1344741748,1344750361,0,1,8613
76,8974,263,1344782764,1344782824,0,1,60
76,8975,35,1345273720,1345274573,0,1,853
76,8976,35,1345300804,1345305606,0,2,4802
76,8976,263,1345305606,1345305666,0,2,60
76,8977,253,1345339316,1345340415,0,1,1099
76,8978,5,1345378976,1345379433,0,2,457
76,8978,21,1345379433,1345379493,0,2,60
76,8979,21,1345453607,1345453979,0,3,372
76,8979,5,1345453979,1345454374,0,3,395
76,8979,21,1345462093,1345462153,0,3,60
76,8980,21,1350096712,1350101709,0,1,4997
76,8982,21,1352626205,1352626265,0,1,60
76,8983,21,1353820783,1353829854,0,1,9071
76,8985,5,1354791034,1354791575,0,1,541
76,8989,5,1355022174,1355022395,0,1,221
76,8990,5,1355056712,1355056772,0,1,60
76,8991,253,1355572130,1355573027,0,2,897
76,8991,263,1355585542,1355585602,0,2,60
76,8993,253,1357128272,1357128332,0,1,60
76,8995,261,1357225221,1357225281,0,1,60
76,8997,5,1357968153,1357970520,0,1,2367
76,9000,21,1358124101,1358128855,0,2,4754
76,9000,21,1358140757,1358140817,0,2,60
76,9001,21,1359166121,1359169207,0,1,3086
76,9002,263,1359211405,1359211465,0,1,60
76,9006,5,1359870938,1359882560,0,3,11622
76,9006,5,1359882560,1359884432,0,3,1872
76,9006,253,1359884432,1359886261,0,3,1829
76,9007,21,1359896974,1359897034,0,1,60
76,9008,21,1360547607,1360548583,0,3,976
76,9008,35,1360548583,1360561088,0,3,12505
76,9008,5,1360561088,1360565953,0,3,4865
77,9009,21,1360589840,1360589900,0,1,60
77,9013,284,1334566319,1334566379,0,1,60
77,9015,284,1335172046,1335172074,0,1,28
77,9016,284,1335430998,1335431380,0,2,382
77,9016,35,1335431380,1335431557,0,2,177
77,9017,284,1335571032,1335571092,0,1,60
77,9019,284,1335949467,1335949483,0,1,16
77,9023,284,1336986374,1336986389,0,1,15
77,9024,284,1337072559,1337072572,0,1,13
77,9025,284,1337158810,1337158834,0,1,24
77,9026,284,1337244635,1337244695,0,1,60
77,9028,284,1337677498,1337677538,0,1,40
77,9029,284,1337849685,1337849709,0,1,24
77,9030,284,1337936476,1337936504,0,1,28
77,9032,284,1338195221,1338195269,0,1,48
77,9034,284,1338801049,1338801079,0,1,30
77,9035,284,1338886268,1338886330,0,1,62
77,9036,284,1338973335,1338973395,0,1,60
77,9037,284,1339060090,1339060197,0,1,107
77,9038,284,1339405474,1339405534,0,1,60
77,9040,284,1340010305,1340010327,0,1,22
77,9041,284,1340270359,1340270371,0,1,12
77,9042,284,1340794701,1340794708,0,1,7
77,9043,284,1341825997,1341826057,0,1,60
77,9044,284,1342000000,1342000018,0,1,18
77,9045,284,1342172237,1342172577,0,2,340
77,9045,35,1342172577,1342172715,0,2,138
77,9046,35,1343455065,1343467977,0,1,12912
77,9051,35,1347526938,1347526957,0,1,19
77,9060,35,1353204808,1353205347,0,1,539
77,9068,35,1359710079,1359710204,0,1,125
78,9070,35,1333834524,1333835231,0,2,707
78,9070,253,1333852198,1333852913,0,2,715
78,9071,253,1333885303,1333885363,0,1,60
78,9072,5,1333886810,1333887413,0,3,603
78,9072,5,1333892126,1333893102,0,3,976
78,9072,35,1333893102,1333894542,0,3,1440
78,9073,35,1334352312,1334352981,0,3,669
78,9073,35,1334369884,1334371355,0,3,1471
78,9073,5,1334371355,1334371799,0,3,444
78,9075,35,1334407067,1334407388,0,1,321
78,9076,35,1336171416,1336181661,0,3,10245
78,9076,35,1336181933,1336183371,0,3,1438
78,9076,284,1336188572,1336188910,0,3,338
78,9077,5,1336195279,1336199143,0,2,3864
78,9077,297,1336205564,1336211745,0,2,6181
78,9078,35,1336219823,1336223620,0,2,3797
78,9078,5,1336225207,1336226700,0,2,1493
78,9079,35,1339196982,1339197587,0,1,605
78,9080,253,1339224816,1339225264,0,3,448
78,9080,253,1339241864,1339243449,0,3,1585
78,9080,5,1339243449,1339243894,0,3,445
78,9081,5,1339249828,1339251604,0,2,1776
78,9081,284,1339251604,1339253145,0,2,1541
78,9082,284,1339295025,1339296083,0,2,1058
78,9082,253,1339296083,1339296385,0,2,302
78,9083,253,1339327722,1339329438,0,3,1716
78,9083,5,1339329438,1339330018,0,3,580
78,9083,35,1339337009,1339337287,0,3,278
78,9085,428,1344177277,1344178518,0,2,1241
78,9085,284,1344178518,1344180263,0,2,1745
78,9086,284,1344213278,1344213338,0,1,60
78,9087,260,1344254256,1344255832,0,2,1576
78,9087,35,1344255832,1344255960,0,2,128
79,9094,640,1334978706,1334980090,0,2,1384
79,9094,5,1334980090,1334980334,0,2,244
79,9095,5,1335016446,1335018169,0,2,1723
79,9095,284,1335018169,1335018229,0,2,60
79,9099,284,1335663519,1335663921,0,2,402
79,9099,284,1335679603,1335681230,0,2,1627
79,9102,284,1336136751,1336136953,0,1,202
79,9103,640,1336185321,1336185378,0,2,57
79,9103,35,1336185847,1336185886,0,2,39
79,9104,35,1336209747,1336211690,0,1,1943
79,9110,640,1338108801,1338108820,0,2,19
79,9110,253,1338109721,1338110691,0,2,970
79,9111,640,1338126032,1338126092,0,1,60
79,9117,35,1341631135,1341631209,0,1,74
79,9121,35,1343451795,1343452661,0,3,866
79,9121,5,1343452661,1343461380,0,3,8719
79,9121,284,1343470303,1343471717,0,3,1414
79,9122,284,1343541958,1343541973,0,1,15
79,9123,284,1344154140,1344154901,0,1,761
79,9126,284,1344740754,1344740814,0,1,60
79,9129,640,1347676039,1347677767,0,2,1728
79,9129,260,1347677767,1347688538,0,2,10771
79,9135,253,1351401871,1351402424,0,1,553
79,9139,35,1353246541,1353246601,0,1,60
79,9140,640,1353749467,1353749556,0,1,89
79,9141,284,1353805553,1353805912,0,1,359
79,9149,11,1357276918,1357279056,0,1,2138
79,9157,5,1360316200,1360321690,0,1,5490
80,9158,5,1360552392,1360552452,0,1,60
80,9159,11,1333535009,1333535069,0,1,60
80,9162,765,1333617778,1333617838,0,1,60
80,9163,5,1333970901,1333970961,0,1,60
80,9177,8,1336995232,1336995292,0,1,60
80,9182,8,1338207327,1338207711,0,2,384
80,9182,5,1338207711,1338207771,0,2,60
80,9190,71,1341214698,1341214762,0,1,64
80,9192,449,1341550270,1341552202,0,1,1932
80,9198,71,1344927208,1344927268,0,1,60
80,9203,449,1350954577,1350956001,0,1,1424
80,9211,5,1351861055,1351861115,0,1,60
80,9215,5,1352466030,1352466090,0,1,60
80,9219,765,1352804157,1352804217,0,1,60
80,9220,8,1353581366,1353585256,0,1,3890
80,9221,5,1353672472,1353673958,0,2,1486
80,9221,8,1353673958,1353674018,0,2,60
80,9225,449,1354606462,1354607582,0,2,1120
80,9225,21,1354621648,1354621708,0,2,60
80,9239,21,1357371725,1357372969,0,3,1244
80,9239,284,1357372969,1357374347,0,3,1378
80,9239,640,1357389625,1357389685,0,3,60
80,9243,8,1357904722,1357904782,0,1,60
80,9244,449,1358766571,1358766631,0,1,60
80,9249,8,1359718848,1359722364,0,2,3516
80,9249,21,1359722364,1359722424,0,2,60
80,9250,260,1359976631,1359976691,0,1,60
81,9259,77,1333516358,1333518489,0,2,2131
81,9259,651,1333518489,1333518549,0,2,60
81,9260,77,1333616521,1333616581,0,1,60
81,9261,212,1333861169,1333861229,0,1,60
81,9262,651,1333926453,1333926513,0,1,60
81,9263,77,1334133768,1334136709,0,2,2941
81,9263,875,1334136709,1334137504,0,2,795
81,9265,212,1334266854,1334266914,0,1,60
81,9266,212,1334570271,1334570331,0,1,60
81,9267,212,1334672505,1334672565,0,1,60
81,9268,651,1334702455,1334702515,0,1,60
81,9271,77,1334911394,1334912792,0,2,1398
81,9271,35,1334912792,1334923217,0,2,10425
81,9273,875,1335131277,1335131337,0,1,60
81,9274,875,1335173330,1335173710,0,1,380
81,9275,212,1335217201,1335217261,0,1,60
81,9276,875,1335432785,1335433748,0,1,963
81,9280,212,1335686938,1335690561,0,2,3623
81,9280,253,1335690561,1335690621,0,2,60
81,9283,77,1336345503,1336345563,0,1,60
81,9284,35,1336381762,1336381822,0,1,60
81,9285,212,1336554878,1336554938,0,1,60
81,9287,651,1336720078,1336727113,0,2,7035
81,9287,260,1336727113,1336728390,0,2,1277
81,9288,212,1336741712,1336741772,0,1,60
81,9293,77,1336983892,1336985097,0,2,1205
81,9293,253,1336985097,1336987501,0,2,2404
81,9294,875,1337033417,1337033477,0,1,60
81,9295,77,1337123155,1337123215,0,1,60
81,9297,77,1337682643,1337682703,0,1,60
81,9299,77,1337946224,1337949354,0,2,3130
81,9299,212,1337949354,1337949414,0,2,60
81,9302,35,1338086807,1338089962,0,2,3155
81,9302,212,1338107566,1338107626,0,2,60
81,9303,77,1338159956,1338160016,0,1,60
81,9304,260,1338295087,1338295147,0,1,60
81,9306,651,1338764161,1338764221,0,1,60
81,9309,35,1339059461,1339061029,0,1,1568
81,9310,35,1339168115,1339168175,0,1,60
81,9312,77,1339403229,1339403289,0,1,60
81,9313,875,1339492125,1339492185,0,1,60
81,9314,77,1339542127,1339542187,0,1,60
81,9315,651,1339577318,1339577378,0,1,60
81,9316,35,1340009587,1340010094,0,1,507
81,9320,212,1341482692,1341482752,0,1,60
81,9322,651,1341813374,1341814011,0,2,637
81,9322,5,1341814011,1341816695,0,2,2684
81,9324,651,1341985513,1341994272,0,1,8759
81,9326,212,1342194068,1342194128,0,1,60
81,9329,651,1342479620,1342495568,0,1,15948
81,9331,651,1342565507,1342565567,0,1,60
81,9334,212,1344204441,1344207465,0,2,3024
81,9334,651,1344207465,1344207525,0,2,60
81,9336,651,1344502432,1344503571,0,1,1139
81,9337,212,1344591266,1344604228,0,1,12962
81,9338,651,1344812135,1344832128,0,1,19993
81,9343,875,1345414977,1345417786,0,2,2809
81,9343,77,1345417786,1345417846,0,2,60
81,9344,875,1345454936,1345455713,0,1,777
81,9347,651,1347232185,1347232245,0,1,60
81,9354,651,1352156850,1352156910,0,1,60
81,9356,651,1352761542,1352761602,0,1,60
81,9357,875,1352801493,1352801553,0,1,60
81,9359,651,1353575370,1353575430,0,1,60
81,9364,651,1355094654,1355094714,0,1,60
81,9365,21,1355346558,1355346618,0,1,60
81,9366,336,1355556753,1355556813,0,1,60
81,9367,651,1355822561,1355822621,0,1,60
81,9368,651,1356045127,1356045187,0,1,60
81,9370,21,1356673963,1356674023,0,1,60
81,9371,35,1356770645,1356770705,0,1,60
81,9375,875,1358202493,1358202553,0,1,60
81,9377,875,1358413933,1358413993,0,1,60
82,9402,59,1336212003,1336213445,0,1,1442
82,9403,21,1336362810,1336363197,0,2,387
82,9403,480,1336363197,1336364652,0,2,1455
82,9435,5,1351407057,1351407529,0,1,472
82,9441,59,1353731976,1353732778,0,1,802
82,9444,5,1355038648,1355042054,0,1,3406
82,9456,59,1357274027,1357274189,0,1,162
82,9458,480,1357444637,1357458209,0,2,13572
82,9458,603,1357458209,1357458269,0,2,60
82,9459,59,1357475811,1357477357,0,1,1546
83,9469,603,1334463652,1334463712,0,1,60
83,9480,284,1341627369,1341627429,0,1,60
83,9481,284,1341671906,1341671966,0,1,60
83,9482,5,1341730922,1341731225,0,1,303
83,9494,284,1346838848,1346838908,0,1,60
83,9497,253,1347715244,1347717779,0,1,2535
83,9499,284,1350602263,1350602323,0,1,60
83,9500,284,1351321770,1351321830,0,1,60
83,9501,351,1351403269,1351404718,0,2,1449
83,9501,284,1351411849,1351411909,0,2,60
83,9502,284,1351783284,1351784137,0,2,853
83,9502,35,1351784137,1351784197,0,2,60
83,9505,284,1353580312,1353580881,0,1,569
83,9506,284,1353667055,1353667115,0,1,60
83,9508,35,1353809713,1353826081,0,2,16368
83,9508,284,1353829202,1353829262,0,2,60
83,9509,284,1354341079,1354341139,0,1,60
83,9512,284,1355023533,1355036827,0,1,13294
83,9515,284,1355699872,1355699932,0,1,60
83,9516,284,1355824537,1355824597,0,1,60
83,9519,35,1357338667,1357338727,0,1,60
83,9520,480,1357368592,1357368652,0,1,60
83,9521,284,1357450332,1357451709,0,1,1377
83,9523,284,1358464811,1358464871,0,1,60
83,9524,284,1359184045,1359184751,0,4,706
83,9524,351,1359184751,1359186189,0,4,1438
83,9524,351,1359190045,1359190992,0,4,947
83,9524,284,1359190992,1359191709,0,4,717
83,9525,284,1359415394,1359415454,0,1,60
84,9538,8,1340800030,1340802463,0,1,2433
84,9541,8,1341404969,1341406571,0,1,1602
84,9544,8,1341573978,1341574038,0,1,60
84,9548,8,1342001769,1342001829,0,1,60
84,9554,5,1343446751,1343446811,0,1,60
84,9559,21,1349698482,1349698542,0,1,60
84,9560,35,1350385376,1350385436,0,1,60
84,9564,5,1351754523,1351755661,0,2,1138
84,9564,765,1351755661,1351755721,0,2,60
84,9566,5,1352700769,1352700829,0,1,60
84,9576,480,1354439664,1354440119,0,1,455
84,9587,5,1357362000,1357373249,0,1,11249
84,9589,8,1357901298,1357901358,0,1,60
85,9596,212,1334460593,1334460640,0,1,47
85,9655,1005,1341116243,1341116969,0,1,726
85,9669,21,1342236824,1342238119,0,1,1295
85,9681,35,1344675725,1344677418,0,2,1693
85,9681,35,1344688953,1344689832,0,2,879
85,9711,8,1355637257,1355643014,0,1,5757
85,9723,5,1359184271,1359186660,0,1,2389
86,9732,8,1360824307,1360824939,0,1,632
86,9740,71,1333983055,1333983982,0,1,927
86,9746,297,1334212836,1334214303,0,3,1467
86,9746,449,1334214303,1334221656,0,3,7353
86,9746,449,1334221656,1334223733,0,3,2077
86,9748,297,1334299700,1334300774,0,3,1074
86,9748,428,1334300774,1334307766,0,3,6992
86,9748,428,1334307766,1334308949,0,3,1183
86,9754,253,1334669434,1334670022,0,1,588
86,9758,71,1334841734,1334843048,0,1,1314
86,9771,21,1335529075,1335530416,0,3,1341
86,9771,603,1335530416,1335531065,0,3,649
86,9771,875,1335538036,1335538096,0,3,60
86,9776,5,1335940019,1335941184,0,2,1165
86,9776,21,1335941479,1335942985,0,2,1506
86,9779,21,1336114293,1336114353,0,1,60
86,9782,297,1336490536,1336491132,0,1,596
86,9784,297,1336567496,1336570227,0,1,2731
86,9804,5,1338018776,1338019546,0,1,770
86,9815,428,1338541758,1338551268,0,1,9510
86,9816,297,1338680541,1338680895,0,1,354
86,9820,449,1338783507,1338799926,0,2,16419
86,9820,5,1338802160,1338802220,0,2,60
86,9823,71,1338897904,1338901732,0,1,3828
86,9833,253,1339513099,1339513159,0,1,60
86,9843,1005,1340769385,1340769445,0,1,60
86,9847,5,1341217308,1341229600,0,1,12292
86,9855,253,1341587262,1341590674,0,1,3412
86,9866,428,1342071912,1342081008,0,1,9096
86,9867,253,1342108490,1342108550,0,1,60
86,9878,35,1342622965,1342623603,0,1,638
86,9899,253,1345475536,1345475596,0,1,60
86,9901,253,1346860457,1346860895,0,1,438
86,9926,253,1351610709,1351610769,0,1,60
86,9928,253,1351697327,1351697387,0,1,60
86,9932,449,1352166361,1352174225,0,1,7864
86,9935,253,1352302506,1352304248,0,1,1742
86,9942,253,1353945310,1353946993,0,1,1683
86,9946,253,1354117968,1354118028,0,1,60
86,9954,253,1354721654,1354721714,0,1,60
86,9956,21,1354791530,1354791590,0,1,60
86,9957,21,1355047402,1355051860,0,1,4458
86,9960,253,1355241358,1355242016,0,1,658
86,9967,5,1355646894,1355647568,0,1,674
86,9981,428,1357698977,1357699037,0,1,60
86,9988,21,1358032442,1358032502,0,1,60
86,9994,449,1358814047,1358814107,0,1,60
86,9996,21,1359111002,1359111062,0,1,60
86,9997,297,1359331265,1359331325,0,1,60
86,10001,253,1359558201,1359562659,0,1,4458
87,10058,71,1336693001,1336706240,0,1,13239
87,10060,284,1336775385,1336775445,0,1,60
87,10137,21,1354052937,1354052997,0,1,60
87,10142,8,1356249325,1356251732,0,1,2407
88,10165,35,1333877035,1333877372,0,1,337
88,10172,21,1335167492,1335167552,0,1,60
88,10184,8,1336994766,1336995015,0,2,249
88,10184,5,1336995049,1336996310,0,2,1261
88,10187,59,1337135813,1337135873,0,1,60
88,10190,21,1337237834,1337237869,0,1,35
88,10193,11,1337421339,1337421387,0,1,48
88,10200,11,1338091938,1338096858,0,1,4920
88,10216,11,1338894344,1338898913,0,1,4569
88,10221,35,1339203551,1339215728,0,1,12177
88,10244,5,1341227986,1341228070,0,1,84
88,10258,5,1347623919,1347624013,0,1,94
88,10260,5,1350095696,1350095756,0,1,60
88,10263,5,1351407154,1351416095,0,1,8941
89,10305,351,1338803449,1338817008,0,2,13559
89,10305,351,1338817008,1338818779,0,2,1771
89,10312,351,1341267597,1341287215,0,1,19618
89,10315,351,1341517311,1341517371,0,1,60
89,10330,21,1351077399,1351077459,0,1,60
89,10336,21,1351599686,1351599746,0,1,60
89,10348,263,1353598921,1353598981,0,1,60
89,10362,351,1357030218,1357030278,0,1,60
89,10364,351,1357289884,1357289944,0,1,60
89,10377,351,1360052400,1360054405,0,1,2005
90,10385,35,1333536278,1333536338,0,1,60
90,10386,253,1333621605,1333621665,0,1,60
90,10387,253,1333844055,1333851510,0,1,7455
90,10388,284,1333871659,1333871719,0,1,60
90,10390,35,1334047084,1334049940,0,1,2856
90,10391,35,1334228266,1334228326,0,1,60
90,10392,35,1334314816,1334314876,0,1,60
90,10393,253,1334361202,1334361262,0,1,60
90,10395,35,1334661129,1334661189,0,1,60
90,10396,35,1334701768,1334701828,0,1,60
90,10397,35,1334789318,1334789378,0,1,60
90,10400,253,1335052495,1335052555,0,1,60
90,10401,253,1335096295,1335096355,0,1,60
90,10402,253,1335191410,1335191470,0,1,60
90,10403,284,1335277297,1335277357,0,1,60
90,10404,35,1335307308,1335307368,0,1,60
90,10406,35,1335437199,1335437259,0,1,60
90,10407,5,1335610225,1335610285,0,1,60
90,10409,253,1335656838,1335676887,0,1,20049
90,10410,253,1335692056,1335692116,0,1,60
90,10411,35,1335914399,1335914459,0,1,60
90,10414,35,1336084832,1336084892,0,1,60
90,10415,284,1336384720,1336388397,0,1,3677
90,10416,35,1336564314,1336564374,0,1,60
90,10418,253,1336807726,1336813777,0,2,6051
90,10418,71,1336815396,1336815456,0,2,60
90,10422,35,1337122431,1337122491,0,1,60
90,10424,35,1337606863,1337606923,0,1,60
90,10426,35,1337813639,1337813699,0,1,60
90,10427,35,1338251923,1338251983,0,1,60
90,10428,35,1338554344,1338554404,0,1,60
90,10429,253,1338686993,1338687053,0,1,60
90,10430,35,1338855837,1338855897,0,1,60
90,10431,253,1339057963,1339058023,0,1,60
90,10432,35,1339108875,1339108935,0,1,60
90,10433,35,1339513110,1339513170,0,1,60
90,10434,253,1339582157,1339582217,0,1,60
90,10435,35,1340025740,1340025800,0,1,60
90,10436,35,1340231984,1340232044,0,1,60
90,10438,35,1340619401,1340619461,0,1,60
90,10440,253,1341563847,1341563907,0,1,60
90,10441,35,1341790979,1341791039,0,1,60
90,10442,35,1342171408,1342172010,0,1,602
90,10443,5,1342270571,1342270631,0,1,60
90,10444,5,1342356177,1342356237,0,1,60
90,10446,35,1342538291,1342538351,0,1,60
90,10447,253,1343474751,1343474811,0,1,60
90,10449,35,1343624659,1343624719,0,1,60
90,10451,253,1344577236,1344578130,0,1,894
90,10455,35,1345129145,1345129205,0,1,60
90,10456,35,1345213532,1345213592,0,1,60
90,10461,5,1350138074,1350138134,0,1,60
90,10462,284,1350384244,1350385086,0,1,842
90,10465,21,1350964676,1350967428,0,1,2752
90,10466,35,1351065495,1351065555,0,1,60
90,10474,35,1351849275,1351858941,0,1,9666
90,10475,35,1352110456,1352113733,0,1,3277
90,10476,253,1352370226,1352375841,0,1,5615
90,10477,253,1352593765,1352593825,0,1,60
90,10479,11,1353056353,1353056413,0,1,60
90,10481,284,1353252532,1353252592,0,1,60
90,10482,28,1353803228,1353803288,0,1,60
90,10487,284,1354519455,1354519515,0,1,60
90,10488,253,1354709875,1354709935,0,1,60
90,10489,5,1354967264,1354967324,0,1,60
90,10490,35,1355842682,1355842742,0,1,60
90,10492,35,1356266547,1356266607,0,1,60
90,10493,21,1356789852,1356789912,0,1,60
90,10494,765,1357128872,1357128932,0,1,60
90,10495,8,1357292808,1357292868,0,1,60
90,10496,35,1357346536,1357346596,0,1,60
90,10499,35,1358843578,1358844266,0,1,688
90,10501,21,1359159669,1359159729,0,1,60
90,10506,284,1360233221,1360233702,0,1,481
91,10511,35,1360841219,1360843619,0,1,2400
91,10548,59,1339337509,1339339058,0,1,1549
91,10575,284,1345302863,1345303926,0,2,1063
91,10575,59,1345303926,1345303986,0,2,60
91,10592,449,1351397915,1351416921,0,1,19006
91,10611,640,1359772685,1359772734,0,1,49
91,10612,640,1359806724,1359817819,0,1,11095
92,10628,11,1334313017,1334313077,0,1,60
92,10634,21,1335529717,1335529777,0,1,60
92,10669,284,1340793291,1340793351,0,1,60
92,10699,21,1347542929,1347542989,0,1,60
92,10730,21,1357860450,1357860510,0,1,60
92,10734,5,1359355674,1359356340,0,1,666
92,10744,35,1360670988,1360671048,0,1,60
93,10810,21,1356088271,1356088331,0,1,60
94,10824,11,1333540463,1333541143,0,1,680
94,10825,21,1333891461,1333893138,0,1,1677
94,10826,11,1333922351,1333922411,0,1,60
94,10827,11,1334010494,1334010554,0,1,60
94,10828,11,1334136721,1334136781,0,1,60
94,10829,11,1334183431,1334183491,0,1,60
94,10831,11,1334268174,1334268234,0,1,60
94,10832,5,1334308893,1334309765,0,1,872
94,10835,11,1334701774,1334701834,0,1,60
94,10837,11,1335133943,1335134003,0,1,60
94,10838,11,1335258665,1335259095,0,1,430
94,10839,11,1335438139,1335438199,0,1,60
94,10843,11,1336515973,1336516033,0,1,60
94,10847,11,1336948135,1336948195,0,1,60
94,10852,11,1337639501,1337639561,0,1,60
94,10854,5,1337936872,1337948105,0,1,11233
94,10856,11,1338202470,1338202530,0,1,60
94,10862,253,1339493476,1339493536,0,1,60
94,10863,297,1339939852,1339939912,0,1,60
94,10865,11,1340276623,1340277157,0,1,534
94,10869,11,1341400380,1341401995,0,1,1615
94,10871,21,1341665268,1341665328,0,1,60
94,10872,21,1341754645,1341754705,0,1,60
94,10873,11,1341786684,1341786744,0,1,60
94,10875,11,1342173916,1342173976,0,1,60
94,10878,8,1342424841,1342432316,0,1,7475
94,10882,11,1343478444,1343478504,0,1,60
94,10886,284,1344922835,1344924053,0,1,1218
94,10893,284,1351139812,1351140132,0,1,320
94,10902,284,1353220399,1353220459,0,1,60
94,10905,297,1353680790,1353680850,0,1,60
94,10907,35,1353875294,1353875354,0,1,60
94,10908,284,1353903038,1353903733,0,2,695
94,10908,35,1353920525,1353920585,0,2,60
94,10912,765,1355553420,1355553813,0,1,393
94,10915,11,1356087889,1356087949,0,1,60
94,10919,21,1357482085,1357482145,0,1,60
94,10920,11,1357556326,1357557890,0,1,1564
94,10924,5,1358054513,1358054573,0,1,60
95,10984,480,1344157677,1344159321,0,1,1644
95,10992,765,1350893374,1350893434,0,1,60
96,11016,35,1333488667,1333489709,0,1,1042
96,11018,253,1333623872,1333627359,0,1,3487
96,11023,253,1334265798,1334265858,0,1,60
96,11024,104,1334307793,1334309575,0,1,1782
96,11026,253,1334573434,1334573494,0,1,60
96,11029,253,1334984893,1334985430,0,1,537
96,11030,253,1335007612,1335008906,0,1,1294
96,11031,253,1335066498,1335067218,0,3,720
96,11031,35,1335067218,1335068513,0,3,1295
96,11031,35,1335072069,1335072592,0,3,523
96,11032,35,1335087435,1335088287,0,2,852
96,11032,253,1335088287,1335089035,0,2,748
96,11033,35,1335130203,1335130350,0,1,147
96,11045,253,1336490447,1336491993,0,1,1546
96,11046,253,1336555914,1336556489,0,2,575
96,11046,253,1336565212,1336566574,0,2,1362
96,11047,253,1336687442,1336687502,0,1,60
96,11050,104,1336922720,1336923376,0,1,656
96,11051,253,1336947704,1336947764,0,1,60
96,11052,253,1337165626,1337166401,0,4,775
96,11052,35,1337166401,1337166872,0,4,471
96,11052,35,1337176333,1337176915,0,4,582
96,11052,253,1337176915,1337178518,0,4,1603
96,11053,104,1337280438,1337280705,0,1,267
96,11055,253,1337807028,1337807253,0,1,225
96,11057,253,1337940910,1337940970,0,1,60
96,11063,35,1338478918,1338480088,0,2,1170
96,11063,253,1338480088,1338483827,0,2,3739
96,11064,253,1338541318,1338541578,0,1,260
96,11066,253,1338718256,1338719625,0,2,1369
96,11066,35,1338730662,1338733772,0,2,3110
96,11068,253,1338807231,1338808735,0,1,1504
96,11069,253,1338849273,1338849856,0,2,583
96,11069,35,1338849856,1338850103,0,2,247
96,11071,35,1338897946,1338898694,0,2,748
96,11071,253,1338898694,1338899993,0,2,1299
96,11074,253,1340623920,1340625469,0,1,1549
96,11076,253,1340799473,1340800793,0,1,1320
96,11078,253,1341226829,1341227218,0,1,389
96,11079,253,1341258732,1341260981,0,1,2249
96,11081,253,1341413831,1341415504,0,1,1673
96,11084,253,1341551285,1341551984,0,1,699
96,11088,253,1341738450,1341738972,0,4,522
96,11088,35,1341746678,1341747217,0,4,539
96,11088,35,1341756404,1341757419,0,4,1015
96,11088,253,1341757419,1341757479,0,4,60
96,11089,253,1341827857,1341831733,0,2,3876
96,11089,253,1341833874,1341835365,0,2,1491
96,11091,253,1342175843,1342176843,0,1,1000
96,11095,253,1342537262,1342538489,0,1,1227
96,11097,253,1343432169,1343433036,0,2,867
96,11097,35,1343433036,1343434034,0,2,998
96,11099,35,1343563234,1343571640,0,1,8406
96,11100,253,1344152927,1344154163,0,2,1236
96,11100,11,1344160204,1344160264,0,2,60
96,11101,11,1344261337,1344261397,0,1,60
96,11104,35,1346837606,1346838109,0,2,503
96,11104,253,1346838109,1346838231,0,2,122
96,11106,35,1347201686,1347205730,0,1,4044
96,11108,253,1347692538,1347695107,0,2,2569
96,11108,253,1347706127,1347706187,0,2,60
96,11109,11,1349703416,1349706045,0,1,2629
96,11111,253,1350015768,1350016694,0,2,926
96,11111,253,1350028226,1350028663,0,2,437
96,11114,253,1350099136,1350099975,0,2,839
96,11114,253,1350115081,1350115869,0,2,788
96,11115,253,1350380826,1350383046,0,1,2220
96,11117,253,1350661283,1350663591,0,1,2308
96,11118,253,1350912238,1350914468,0,1,2230
96,11120,253,1350987390,1350987450,0,1,60
96,11122,77,1351055971,1351056939,0,4,968
96,11122,2151,1351057757,1351059066,0,4,1309
96,11122,2151,1351071962,1351072995,0,4,1033
96,11122,77,1351074296,1351074664,0,4,368
96,11124,875,1351163202,1351163727,0,2,525
96,11124,875,1351176708,1351180604,0,2,3896
96,11125,253,1351236505,1351237567,0,1,1062
96,11127,253,1351313213,1351313724,0,1,511
96,11128,35,1351337549,1351340239,0,2,2690
96,11128,35,1351350282,1351353395,0,2,3113
96,11129,253,1351473719,1351485146,0,1,11427
96,11131,253,1351656459,1351657553,0,1,1094
96,11132,253,1351683491,1351683551,0,1,60
96,11133,253,1351706902,1351706962,0,1,60
96,11134,253,1351742007,1351745960,0,2,3953
96,11134,253,1351752738,1351754229,0,2,1491
96,11135,253,1351769828,1351770280,0,2,452
96,11135,253,1351773780,1351775440,0,2,1660
96,11138,35,1352149638,1352149698,0,1,60
96,11139,253,1352608934,1352609951,0,1,1017
96,11140,253,1352637910,1352639679,0,1,1769
96,11141,253,1352712524,1352713086,0,1,562
96,11143,253,1352775076,1352775136,0,1,60
96,11144,253,1352801947,1352803726,0,1,1779
96,11145,253,1353027564,1353039394,0,1,11830
96,11146,253,1353059931,1353061131,0,2,1200
96,11146,253,1353070384,1353070444,0,2,60
96,11147,253,1354335762,1354346725,0,1,10963
96,11148,253,1354360147,1354361282,0,1,1135
96,11149,284,1354428666,1354430341,0,1,1675
96,11150,253,1354444595,1354448920,0,2,4325
96,11150,253,1354448941,1354450577,0,2,1636
96,11151,253,1354513904,1354516291,0,1,2387
96,11152,253,1354547929,1354547989,0,1,60
96,11153,253,1354588334,1354590095,0,1,1761
96,11154,35,1354632095,1354632599,0,2,504
96,11154,253,1354632599,1354634716,0,2,2117
96,11155,875,1354684320,1354687739,0,3,3419
96,11155,253,1354689015,1354689023,0,3,8
96,11155,253,1354689852,1354690925,0,3,1073
96,11157,253,1354780290,1354783786,0,1,3496
96,11158,35,1354797626,1354797682,0,1,56
96,11160,253,1354937823,1354950548,0,4,12725
96,11160,640,1354951470,1354954377,0,4,2907
96,11160,253,1354954386,1354955650,0,4,1264
96,11160,35,1354955650,1354955710,0,4,60
96,11161,253,1354969321,1354969381,0,1,60
96,11162,253,1355021560,1355022072,0,2,512
96,11162,35,1355022072,1355028553,0,2,6481
96,11165,253,1355172213,1355172273,0,1,60
96,11166,253,1355236168,1355238085,0,1,1917
96,11167,253,1355264725,1355264785,0,1,60
96,11168,253,1355350445,1355350931,0,4,486
96,11168,35,1355350931,1355360805,0,4,9874
96,11168,35,1355360805,1355361678,0,4,873
96,11168,253,1355361678,1355363623,0,4,1945
96,11174,253,1356880613,1356880673,0,1,60
96,11176,35,1357398768,1357399157,0,2,389
96,11176,253,1357399157,1357399217,0,2,60
96,11177,253,1357806144,1357812291,0,2,6147
96,11177,253,1357821338,1357821398,0,2,60
96,11178,77,1358054707,1358056066,0,3,1359
96,11178,35,1358066748,1358067286,0,3,538
96,11178,253,1358067286,1358067346,0,3,60
96,11180,77,1358121915,1358128044,0,1,6129
96,11181,11,1358148503,1358151956,0,1,3453
96,11183,253,1358519274,1358520678,0,1,1404
96,11184,253,1358850516,1358851169,0,2,653
96,11184,253,1358862593,1358862653,0,2,60
96,11185,253,1359021616,1359022844,0,1,1228
96,11187,253,1359209042,1359209102,0,1,60
96,11188,77,1359242116,1359242176,0,1,60
96,11190,253,1359293432,1359293492,0,1,60
96,11191,284,1359466065,1359467908,0,2,1843
96,11191,253,1359467908,1359467968,0,2,60
96,11192,253,1359621885,1359622585,0,1,700
96,11195,253,1359786526,1359787540,0,1,1014
96,11197,253,1359884882,1359886862,0,1,1980
96,11200,253,1360232691,1360246148,0,1,13457
96,11204,253,1360750424,1360751441,0,3,1017
96,11204,35,1360751441,1360753616,0,3,2175
96,11204,253,1360768305,1360768365,0,3,60
97,11281,351,1353157357,1353157417,0,1,60
98,11298,449,1334104791,1334116466,0,2,11675
98,11298,449,1334116575,1334119302,0,2,2727
98,11309,253,1335239138,1335239198,0,1,60
98,11320,640,1337078666,1337079085,0,1,419
98,11327,640,1338161779,1338165040,0,2,3261
98,11327,21,1338165040,1338165100,0,2,60
98,11333,35,1339386338,1339387096,0,3,758
98,11333,253,1339387096,1339389560,0,3,2464
98,11333,59,1339389600,1339389660,0,3,60
98,11334,253,1339413245,1339413305,0,1,60
98,11344,1005,1341277072,1341277098,0,2,26
98,11344,765,1341277106,1341281354,0,2,4248
98,11347,640,1342094197,1342094257,0,1,60
98,11348,640,1342173021,1342173081,0,1,60
98,11350,35,1342422217,1342425945,0,1,3728
98,11352,35,1343119509,1343119527,0,1,18
98,11355,640,1344655021,1344657474,0,2,2453
98,11355,5,1344657474,1344657563,0,2,89
98,11360,449,1345292047,1345292057,0,1,10
98,11361,1005,1345351050,1345351057,0,2,7
98,11361,765,1345351061,1345351121,0,2,60
98,11365,640,1349688742,1349688748,0,1,6
98,11367,28,1350112839,1350119795,0,2,6956
98,11367,253,1350119795,1350119828,0,2,33
98,11372,640,1350965573,1350965633,0,1,60
98,11373,35,1350986468,1350986695,0,1,227
98,11374,35,1351022498,1351023502,0,1,1004
98,11375,35,1351072709,1351072769,0,1,60
98,11378,8,1351334219,1351335124,0,1,905
98,11381,640,1351392981,1351393041,0,1,60
98,11383,640,1351496141,1351496201,0,1,60
98,11393,640,1352786006,1352786066,0,1,60
98,11396,640,1353092379,1353093789,0,1,1410
98,11397,640,1353130471,1353130471,0,1,0
98,11401,640,1353461827,1353463177,0,1,1350
98,11403,35,1353532125,1353532185,0,1,60
98,11404,35,1353583561,1353583737,0,1,176
98,11405,640,1353638153,1353638153,0,3,0
98,11405,35,1353638925,1353639476,0,3,551
98,11405,35,1353658720,1353658780,0,3,60
98,11406,640,1353662071,1353662072,0,1,1
98,11407,260,1353731656,1353731716,0,1,60
98,11412,5,1354341645,1354353357,0,1,11712
98,11413,35,1354440157,1354440413,0,1,256
98,11414,35,1354531194,1354531567,0,2,373
98,11414,640,1354531567,1354547216,0,2,15649
98,11418,35,1354798446,1354799421,0,1,975
98,11420,35,1355000117,1355010906,0,1,10789
98,11421,35,1355045646,1355045977,0,1,331
98,11425,35,1355479668,1355483659,0,1,3991
98,11426,640,1355520824,1355520884,0,1,60
98,11427,35,1355655789,1355655849,0,1,60
98,11434,35,1356249592,1356255909,0,1,6317
98,11435,35,1356684217,1356684671,0,1,454
98,11437,640,1356813565,1356813625,0,1,60
98,11440,35,1357031790,1357032092,0,2,302
98,11440,640,1357032092,1357032092,0,2,0
98,11442,640,1357519095,1357519556,0,1,461
98,11445,35,1357817298,1357817666,0,1,368
98,11447,35,1357987303,1358005458,0,1,18155
98,11450,640,1358247742,1358247802,0,1,60
98,11464,640,1360108062,1360108732,0,1,670
98,11471,640,1360719813,1360719873,0,1,60
99,11472,640,1360807361,1360808004,0,1,643
99,11489,35,1336233829,1336233889,0,1,60
99,11508,8,1339505962,1339507329,0,1,1367
99,11511,5,1339934688,1339935475,0,1,787
99,11514,21,1340809490,1340809550,0,1,60
99,11518,35,1342344700,1342345449,0,1,749
99,11521,21,1342625298,1342625358,0,1,60
99,11523,35,1343460849,1343460909,0,1,60
99,11524,21,1343489855,1343489915,0,1,60
99,11527,5,1344152632,1344155561,0,2,2929
99,11527,8,1344155561,1344156902,0,2,1341
99,11528,5,1344262319,1344262379,0,1,60
99,11531,35,1344588752,1344590189,0,1,1437
99,11535,603,1344773937,1344773997,0,1,60
99,11540,35,1347718921,1347719419,0,1,498
99,11541,603,1350091688,1350093564,0,3,1876
99,11541,21,1350093564,1350093658,0,3,94
99,11541,11,1350093658,1350093718,0,3,60
99,11555,603,1353668128,1353670925,0,2,2797
99,11555,35,1353682922,1353682982,0,2,60
99,11574,284,1357745822,1357749676,0,1,3854
99,11576,284,1357920018,1357920078,0,1,60
99,11580,603,1358525548,1358525608,0,1,60
99,11583,449,1359193539,1359193599,0,1,60
100,11592,5,1333515580,1333517084,0,2,1504
100,11592,21,1333535307,1333535367,0,2,60
100,11593,35,1333720774,1333720834,0,1,60
100,11596,480,1334811928,1334812050,0,3,122
100,11596,5,1334820655,1334828268,0,3,7613
100,11596,5,1334828268,1334828328,0,3,60
100,11597,875,1335098766,1335098826,0,1,60
100,11599,35,1335453327,1335453387,0,1,60
100,11600,35,1335604364,1335605201,0,2,837
100,11600,480,1335605201,1335605239,0,2,38
100,11601,5,1335935116,1335935176,0,1,60
100,11604,875,1336389459,1336389560,0,1,101
100,11605,5,1336476302,1336476362,0,1,60
100,11606,35,1336572532,1336572592,0,1,60
100,11607,35,1336719558,1336720586,0,2,1028
100,11607,5,1336720586,1336724250,0,2,3664
100,11608,5,1336742369,1336742806,0,2,437
100,11608,21,1336742806,1336742866,0,2,60
100,11610,480,1337053247,1337053998,0,2,751
100,11610,5,1337053998,1337054092,0,2,94
100,11614,5,1339216710,1339216770,0,1,60
100,11615,28,1341215248,1341224962,0,1,9714
100,11617,5,1342490471,1342490852,0,2,381
100,11617,28,1342490852,1342492590,0,2,1738
100,11618,875,1343439454,1343439514,0,1,60
100,11620,21,1343641710,1343641770,0,1,60
100,11621,35,1344240162,1344240222,0,1,60
100,11625,5,1344935941,1344936745,0,2,804
100,11625,35,1344936745,1344936805,0,2,60
100,11627,5,1345436092,1345436336,0,1,244
100,11628,5,1345466871,1345467656,0,2,785
100,11628,21,1345467656,1345467716,0,2,60
100,11629,875,1349689092,1349689152,0,1,60
100,11630,875,1350035951,1350037354,0,4,1403
100,11630,480,1350037354,1350037809,0,4,455
100,11630,8,1350037809,1350039964,0,4,2155
100,11630,5,1350048183,1350048243,0,4,60
100,11632,875,1351072124,1351072184,0,1,60
100,11633,875,1351417956,1351418013,0,1,57
100,11634,875,1351676184,1351676244,0,1,60
100,11637,5,1352691794,1352696345,0,1,4551
100,11638,875,1353233780,1353233840,0,1,60
100,11639,5,1353390629,1353394261,0,3,3632
100,11639,8,1353394261,1353400389,0,3,6128
100,11639,5,1353400389,1353400449,0,3,60
100,11643,875,1354960101,1354960161,0,1,60
100,11644,875,1355045489,1355045522,0,1,33
100,11647,875,1356172081,1356172141,0,1,60
100,11649,480,1357000876,1357001027,0,1,151
100,11650,875,1357811391,1357811462,0,1,71
100,11651,875,1357897142,1357897202,0,1,60
100,11652,875,1357983821,1357984643,0,1,822
100,11656,8,1359180228,1359180267,0,1,39
100,11658,35,1359713677,1359713737,0,1,60
100,11659,35,1359985379,1359985439,0,1,60
101,11660,253,1360314288,1360315084,0,2,796
101,11660,35,1360315084,1360315144,0,2,60
101,11666,35,1334568720,1334569192,0,2,472
101,11666,253,1334569192,1334569211,0,2,19
101,11673,35,1336728125,1336729099,0,1,974
101,11674,253,1337210863,1337211322,0,2,459
101,11674,35,1337211322,1337211382,0,2,60
101,11686,253,1339975883,1339975897,0,1,14
101,11691,35,1341359578,1341359638,0,1,60
101,11713,21,1351074270,1351074330,0,1,60
102,11737,21,1334026360,1334026459,0,1,99
102,11738,21,1334053249,1334053309,0,1,60
102,11740,35,1334129011,1334130803,0,1,1792
102,11741,21,1334196943,1334197872,0,1,929
102,11742,21,1334212188,1334212248,0,1,60
102,11743,1005,1334278921,1334282414,0,1,3493
102,11744,8,1334303347,1334307944,0,3,4597
102,11744,5,1334312969,1334313370,0,3,401
102,11744,21,1334313370,1334313430,0,3,60
102,11745,21,1334452015,1334453189,0,3,1174
102,11745,603,1334453189,1334453928,0,3,739
102,11745,875,1334453928,1334453988,0,3,60
102,11746,5,1334487272,1334487512,0,1,240
102,11751,5,1334903334,1334903520,0,1,186
102,11752,5,1334915067,1334915127,0,1,60
102,11754,5,1335262852,1335264150,0,2,1298
102,11754,1005,1335264150,1335264210,0,2,60
102,11756,765,1335679502,1335680292,0,4,790
102,11756,21,1335682237,1335682801,0,4,564
102,11756,5,1335684868,1335684986,0,4,118
102,11756,8,1335686728,1335688129,0,4,1401
102,11757,21,1335915703,1335921641,0,2,5938
102,11757,5,1335935569,1335935962,0,2,393
102,11758,8,1335938587,1335940846,0,2,2259
102,11758,1005,1335940846,1335940906,0,2,60
102,11759,297,1336112410,1336113071,0,5,661
102,11759,5,1336113071,1336113402,0,5,331
102,11759,8,1336114796,1336118863,0,5,4067
102,11759,5,1336118863,1336119720,0,5,857
102,11759,35,1336119720,1336119780,0,5,60
102,11760,284,1336127088,1336128420,0,2,1332
102,11760,284,1336137785,1336137845,0,2,60
102,11761,5,1336202276,1336202828,0,1,552
102,11762,5,1336210748,1336212041,0,2,1293
102,11762,1005,1336212041,1336212101,0,2,60
102,11764,8,1336555771,1336556725,0,3,954
102,11764,5,1336556725,1336558037,0,3,1312
102,11764,1005,1336558037,1336558097,0,3,60
102,11766,35,1336722390,1336722677,0,3,287
102,11766,428,1336730140,1336730822,0,3,682
102,11766,1005,1336730822,1336730882,0,3,60
102,11767,1005,1336877740,1336878886,0,1,1146
102,11768,5,1336906834,1336906894,0,1,60
102,11769,253,1337049584,1337049808,0,1,224
102,11770,1005,1337078163,1337078223,0,1,60
102,11772,1005,1337164995,1337165055,0,1,60
102,11773,1005,1337399696,1337400926,0,6,1230
102,11773,35,1337400926,1337401268,0,6,342
102,11773,35,1337408575,1337409830,0,6,1255
102,11773,5,1337409830,1337410105,0,6,275
102,11773,8,1337410105,1337414883,0,6,4778
102,11773,1005,1337418548,1337418608,0,6,60
102,11775,21,1337816730,1337817602,0,1,872
102,11776,765,1338021571,1338021926,0,2,355
102,11776,428,1338021926,1338021986,0,2,60
102,11777,5,1338271842,1338272382,0,2,540
102,11777,8,1338273497,1338273557,0,2,60
102,11779,1005,1338889708,1338889768,0,1,60
102,11780,21,1339029372,1339036522,0,1,7150
102,11781,8,1339053880,1339053920,0,2,40
102,11781,5,1339053920,1339057873,0,2,3953
102,11782,1005,1339077276,1339077336,0,1,60
102,11783,640,1339296568,1339301909,0,1,5341
102,11784,640,1339329255,1339329315,0,1,60
102,11786,480,1339559988,1339560221,0,1,233
102,11787,5,1339589106,1339589166,0,1,60
102,11788,428,1344636766,1344636826,0,1,60
102,11789,5,1344680990,1344681058,0,1,68
102,11791,35,1344932616,1344932932,0,2,316
102,11791,449,1344945678,1344945977,0,2,299
102,11793,21,1356049126,1356049186,0,1,60
102,11794,35,1356145313,1356145483,0,1,170
102,11795,8,1356766766,1356766793,0,2,27
102,11795,5,1356767221,1356767281,0,2,60
102,11796,260,1356817233,1356817718,0,2,485
102,11796,428,1356817718,1356819422,0,2,1704
102,11800,21,1357274979,1357275575,0,1,596
102,11804,260,1358492939,1358492999,0,1,60
103,11806,5,1359887242,1359887302,0,1,60
103,11872,1,1353755254,1353755314,0,1,60
103,11885,71,1355098435,1355098495,0,1,60
103,11909,71,1359505762,1359526035,0,1,20273
104,11959,480,1337951040,1337951100,0,1,60
104,11965,21,1338544225,1338545087,0,2,862
104,11965,5,1338545087,1338549040,0,2,3953
104,12064,1005,1354593879,1354612898,0,1,19019
104,12100,21,1359536765,1359536825,0,1,60
105,12109,35,1333519477,1333520319,0,1,842
105,12111,35,1333618013,1333620641,0,1,2628
105,12113,35,1335602191,1335602927,0,4,736
105,12113,284,1335602927,1335603886,0,4,959
105,12113,11,1335603886,1335603886,0,4,0
105,12113,11,1335603886,1335608590,0,4,4704
105,12114,11,1335656917,1335657940,0,3,1023
105,12114,284,1335657940,1335658494,0,3,554
105,12114,35,1335658494,1335660005,0,3,1511
105,12116,35,1336102184,1336102592,0,1,408
105,12118,35,1336188353,1336197855,0,1,9502
105,12120,35,1347680402,1347681440,0,5,1038
105,12120,5,1347681440,1347684163,0,5,2723
105,12120,8,1347686393,1347694284,0,5,7891
105,12120,5,1347694284,1347695351,0,5,1067
105,12120,35,1347695351,1347695853,0,5,502
105,12121,284,1347703922,1347703982,0,1,60
105,12122,35,1347765681,1347766500,0,1,819
105,12123,260,1352606284,1352607264,0,4,980
105,12123,253,1352607264,1352607749,0,4,485
105,12123,35,1352607749,1352609508,0,4,1759
105,12123,35,1352617691,1352618077,0,4,386
105,12124,35,1352629349,1352631085,0,1,1736
105,12125,35,1352794103,1352794472,0,3,369
105,12125,480,1352794472,1352794634,0,3,162
105,12125,5,1352794634,1352802691,0,3,8057
105,12127,35,1356677850,1356678210,0,1,360
105,12130,35,1356830940,1356836552,0,1,5612
105,12131,284,1356857267,1356857764,0,2,497
105,12131,35,1356857764,1356859446,0,2,1682
105,12132,35,1356918582,1356918642,0,1,60
105,12133,284,1356987809,1356989636,0,2,1827
105,12133,253,1356989636,1356996174,0,2,6538
105,12134,35,1357097835,1357097895,0,1,60
105,12137,35,1357249390,1357255485,0,1,6095
105,12138,35,1357451438,1357452243,0,1,805
105,12139,35,1357549097,1357549157,0,1,60
106,12160,260,1336139362,1336139422,0,1,60
106,12292,35,1356686750,1356691808,0,1,5058
107,12322,640,1338009764,1338009824,0,1,60
107,12328,640,1339213787,1339220609,0,1,6822
107,12342,640,1341408497,1341408557,0,1,60
107,12343,28,1341460697,1341462008,0,1,1311
107,12344,28,1341488794,1341489716,0,1,922
107,12350,253,1342267153,1342267213,0,1,60
107,12361,640,1351254575,1351255493,0,1,918
107,12362,640,1351323821,1351324564,0,1,743
107,12368,640,1353040673,1353041034,0,2,361
107,12368,284,1353041034,1353052339,0,2,11305
107,12378,253,1354108937,1354108997,0,1,60
107,12379,284,1354285646,1354285706,0,1,60
107,12383,59,1355009462,1355011601,0,1,2139
107,12386,260,1357567728,1357571236,0,1,3508
107,12390,253,1358780244,1358780304,0,1,60
107,12395,640,1359622010,1359623902,0,5,1892
107,12395,260,1359623902,1359624751,0,5,849
107,12395,449,1359624751,1359625700,0,5,949
107,12395,449,1359635168,1359636658,0,5,1490
107,12395,260,1359636658,1359639778,0,5,3120
107,12397,284,1359797625,1359797685,0,1,60
108,12413,104,1340272137,1340272251,0,1,114
108,12424,104,1344510599,1344510659,0,1,60
108,12428,480,1347701389,1347701796,0,2,407
108,12428,35,1347701796,1347702278,0,2,482
108,12432,104,1350003756,1350003827,0,1,71
108,12438,35,1351066076,1351066321,0,1,245
108,12439,35,1351161921,1351162698,0,1,777
108,12453,253,1353714925,1353714985,0,1,60
108,12462,480,1354717532,1354717592,0,1,60
108,12466,35,1354965551,1354966587,0,1,1036
108,12467,35,1355640964,1355647156,0,1,6192
108,12473,104,1357555133,1357555193,0,1,60
108,12483,104,1360740748,1360740808,0,1,60
109,12488,35,1333983787,1333985029,0,2,1242
109,12488,21,1333985029,1333985089,0,2,60
109,12525,480,1344700160,1344700220,0,1,60
109,12549,263,1351139480,1351141703,0,1,2223
109,12553,5,1351352987,1351353047,0,1,60
109,12560,35,1352457782,1352457806,0,1,24
110,12600,71,1338974705,1338985262,0,1,10557
110,12620,21,1342649702,1342649762,0,1,60
110,12642,1,1351330320,1351331889,0,1,1569
111,12709,5,1335426603,1335427196,0,1,593
111,12728,8,1336987487,1336993861,0,1,6374
111,12769,35,1341792155,1341793867,0,1,1712
111,12791,71,1347697057,1347697614,0,2,557
111,12791,5,1347697614,1347697674,0,2,60
113,12965,297,1333492212,1333493813,0,2,1601
113,12965,35,1333493813,1333495472,0,2,1659
113,12966,35,1333538336,1333539956,0,2,1620
113,12966,297,1333539956,1333540016,0,2,60
113,12967,35,1333580702,1333581255,0,2,553
113,12967,35,1333582485,1333582521,0,2,36
113,12968,35,1333614562,1333616215,0,2,1653
113,12968,297,1333616215,1333616275,0,2,60
113,12970,263,1333842130,1333843372,0,2,1242
113,12970,253,1333846044,1333846985,0,2,941
113,12972,35,1334050883,1334052486,0,2,1603
113,12972,297,1334052486,1334052546,0,2,60
113,12973,297,1334100185,1334101797,0,2,1612
113,12973,35,1334101797,1334103064,0,2,1267
113,12975,35,1334230046,1334231387,0,3,1341
113,12975,260,1334231387,1334231742,0,3,355
113,12975,297,1334231742,1334231802,0,3,60
113,12976,297,1334273351,1334276432,0,1,3081
113,12977,35,1334304137,1334304860,0,2,723
113,12977,297,1334305739,1334305799,0,2,60
113,12978,297,1334361075,1334362935,0,2,1860
113,12978,35,1334362935,1334365056,0,2,2121
113,12979,297,1334446296,1334448331,0,3,2035
113,12979,35,1334448331,1334450809,0,3,2478
113,12979,35,1334450809,1334450840,0,3,31
113,12981,35,1334567198,1334567749,0,3,551
113,12981,253,1334567749,1334570007,0,3,2258
113,12981,253,1334579279,1334580479,0,3,1200
113,12982,297,1334701046,1334702817,0,3,1771
113,12982,35,1334702817,1334703368,0,3,551
113,12982,35,1334705414,1334707386,0,3,1972
113,12983,297,1334791092,1334792781,0,2,1689
113,12983,35,1334792781,1334794145,0,2,1364
113,12984,35,1334834417,1334836110,0,2,1693
113,12984,297,1334836110,1334836170,0,2,60
113,12985,297,1334874952,1334879372,0,1,4420
113,12986,35,1334910571,1334912187,0,2,1616
113,12986,297,1334912187,1334912247,0,2,60
113,12988,35,1335000146,1335001869,0,2,1723
113,12988,297,1335001869,1335001929,0,2,60
113,12989,260,1335055715,1335056974,0,2,1259
113,12989,35,1335056974,1335058906,0,2,1932
113,12991,428,1335172047,1335173177,0,4,1130
113,12991,71,1335181409,1335181832,0,4,423
113,12991,21,1335181832,1335182927,0,4,1095
113,12991,35,1335182927,1335184290,0,4,1363
113,12993,297,1335268530,1335268590,0,1,60
113,12994,297,1335309499,1335309992,0,3,493
113,12994,260,1335309992,1335310024,0,3,32
113,12994,35,1335313242,1335313302,0,3,60
113,12995,35,1335353298,1335354860,0,2,1562
113,12995,297,1335354860,1335354920,0,2,60
113,12996,297,1335399799,1335403294,0,1,3495
113,12997,35,1335439715,1335440250,0,3,535
113,12997,253,1335440250,1335441256,0,3,1006
113,12997,297,1335441256,1335441316,0,3,60
113,12998,297,1335569018,1335570841,0,2,1823
113,12998,35,1335570841,1335572880,0,2,2039
113,12999,35,1335604897,1335606568,0,2,1671
113,12999,297,1335606568,1335606628,0,2,60
113,13000,297,1335655746,1335657249,0,1,1503
113,13003,35,1335947415,1335948938,0,2,1523
113,13003,297,1335948938,1335948998,0,2,60
113,13004,35,1336036225,1336036735,0,3,510
113,13004,253,1336036735,1336037721,0,3,986
113,13004,297,1336037721,1336037781,0,3,60
113,13005,297,1336090767,1336092924,0,1,2157
113,13006,35,1336120710,1336122274,0,2,1564
113,13006,297,1336122274,1336122334,0,2,60
113,13007,297,1336170014,1336171603,0,2,1589
113,13007,35,1336171603,1336172288,0,2,685
113,13008,35,1336207257,1336209214,0,2,1957
113,13008,297,1336209214,1336209274,0,2,60
113,13009,297,1336259953,1336260445,0,3,492
113,13009,260,1336260445,1336263593,0,3,3148
113,13009,35,1336263593,1336263653,0,3,60
113,13010,35,1336355223,1336356597,0,4,1374
113,13010,21,1336356597,1336369452,0,4,12855
113,13010,480,1336370230,1336370974,0,4,744
113,13010,35,1336370974,1336372721,0,4,1747
113,13012,35,1336475315,1336476959,0,2,1644
113,13012,297,1336476959,1336477019,0,2,60
113,13013,297,1336516382,1336517977,0,2,1595
113,13013,35,1336517977,1336518509,0,2,532
113,13014,35,1336561622,1336563497,0,2,1875
113,13014,297,1336563497,1336563557,0,2,60
113,13015,297,1336607855,1336609305,0,2,1450
113,13015,35,1336609305,1336611075,0,2,1770
113,13017,35,1336723784,1336725619,0,2,1835
113,13017,297,1336725619,1336725679,0,2,60
113,13018,297,1336780502,1336782041,0,2,1539
113,13018,35,1336782041,1336784585,0,2,2544
113,13019,35,1336813716,1336815529,0,2,1813
113,13019,297,1336815529,1336815589,0,2,60
113,13020,297,1336866099,1336867749,0,2,1650
113,13020,35,1336867749,1336868348,0,2,599
113,13021,1,1336893930,1336910710,0,2,16780
113,13021,1,1336910710,1336910770,0,2,60
113,13023,35,1336975692,1336976358,0,2,666
113,13023,253,1336980742,1336981107,0,2,365
113,13025,35,1337080731,1337082290,0,2,1559
113,13025,297,1337082290,1337082350,0,2,60
113,13026,297,1337124817,1337126702,0,2,1885
113,13026,35,1337126702,1337128375,0,2,1673
113,13027,35,1337166494,1337167869,0,2,1375
113,13027,297,1337167869,1337167929,0,2,60
113,13028,35,1337210823,1337211965,0,1,1142
113,13029,35,1337242162,1337243895,0,2,1733
113,13029,297,1337243895,1337243955,0,2,60
113,13030,297,1337296867,1337296955,0,2,88
113,13030,35,1337296955,1337297015,0,2,60
113,13031,297,1337385204,1337388226,0,1,3022
113,13032,35,1337418667,1337420228,0,2,1561
113,13032,297,1337420228,1337420288,0,2,60
113,13033,253,1337594529,1337604042,0,1,9513
113,13034,35,1337685589,1337687310,0,2,1721
113,13034,297,1337687310,1337687370,0,2,60
113,13035,297,1337813680,1337815310,0,2,1630
113,13035,35,1337815310,1337815788,0,2,478
113,13036,35,1337944428,1337945557,0,2,1129
113,13036,297,1337945557,1337945617,0,2,60
113,13037,297,1337990816,1337992510,0,2,1694
113,13037,35,1337992510,1337993099,0,2,589
113,13038,35,1338024203,1338024263,0,1,60
113,13039,297,1338076342,1338077931,0,3,1589
113,13039,35,1338077931,1338080505,0,3,2574
113,13039,35,1338081709,1338081751,0,3,42
113,13042,35,1338290399,1338291983,0,2,1584
113,13042,297,1338291983,1338292043,0,2,60
113,13043,35,1338333745,1338335604,0,1,1859
113,13044,297,1338540488,1338540548,0,1,60
113,13045,297,1338680382,1338681358,0,1,976
113,13046,35,1338712153,1338713109,0,2,956
113,13046,35,1338724257,1338724587,0,2,330
113,13047,35,1338807032,1338809984,0,2,2952
113,13047,297,1338809984,1338810044,0,2,60
113,13048,297,1338851024,1338853019,0,3,1995
113,13048,35,1338853019,1338853462,0,3,443
113,13048,35,1338855094,1338855153,0,3,59
113,13050,35,1338976944,1338980628,0,1,3684
113,13051,297,1339069704,1339069764,0,1,60
113,13052,297,1339109292,1339110693,0,2,1401
113,13052,35,1339110693,1339112560,0,2,1867
113,13053,297,1339198821,1339200327,0,2,1506
113,13053,35,1339200327,1339201635,0,2,1308
113,13054,35,1339233661,1339235416,0,2,1755
113,13054,297,1339235416,1339235476,0,2,60
113,13055,297,1339284408,1339286026,0,2,1618
113,13055,35,1339286042,1339286705,0,2,663
113,13057,35,1339401676,1339402671,0,2,995
113,13057,35,1339409683,1339409718,0,2,35
113,13060,35,1339500357,1339501962,0,2,1605
113,13060,297,1339501962,1339502022,0,2,60
113,13061,297,1339543349,1339545109,0,2,1760
113,13061,35,1339545109,1339546963,0,2,1854
113,13062,35,1339575632,1339577259,0,2,1627
113,13062,297,1339577259,1339577319,0,2,60
113,13063,297,1339627922,1339629648,0,2,1726
113,13063,35,1339629648,1339631504,0,2,1856
113,13064,35,1339672790,1339672850,0,1,60
113,13065,35,1339758647,1339760096,0,2,1449
113,13065,297,1339760096,1339760156,0,2,60
113,13066,297,1339889642,1339891460,0,3,1818
113,13066,35,1339891460,1339893842,0,3,2382
113,13066,35,1339895657,1339896443,0,3,786
113,13068,35,1340012859,1340014285,0,2,1426
113,13068,297,1340014285,1340014345,0,2,60
113,13070,35,1340268403,1340268943,0,2,540
113,13070,253,1340268943,1340269456,0,2,513
113,13071,35,1340619997,1340621224,0,2,1227
113,13071,297,1340621224,1340621284,0,2,60
113,13072,297,1340752665,1340754170,0,2,1505
113,13072,35,1340754170,1340754786,0,2,616
113,13073,35,1340794783,1340795193,0,2,410
113,13073,35,1340800482,1340801808,0,2,1326
113,13074,297,1341103389,1341104723,0,3,1334
113,13074,253,1341104723,1341108157,0,3,3434
113,13074,35,1341109164,1341111152,0,3,1988
113,13075,253,1341221355,1341222548,0,3,1193
113,13075,35,1341229632,1341229887,0,3,255
113,13075,35,1341229887,1341231612,0,3,1725
113,13076,35,1341309743,1341311455,0,2,1712
113,13076,297,1341311455,1341311515,0,2,60
113,13077,297,1341359969,1341360313,0,3,344
113,13077,260,1341360313,1341360503,0,3,190
113,13077,35,1341362998,1341364776,0,3,1778
113,13078,35,1341400855,1341402536,0,2,1681
113,13078,297,1341402536,1341402596,0,2,60
113,13079,297,1341443717,1341445368,0,2,1651
113,13079,35,1341445368,1341446162,0,2,794
113,13080,35,1341486763,1341488160,0,2,1397
113,13080,297,1341488160,1341488220,0,2,60
113,13081,297,1341531141,1341534859,0,1,3718
113,13082,35,1341569585,1341571305,0,2,1720
113,13082,297,1341571305,1341571365,0,2,60
113,13083,297,1341618787,1341620421,0,2,1634
113,13083,35,1341620421,1341621791,0,2,1370
113,13084,35,1341651753,1341653449,0,2,1696
113,13084,297,1341653449,1341653509,0,2,60
113,13085,297,1341707139,1341709114,0,1,1975
113,13086,35,1341825496,1341827155,0,2,1659
113,13086,297,1341827155,1341827215,0,2,60
113,13087,297,1341879142,1341879202,0,1,60
113,13088,35,1341964305,1341965652,0,1,1347
113,13089,35,1342001015,1342003180,0,2,2165
113,13089,35,1342008473,1342010472,0,2,1999
113,13090,35,1342088741,1342090103,0,2,1362
113,13090,297,1342090103,1342090163,0,2,60
113,13091,35,1342138730,1342140618,0,1,1888
113,13092,35,1342166533,1342168062,0,2,1529
113,13092,297,1342168062,1342168122,0,2,60
113,13093,297,1342223406,1342223466,0,1,60
113,13094,35,1342249753,1342251186,0,2,1433
113,13094,297,1342251186,1342251246,0,2,60
113,13097,35,1342508898,1342509808,0,2,910
113,13097,253,1342512456,1342514187,0,2,1731
113,13100,297,1342654706,1342656397,0,2,1691
113,13100,35,1342656397,1342657630,0,2,1233
113,13101,297,1342825222,1342826881,0,2,1659
113,13101,35,1342826881,1342828188,0,2,1307
113,13103,297,1343117206,1343117266,0,1,60
113,13104,297,1343343806,1343343866,0,1,60
113,13105,297,1343432372,1343433893,0,2,1521
113,13105,35,1343433893,1343435817,0,2,1924
113,13106,35,1343459328,1343461067,0,2,1739
113,13106,297,1343461067,1343461127,0,2,60
113,13107,35,1343525335,1343527259,0,1,1924
113,13109,35,1343630950,1343631831,0,2,881
113,13109,253,1343631831,1343631891,0,2,60
113,13110,77,1343645672,1343648596,0,1,2924
113,13111,35,1344240032,1344240631,0,3,599
113,13111,253,1344240631,1344242504,0,3,1873
113,13111,253,1344249265,1344249512,0,3,247
113,13112,35,1344511272,1344512949,0,2,1677
113,13112,297,1344512949,1344513009,0,2,60
113,13113,297,1344552151,1344553827,0,2,1676
113,13113,35,1344553827,1344554353,0,2,526
113,13114,35,1344596800,1344598323,0,2,1523
113,13114,297,1344598323,1344598383,0,2,60
113,13115,297,1344642804,1344644362,0,2,1558
113,13115,35,1344644362,1344644422,0,2,60
113,13116,35,1344669639,1344671143,0,2,1504
113,13116,297,1344671143,1344671203,0,2,60
113,13117,297,1344731435,1344734725,0,2,3290
113,13117,351,1344750020,1344750080,0,2,60
113,13118,297,1345245132,1345246625,0,2,1493
113,13118,35,1345246625,1345247996,0,2,1371
113,13119,35,1345274316,1345274376,0,1,60
113,13122,104,1345454628,1345455976,0,1,1348
113,13123,297,1346845755,1346845815,0,1,60
113,13124,297,1346887688,1346888226,0,3,538
113,13124,260,1346888226,1346891103,0,3,2877
113,13124,35,1346891103,1346893289,0,3,2186
113,13125,35,1347535207,1347536949,0,2,1742
113,13125,297,1347536949,1347537009,0,2,60
113,13126,297,1347666605,1347668361,0,2,1756
113,13126,35,1347668361,1347670281,0,2,1920
113,13127,35,1347693527,1347695052,0,2,1525
113,13127,297,1347695052,1347695185,0,2,133
114,13128,35,1347754435,1347755662,0,1,1227
114,13129,21,1333485784,1333485844,0,1,60
114,13131,5,1333851153,1333851523,0,1,370
114,13132,603,1334021347,1334022343,0,2,996
114,13132,480,1334022343,1334022608,0,2,265
114,13133,480,1334123598,1334126793,0,1,3195
114,13135,603,1334279192,1334279606,0,1,414
114,13140,480,1334822248,1334824001,0,2,1753
114,13140,212,1334824001,1334824493,0,2,492
114,13142,480,1335139722,1335139782,0,1,60
114,13143,480,1335164225,1335167097,0,1,2872
114,13145,480,1335398281,1335398341,0,1,60
114,13146,480,1335428606,1335431121,0,1,2515
114,13148,480,1335664394,1335680803,0,1,16409
114,13150,480,1336375909,1336375969,0,1,60
114,13153,5,1336531419,1336533862,0,1,2443
114,13154,480,1336788665,1336788927,0,2,262
114,13154,875,1336801831,1336802961,0,2,1130
114,13155,5,1336883884,1336892763,0,1,8879
114,13156,480,1336954834,1336954894,0,1,60
114,13159,8,1337396036,1337399031,0,1,2995
114,13162,480,1337846047,1337848538,0,1,2491
114,13163,35,1337998004,1338002015,0,1,4011
114,13164,212,1338019534,1338020314,0,1,780
114,13166,480,1338173593,1338174733,0,1,1140
114,13169,480,1338769055,1338769115,0,1,60
114,13170,1005,1339295372,1339311457,0,1,16085
114,13171,875,1339312905,1339312965,0,1,60
114,13173,480,1340265693,1340271002,0,1,5309
114,13175,480,1341302519,1341302579,0,1,60
114,13183,480,1341793189,1341793249,0,1,60
114,13188,480,1342488551,1342488611,0,1,60
115,13201,640,1334459243,1334460277,0,2,1034
115,13201,28,1334460277,1334460337,0,2,60
116,13389,336,1333491288,1333491348,0,1,60
116,13390,336,1333533922,1333534283,0,1,361
116,13392,77,1333852911,1333853903,0,1,992
116,13393,77,1333878545,1333879901,0,1,1356
116,13395,336,1333971271,1333971343,0,1,72
116,13401,428,1334352716,1334365063,0,1,12347
116,13404,336,1334528344,1334528404,0,1,60
116,13405,336,1334575551,1334576502,0,1,951
116,13406,35,1334668962,1334670216,0,2,1254
116,13406,428,1334670216,1334670834,0,2,618
116,13407,336,1334701376,1334701436,0,1,60
116,13409,336,1334787557,1334787617,0,1,60
116,13410,336,1334839551,1334840227,0,1,676
116,13412,336,1334926559,1334926864,0,1,305
116,13413,449,1335018538,1335019307,0,2,769
116,13413,336,1335019307,1335021957,0,2,2650
116,13419,336,1335357029,1335357083,0,1,54
116,13421,428,1335563702,1335567457,0,1,3755
116,13423,336,1335651477,1335651537,0,1,60
116,13424,336,1335698925,1335699350,0,1,425
116,13425,336,1335910435,1335910495,0,1,60
116,13429,336,1336264817,1336264877,0,1,60
116,13430,336,1336342593,1336342653,0,1,60
116,13431,336,1336393330,1336394112,0,1,782
116,13432,336,1336566694,1336567795,0,1,1101
116,13434,336,1336819603,1336820206,0,1,603
116,13438,336,1337034232,1337055651,0,1,21419
116,13439,336,1337087651,1337088056,0,1,405
116,13440,336,1337120412,1337120472,0,1,60
116,13441,336,1337158111,1337158644,0,1,533
116,13445,336,1337611193,1337611253,0,1,60
116,13450,336,1338130036,1338130096,0,1,60
116,13453,336,1338243968,1338244028,0,1,60
116,13454,336,1338295035,1338295716,0,1,681
116,13457,336,1338503509,1338503569,0,1,60
116,13462,336,1338890426,1338890779,0,1,353
116,13463,336,1338986865,1338986964,0,1,99
116,13466,336,1339165691,1339166512,0,1,821
116,13467,428,1339204312,1339204768,0,3,456
116,13467,336,1339204768,1339209052,0,3,4284
116,13467,336,1339214168,1339215297,0,3,1129
116,13469,336,1339278954,1339279014,0,1,60
116,13470,336,1339317161,1339317527,0,1,366
116,13471,336,1339453650,1339467388,0,1,13738
116,13474,336,1339765901,1339766286,0,1,385
116,13475,336,1339885366,1339885426,0,1,60
116,13476,336,1339932007,1339933747,0,1,1740
116,13478,336,1340230945,1340231005,0,1,60
116,13479,336,1340282135,1340282867,0,1,732
116,13480,263,1340765048,1340766611,0,1,1563
116,13483,336,1341231938,1341232766,0,1,828
116,13484,336,1341271970,1341272030,0,1,60
116,13485,336,1341320109,1341320169,0,1,60
116,13486,336,1341353792,1341353852,0,1,60
116,13487,336,1341403856,1341404409,0,1,553
116,13488,336,1341439640,1341439700,0,1,60
116,13489,336,1341498497,1341498693,0,1,196
116,13492,336,1341586459,1341586519,0,1,60
116,13493,428,1341615338,1341619027,0,1,3689
116,13495,35,1341664908,1341665893,0,1,985
116,13496,336,1341700095,1341700155,0,1,60
116,13497,336,1341742591,1341743081,0,1,490
116,13498,336,1341786295,1341786355,0,1,60
116,13499,336,1341841932,1341842358,0,1,426
116,13500,336,1341957861,1341966148,0,1,8287
116,13502,336,1342015898,1342015958,0,1,60
116,13506,336,1342188691,1342189445,0,1,754
116,13507,428,1342235698,1342237372,0,1,1674
116,13508,428,1342254746,1342254806,0,1,60
116,13510,336,1342390693,1342390753,0,1,60
116,13511,336,1342442549,1342442939,0,1,390
116,13512,336,1342476527,1342495095,0,1,18568
116,13514,336,1342531266,1342532035,0,1,769
116,13515,336,1342563319,1342563379,0,1,60
116,13516,336,1342617964,1342618559,0,1,595
116,13520,336,1342957417,1342958259,0,1,842
116,13521,336,1343426061,1343426121,0,1,60
116,13522,104,1343470162,1343471847,0,2,1685
116,13522,35,1343478205,1343479607,0,2,1402
116,13524,336,1343600205,1343600265,0,1,60
116,13525,336,1343658352,1343659541,0,1,1189
116,13528,336,1344254646,1344255477,0,1,831
116,13529,336,1344511309,1344511748,0,1,439
116,13532,263,1344677867,1344678947,0,1,1080
116,13537,336,1344982914,1344982974,0,1,60
116,13539,428,1345241751,1345245280,0,1,3529
116,13540,35,1345293107,1345293167,0,1,60
116,13541,336,1345326916,1345326976,0,1,60
116,13543,336,1345413988,1345414048,0,1,60
116,13544,336,1345465911,1345465939,0,1,28
116,13546,336,1346883268,1346883328,0,1,60
116,13547,336,1347227526,1347227586,0,1,60
116,13548,336,1347539459,1347539931,0,1,472
116,13550,263,1347702669,1347702941,0,1,272
116,13553,336,1349993388,1349993448,0,1,60
116,13554,336,1350081382,1350081442,0,1,60
116,13555,336,1350123810,1350124307,0,1,497
116,13557,336,1350648226,1350648286,0,1,60
116,13558,336,1350902627,1350903095,0,1,468
116,13559,336,1350944180,1350944240,0,1,60
116,13560,336,1350996437,1350996877,0,1,440
116,13561,336,1351030469,1351030529,0,1,60
116,13562,336,1351087435,1351087479,0,1,44
116,13564,336,1351203292,1351203352,0,1,60
116,13566,336,1351288026,1351288086,0,1,60
116,13567,336,1351338088,1351338506,0,1,418
116,13571,336,1351597630,1351597946,0,1,316
116,13572,336,1351685176,1351685700,0,1,524
116,13573,336,1351721662,1351722263,0,2,601
116,13573,263,1351722263,1351736439,0,2,14176
116,13578,336,1352199906,1352199966,0,1,60
116,13581,336,1352457711,1352459584,0,1,1873
116,13584,336,1352672251,1352672311,0,1,60
116,13586,336,1352720226,1352720240,0,1,14
116,13588,336,1353014108,1353014168,0,1,60
116,13590,336,1353103814,1353103874,0,1,60
116,13591,336,1353151803,1353152411,0,1,608
116,13593,336,1353226644,1353226999,0,1,355
116,13602,336,1354141696,1354141756,0,1,60
116,13603,428,1354314387,1354326794,0,2,12407
116,13603,104,1354326794,1354326854,0,2,60
116,13604,35,1354368622,1354369580,0,2,958
116,13604,428,1354369580,1354369640,0,2,60
116,13606,336,1354487739,1354506254,0,1,18515
116,13608,336,1354619845,1354619905,0,1,60
116,13610,336,1354746549,1354746609,0,1,60
116,13611,336,1354787903,1354788319,0,1,416
116,13617,336,1355042887,1355042986,0,1,99
116,13621,336,1355398533,1355398593,0,1,60
116,13622,336,1355571443,1355571860,0,1,417
116,13626,336,1355782830,1355782890,0,1,60
116,13628,336,1355837713,1355837773,0,1,60
116,13629,336,1355869692,1355869752,0,1,60
116,13631,336,1355955815,1355955875,0,1,60
116,13633,336,1356090059,1356090787,0,1,728
116,13647,336,1357429469,1357447615,0,2,18146
116,13647,336,1357447615,1357448158,0,2,543
116,13650,336,1357597240,1357597300,0,1,60
116,13663,336,1358375101,1358394594,0,1,19493
116,13666,336,1358807169,1358807229,0,1,60
116,13667,253,1358844483,1358851128,0,2,6645
116,13667,35,1358851128,1358852903,0,2,1775
116,13669,336,1359195422,1359195935,0,1,513
116,13670,428,1359252318,1359253391,0,2,1073
116,13670,5,1359253391,1359254619,0,2,1228
116,13671,336,1359326133,1359326193,0,1,60
116,13672,336,1359378953,1359379911,0,1,958
116,13676,336,1359552651,1359553233,0,1,582
116,13677,336,1359583586,1359583646,0,1,60
116,13678,336,1359625721,1359626191,0,1,470
116,13680,428,1360047505,1360051279,0,1,3774
116,13681,336,1360102819,1360102879,0,1,60
116,13682,336,1360153829,1360153847,0,1,18
116,13685,336,1360324050,1360324384,0,1,334
116,13686,428,1360550816,1360551921,0,3,1105
116,13686,35,1360551921,1360552860,0,3,939
116,13686,35,1360571966,1360572026,0,3,60
116,13687,428,1360572934,1360581775,0,1,8841
116,13688,336,1360621933,1360621993,0,1,60
116,13689,336,1360677143,1360677439,0,1,296
116,13690,336,1360708403,1360717054,0,1,8651
117,13695,71,1333851942,1333852227,0,3,285
117,13695,71,1333860913,1333872665,0,3,11752
117,13695,71,1333872665,1333872969,0,3,304
117,13696,71,1333888847,1333888907,0,1,60
117,13698,449,1334008455,1334008515,0,1,60
117,13699,28,1334326810,1334326870,0,1,60
117,13700,5,1334383099,1334384705,0,1,1606
117,13701,35,1334413564,1334414482,0,2,918
117,13701,253,1334414482,1334414542,0,2,60
117,13702,253,1334459970,1334464449,0,1,4479
117,13703,253,1334496152,1334496212,0,1,60
117,13709,5,1335686822,1335688163,0,1,1341
117,13710,5,1335709658,1335711538,0,2,1880
117,13710,260,1335711538,1335711598,0,2,60
117,13711,449,1336166431,1336166491,0,1,60
117,13712,449,1336182666,1336182726,0,1,60
117,13713,21,1336824307,1336824570,0,2,263
117,13713,449,1336832930,1336833790,0,2,860
117,13714,449,1336854424,1336856394,0,3,1970
117,13714,5,1336856394,1336863690,0,3,7296
117,13714,5,1336863690,1336866333,0,3,2643
117,13716,5,1336899269,1336900790,0,2,1521
117,13716,260,1336900790,1336900850,0,2,60
117,13717,260,1337416395,1337417594,0,3,1199
117,13717,5,1337417594,1337418410,0,3,816
117,13717,5,1337437991,1337438051,0,3,60
117,13719,35,1337803305,1337803705,0,2,400
117,13719,253,1337803705,1337803765,0,2,60
117,13724,71,1339063578,1339063638,0,1,60
117,13726,5,1339327097,1339328732,0,2,1635
117,13726,260,1339328732,1339328792,0,2,60
117,13727,253,1339882567,1339882627,0,1,60
117,13728,449,1341091335,1341108120,0,1,16785
117,13730,253,1341585775,1341586827,0,1,1052
117,13731,253,1341609111,1341609171,0,1,60
117,13732,71,1341668365,1341669818,0,1,1453
117,13733,5,1341747787,1341748789,0,2,1002
117,13733,260,1341748789,1341748849,0,2,60
117,13734,260,1342185499,1342190293,0,2,4794
117,13734,5,1342192009,1342199367,0,2,7358
117,13736,5,1342250508,1342251130,0,1,622
117,13737,449,1342357970,1342358030,0,1,60
117,13738,8,1343448136,1343448196,0,1,60
117,13739,8,1343477635,1343479815,0,2,2180
117,13739,260,1343479815,1343479875,0,2,60
117,13740,253,1343552092,1343552684,0,2,592
117,13740,253,1343564391,1343564451,0,2,60
117,13741,253,1344169100,1344169160,0,1,60
117,13742,336,1344512477,1344513530,0,1,1053
117,13744,336,1344579515,1344579575,0,1,60
117,13745,336,1344640046,1344641540,0,1,1494
117,13746,336,1344668992,1344669052,0,1,60
117,13748,71,1344759724,1344760615,0,2,891
117,13748,71,1344773558,1344773618,0,2,60
117,13750,253,1345213834,1345213894,0,1,60
117,13751,651,1345263223,1345264507,0,1,1284
117,13752,651,1345294555,1345294615,0,1,60
117,13756,449,1347676853,1347679076,0,2,2223
117,13756,284,1347679575,1347682141,0,2,2566
117,13757,284,1347703216,1347704610,0,2,1394
117,13757,253,1347704610,1347704670,0,2,60
117,13758,253,1347766688,1347766748,0,1,60
117,13759,449,1349684246,1349685665,0,1,1419
117,13760,71,1351154895,1351155650,0,4,755
117,13760,5,1351155650,1351156066,0,4,416
117,13760,5,1351172457,1351173452,0,4,995
117,13760,260,1351173452,1351173512,0,4,60
117,13761,253,1351316888,1351317590,0,2,702
117,13761,253,1351321547,1351321607,0,2,60
117,13762,253,1351412210,1351412270,0,1,60
117,13763,21,1352369159,1352369219,0,1,60
117,13764,260,1352611169,1352612166,0,3,997
117,13764,5,1352612166,1352615448,0,3,3282
117,13764,5,1352621267,1352621327,0,3,60
117,13765,253,1353224034,1353224494,0,2,460
117,13765,253,1353235425,1353236200,0,2,775
117,13767,449,1353827056,1353827604,0,2,548
117,13767,449,1353847647,1353847707,0,2,60
117,13768,253,1354974289,1354975860,0,1,1571
117,13769,5,1355209126,1355209633,0,1,507
117,13772,5,1355577009,1355577069,0,1,60
117,13773,71,1355650449,1355650936,0,3,487
117,13773,5,1355650936,1355651135,0,3,199
117,13773,5,1355659321,1355659381,0,3,60
117,13775,21,1356160801,1356161054,0,1,253
117,13776,35,1356206782,1356226982,0,1,20200
117,13777,5,1356230722,1356230782,0,1,60
117,13778,71,1356637384,1356637444,0,1,60
117,13779,260,1356687804,1356688089,0,3,285
117,13779,651,1356688089,1356692586,0,3,4497
117,13779,651,1356692586,1356695489,0,3,2903
117,13780,336,1356764135,1356764195,0,1,60
117,13781,336,1356816521,1356817447,0,1,926
117,13782,336,1356850659,1356850719,0,1,60
117,13783,5,1356941130,1356942843,0,3,1713
117,13783,5,1356951187,1356952027,0,3,840
117,13783,260,1356952027,1356952087,0,3,60
117,13784,449,1357212183,1357212243,0,1,60
117,13785,253,1357289955,1357290376,0,1,421
117,13787,260,1357397823,1357397883,0,1,60
117,13788,21,1357800568,1357800628,0,1,60
117,13789,21,1357824604,1357824664,0,1,60
117,13791,35,1357943157,1357943217,0,1,60
117,13793,5,1358142157,1358147937,0,3,5780
117,13793,5,1358150397,1358151914,0,3,1517
117,13793,260,1358151914,1358152761,0,3,847
117,13794,71,1359100266,1359101056,0,3,790
117,13794,11,1359101056,1359102672,0,3,1616
117,13794,28,1359121375,1359121435,0,3,60
117,13795,263,1359159511,1359170248,0,1,10737
117,13796,263,1359195448,1359196237,0,1,789
117,13797,77,1359245450,1359245634,0,1,184
117,13798,263,1359278575,1359279619,0,1,1044
117,13799,260,1359781790,1359782526,0,1,736
117,13800,640,1359883785,1359887739,0,2,3954
117,13800,260,1359897954,1359898014,0,2,60
118,13801,449,1360828509,1360828569,0,1,60
118,13802,5,1333515978,1333516676,0,1,698
118,13805,212,1333859863,1333864149,0,4,4286
118,13805,253,1333864149,1333865495,0,4,1346
118,13805,253,1333866690,1333869262,0,4,2572
118,13805,5,1333871745,1333872739,0,4,994
118,13806,5,1333894936,1333895180,0,7,244
118,13806,21,1333895180,1333895894,0,7,714
118,13806,480,1333895894,1333896187,0,7,293
118,13806,35,1333896863,1333897131,0,7,268
118,13806,603,1333897272,1333897574,0,7,302
118,13806,875,1333897964,1333898121,0,7,157
118,13806,212,1333898121,1333898275,0,7,154
118,13810,21,1334437977,1334443501,0,1,5524
118,13812,21,1335080510,1335084826,0,1,4316
118,13815,5,1335536379,1335536439,0,1,60
118,13817,640,1336037963,1336044134,0,2,6171
118,13817,5,1336044134,1336045177,0,2,1043
118,13819,21,1336638202,1336638226,0,1,24
118,13821,640,1337142094,1337146542,0,2,4448
118,13821,284,1337146542,1337146602,0,2,60
118,13824,603,1337392988,1337394112,0,2,1124
118,13824,21,1337394112,1337395589,0,2,1477
118,13825,21,1337430353,1337433106,0,1,2753
118,13826,5,1338005562,1338009451,0,1,3889
118,13830,35,1338710361,1338712120,0,7,1759
118,13830,640,1338712120,1338714543,0,7,2423
118,13830,35,1338714543,1338716489,0,7,1946
118,13830,5,1338716489,1338716559,0,7,70
118,13830,5,1338717721,1338718980,0,7,1259
118,13830,5,1338723149,1338723566,0,7,417
118,13830,21,1338723566,1338727049,0,7,3483
118,13831,875,1338802710,1338809741,0,1,7031
118,13832,875,1338981299,1338981359,0,1,60
118,13835,21,1339191657,1339191717,0,1,60
118,13836,21,1339241142,1339242333,0,4,1191
118,13836,5,1339242333,1339242923,0,4,590
118,13836,5,1339249232,1339250821,0,4,1589
118,13836,35,1339250821,1339250881,0,4,60
118,13837,212,1339310694,1339313546,0,2,2852
118,13837,5,1339313546,1339324192,0,2,10646
118,13839,5,1339569353,1339569877,0,2,524
118,13839,5,1339584824,1339590942,0,2,6118
118,13840,5,1339919905,1339920283,0,1,378
118,13841,5,1340007553,1340007613,0,1,60
118,13843,640,1340778657,1340779299,0,3,642
118,13843,35,1340779299,1340780408,0,3,1109
118,13843,5,1340780408,1340782452,0,3,2044
118,13844,651,1351171782,1351171842,0,1,60
118,13845,21,1351261113,1351265674,0,1,4561
118,13846,875,1351336767,1351336827,0,1,60
118,13848,21,1351694956,1351695016,0,1,60
118,13853,5,1353143500,1353143560,0,1,60
118,13855,28,1353829433,1353831114,0,2,1681
118,13855,5,1353831114,1353831174,0,2,60
118,13857,21,1354321259,1354321319,0,1,60
118,13858,5,1354431528,1354432237,0,1,709
118,13862,480,1355044207,1355044267,0,1,60
118,13864,212,1355265710,1355265770,0,1,60
118,13865,5,1355558079,1355558139,0,1,60
118,13867,651,1356091626,1356096488,0,2,4862
118,13867,21,1356096488,1356096548,0,2,60
118,13870,5,1357195175,1357210425,0,1,15250
118,13871,651,1357520299,1357520359,0,1,60
118,13875,297,1358060124,1358060484,0,1,360
118,13877,21,1358295541,1358295601,0,1,60
118,13882,21,1359554896,1359554956,0,1,60
119,13923,104,1345266873,1345267731,0,3,858
119,13923,104,1345277214,1345277281,0,3,67
119,13923,104,1345277281,1345277567,0,3,286
119,13931,5,1350381612,1350386155,0,1,4543
119,13945,104,1352613390,1352614049,0,2,659
119,13945,104,1352621241,1352621619,0,2,378
119,13949,449,1353131371,1353132215,0,1,844
119,13959,35,1359531872,1359531948,0,1,76
119,13960,104,1359533233,1359533651,0,1,418
121,14054,640,1337412963,1337413428,0,1,465
122,14198,253,1344699417,1344699477,0,1,60
123,14232,5,1333854293,1333855228,0,2,935
123,14232,5,1333868068,1333872016,0,2,3948
123,14238,253,1334376461,1334377000,0,1,539
123,14263,5,1337388271,1337388331,0,1,60
123,14269,336,1338210242,1338210955,0,1,713
123,14272,253,1338815715,1338820648,0,1,4933
123,14301,77,1341982055,1341982115,0,1,60
123,14317,77,1347675003,1347689982,0,1,14979
123,14333,284,1352454117,1352459644,0,1,5527
123,14370,77,1359154538,1359154598,0,1,60
123,14373,284,1359790232,1359792101,0,1,1869
124,14378,11,1341981511,1341981571,0,1,60
124,14380,351,1342046106,1342048129,0,1,2023
124,14381,351,1342068519,1342068579,0,1,60
124,14384,11,1342909480,1342909540,0,1,60
124,14386,11,1344691776,1344691836,0,1,60
124,14387,11,1344981456,1344981516,0,1,60
124,14388,253,1345260557,1345262227,0,1,1670
124,14389,21,1345443280,1345445143,0,1,1863
124,14390,284,1346886656,1346886716,0,1,60
124,14391,11,1347230918,1347232371,0,2,1453
124,14391,284,1347232371,1347232431,0,2,60
124,14392,284,1347529338,1347529398,0,1,60
124,14393,284,1347664102,1347664162,0,1,60
124,14394,284,1347694890,1347694902,0,1,12
124,14395,284,1347750603,1347750663,0,1,60
124,14396,351,1349994670,1349995194,0,1,524
124,14397,284,1350024377,1350024699,0,2,322
124,14397,351,1350025001,1350025061,0,2,60
124,14398,5,1350077788,1350077994,0,4,206
124,14398,21,1350077994,1350078116,0,4,122
124,14398,71,1350078223,1350078329,0,4,106
124,14398,297,1350078329,1350079798,0,4,1469
124,14399,297,1350114689,1350114898,0,4,209
124,14399,71,1350114898,1350115010,0,4,112
124,14399,21,1350115088,1350116723,0,4,1635
124,14399,5,1350116723,1350116783,0,4,60
124,14400,11,1350600364,1350600376,0,2,12
124,14400,284,1350601690,1350601712,0,2,22
124,14402,11,1350945981,1350945997,0,2,16
124,14402,284,1350964121,1350964181,0,2,60
124,14403,284,1351033838,1351033849,0,3,11
124,14403,284,1351050959,1351051006,0,3,47
124,14403,351,1351051656,1351052295,0,3,639
124,14404,284,1351118326,1351118343,0,3,17
124,14404,284,1351137106,1351137340,0,3,234
124,14404,351,1351137827,1351139895,0,3,2068
124,14405,284,1351204756,1351204784,0,2,28
124,14405,11,1351224367,1351224427,0,2,60
124,14407,284,1351312697,1351313389,0,2,692
124,14407,351,1351313598,1351314177,0,2,579
124,14408,1,1351377098,1351378377,0,1,1279
124,14410,284,1351498329,1351498341,0,2,12
124,14410,351,1351499149,1351499209,0,2,60
124,14412,284,1351666406,1351666877,0,2,471
124,14412,351,1351667111,1351667171,0,2,60
124,14413,11,1351723555,1351723566,0,1,11
124,14414,351,1351760836,1351760896,0,1,60
124,14415,351,1351810083,1351811667,0,1,1584
124,14417,11,1352156052,1352156063,0,2,11
124,14417,284,1352157614,1352158428,0,2,814
124,14418,284,1352185102,1352185113,0,2,11
124,14418,351,1352185796,1352185856,0,2,60
124,14419,284,1352241565,1352241625,0,1,60
124,14420,284,1352268544,1352269578,0,1,1034
124,14421,284,1352502536,1352502596,0,1,60
124,14422,11,1352585804,1352585814,0,2,10
124,14422,5,1352586426,1352586486,0,2,60
124,14424,284,1352706010,1352706645,0,1,635
124,14426,284,1353364939,1353364952,0,1,13
124,14427,284,1353394550,1353394782,0,2,232
124,14427,351,1353395254,1353395314,0,2,60
124,14429,284,1353478202,1353478827,0,1,625
124,14430,284,1353537567,1353537627,0,1,60
124,14431,284,1353570303,1353570611,0,1,308
124,14432,11,1353635460,1353635471,0,3,11
124,14432,11,1353642081,1353642109,0,3,28
124,14432,8,1353651979,1353652039,0,3,60
124,14435,284,1353914514,1353914574,0,1,60
124,14441,351,1354417090,1354418120,0,5,1030
124,14441,11,1354418120,1354419608,0,5,1488
124,14441,8,1354419608,1354429644,0,5,10036
124,14441,21,1354429644,1354429718,0,5,74
124,14441,21,1354431317,1354431377,0,5,60
124,14442,284,1354521878,1354521889,0,1,11
124,14443,284,1354574356,1354574416,0,1,60
124,14444,284,1354606343,1354606367,0,1,24
124,14445,284,1354660763,1354661547,0,2,784
124,14445,284,1354678973,1354680037,0,2,1064
124,14446,284,1354747155,1354747175,0,1,20
124,14447,284,1354852017,1354853064,0,2,1047
124,14447,351,1354853064,1354853124,0,2,60
124,14448,35,1355015639,1355016366,0,1,727
124,14449,284,1355092754,1355112527,0,2,19773
124,14449,284,1355112527,1355113271,0,2,744
124,14450,11,1355114589,1355114609,0,1,20
124,14452,11,1355205768,1355205828,0,1,60
124,14453,284,1355351977,1355353218,0,1,1241
124,14454,284,1355550951,1355551231,0,1,280
124,14457,284,1355733377,1355734130,0,1,753
124,14459,284,1355823965,1355824246,0,1,281
124,14460,284,1355985256,1355985486,0,1,230
124,14462,284,1356131281,1356131293,0,1,12
124,14464,21,1356222127,1356222187,0,1,60
124,14465,5,1356245864,1356246049,0,2,185
124,14465,11,1356246049,1356246109,0,2,60
124,14466,260,1356757837,1356760126,0,1,2289
124,14467,8,1357105098,1357110502,0,2,5404
124,14467,5,1357110502,1357110562,0,2,60
124,14469,5,1357543439,1357543645,0,2,206
124,14469,11,1357543645,1357543705,0,2,60
124,14472,284,1357684753,1357684813,0,1,60
124,14475,284,1357800420,1357801108,0,2,688
124,14475,351,1357801108,1357801168,0,2,60
124,14476,284,1357857694,1357857754,0,1,60
124,14478,5,1357957703,1357968842,0,2,11139
124,14478,11,1357972857,1357972917,0,2,60
124,14479,11,1358034410,1358035702,0,2,1292
124,14479,260,1358035702,1358036185,0,2,483
124,14480,21,1358061056,1358061116,0,1,60
124,14481,284,1358232708,1358233628,0,2,920
124,14481,351,1358233628,1358233688,0,2,60
124,14482,284,1358289544,1358289579,0,1,35
124,14483,284,1358376075,1358377015,0,1,940
124,14484,284,1358405410,1358411121,0,1,5711
124,14485,284,1358462323,1358464110,0,1,1787
124,14486,284,1358491749,1358492657,0,2,908
124,14486,351,1358492657,1358492717,0,2,60
124,14488,284,1359097875,1359097886,0,2,11
124,14488,351,1359098911,1359098971,0,2,60
124,14489,284,1359155282,1359156373,0,2,1091
124,14489,284,1359174609,1359174669,0,2,60
124,14492,284,1359327469,1359328549,0,1,1080
124,14493,284,1359355975,1359356035,0,1,60
124,14494,284,1359414111,1359414171,0,1,60
124,14496,284,1359528027,1359528087,0,1,60
124,14498,284,1359614801,1359614947,0,1,146
124,14500,284,1359706498,1359706550,0,2,52
124,14500,351,1359707079,1359707139,0,2,60
124,14501,284,1359760086,1359760102,0,2,16
124,14501,11,1359780772,1359780832,0,2,60
124,14502,351,1359848506,1359849225,0,4,719
124,14502,284,1359849225,1359850717,0,4,1492
124,14502,5,1359850717,1359865341,0,4,14624
124,14502,5,1359865341,1359865401,0,4,60
124,14503,21,1359871625,1359871685,0,1,60
124,14505,351,1360047807,1360047867,0,1,60
124,14506,284,1360193135,1360193195,0,1,60
124,14507,284,1360219538,1360220440,0,2,902
124,14507,351,1360220440,1360220500,0,2,60
124,14508,284,1360277859,1360278980,0,1,1121
124,14509,284,1360306778,1360307662,0,2,884
124,14509,351,1360307662,1360307722,0,2,60
124,14510,5,1360536746,1360537021,0,3,275
124,14510,21,1360537021,1360537316,0,3,295
124,14510,297,1360537316,1360537376,0,3,60
124,14511,1,1360566872,1360566932,0,1,60
124,14512,284,1360652023,1360653245,0,2,1222
124,14512,351,1360653245,1360653305,0,2,60
124,14513,284,1360710307,1360710367,0,1,60
124,14514,284,1360737855,1360739171,0,2,1316
124,14514,351,1360739171,1360739231,0,2,60
124,14515,284,1360796209,1360797369,0,1,1160
125,14516,284,1360824965,1360829108,0,1,4143
125,14538,35,1357891773,1357895870,0,1,4097
125,14542,449,1358204999,1358218751,0,1,13752
125,14543,260,1358244209,1358244950,0,2,741
125,14543,449,1358244950,1358247567,0,2,2617
125,14544,260,1358465132,1358465540,0,1,408
125,14545,260,1358505122,1358505756,0,2,634
125,14545,449,1358505756,1358506062,0,2,306
125,14549,449,1359069386,1359070680,0,1,1294
125,14554,260,1359416135,1359416195,0,1,60
125,14556,260,1359539248,1359543266,0,1,4018
125,14563,449,1360106459,1360108235,0,2,1776
125,14563,260,1360108235,1360108295,0,2,60
125,14564,449,1360215071,1360215743,0,1,672
125,14568,260,1360626083,1360626143,0,1,60
125,14569,449,1360661083,1360661143,0,1,60
125,14571,449,1360749637,1360749697,0,1,60
126,14575,35,1341570751,1341571970,0,2,1219
126,14575,351,1341571970,1341572030,0,2,60
126,14576,11,1341615806,1341615866,0,1,60
126,14577,260,1341641201,1341642168,0,3,967
126,14577,5,1341642168,1341644471,0,3,2303
126,14577,8,1341649696,1341661688,0,3,11992
126,14578,5,1341664926,1341665542,0,2,616
126,14578,11,1341665542,1341665602,0,2,60
126,14583,35,1342175319,1342175379,0,1,60
126,14585,35,1342422140,1342423133,0,2,993
126,14585,351,1342423133,1342423193,0,2,60
126,14587,11,1347630449,1347630509,0,1,60
126,14591,35,1350037837,1350039472,0,2,1635
126,14591,351,1350039472,1350039532,0,2,60
126,14592,35,1350103576,1350103847,0,2,271
126,14592,284,1350103847,1350104797,0,2,950
126,14593,11,1350137933,1350137993,0,1,60
126,14596,35,1351062195,1351062255,0,1,60
126,14597,35,1351139091,1351139151,0,1,60
126,14598,35,1351248462,1351248522,0,1,60
126,14600,35,1351316019,1351316928,0,2,909
126,14600,351,1351316928,1351316988,0,2,60
126,14602,35,1351743853,1351762238,0,3,18385
126,14602,35,1351762238,1351763059,0,3,821
126,14602,351,1351763059,1351763119,0,3,60
126,14605,5,1352264477,1352272271,0,3,7794
126,14605,5,1352272271,1352272657,0,3,386
126,14605,11,1352272657,1352272717,0,3,60
126,14606,35,1352371130,1352371190,0,1,60
126,14607,8,1352458258,1352460304,0,2,2046
126,14607,11,1352463989,1352464049,0,2,60
126,14609,351,1353063729,1353063789,0,1,60
126,14610,35,1353128616,1353128676,0,1,60
126,14611,35,1353473454,1353473514,0,1,60
126,14613,11,1353676069,1353676129,0,1,60
126,14614,35,1353733372,1353733432,0,1,60
126,14616,21,1354162791,1354162851,0,1,60
126,14618,35,1354582728,1354582788,0,1,60
126,14620,35,1354690830,1354690890,0,1,60
126,14621,35,1354783675,1354783735,0,1,60
126,14623,35,1354870469,1354870529,0,1,60
126,14624,35,1355372958,1355373018,0,1,60
126,14625,21,1355630872,1355630932,0,1,60
126,14627,297,1356737963,1356739773,0,1,1810
126,14628,21,1356768986,1356769576,0,4,590
126,14628,480,1356769576,1356770149,0,4,573
126,14628,5,1356770149,1356774676,0,4,4527
126,14628,8,1356774676,1356774736,0,4,60
126,14629,5,1357189481,1357195797,0,3,6316
126,14629,11,1357195797,1357198625,0,3,2828
126,14629,297,1357198625,1357198685,0,3,60
127,14630,5,1360056396,1360056456,0,1,60
128,14716,8,1334280761,1334289061,0,3,8300
128,14716,35,1334290563,1334291887,0,3,1324
128,14716,5,1334291887,1334292449,0,3,562
128,14717,8,1334307248,1334308134,0,1,886
128,14727,8,1336359128,1336363585,0,2,4457
128,14727,8,1336376498,1336377041,0,2,543
128,14728,8,1336710016,1336710467,0,2,451
128,14728,8,1336725190,1336725898,0,2,708
128,14729,8,1336986934,1336988475,0,1,1541
128,14733,8,1337939124,1337939696,0,1,572
128,14740,8,1341218316,1341218413,0,1,97
128,14742,8,1341551460,1341553225,0,1,1765
128,14744,480,1342145002,1342145588,0,4,586
128,14744,35,1342145588,1342146743,0,4,1155
128,14744,35,1342155949,1342156525,0,4,576
128,14744,480,1342156525,1342156756,0,4,231
128,14751,8,1344572409,1344573337,0,2,928
128,14751,8,1344582401,1344582850,0,2,449
128,14753,8,1345440617,1345442375,0,1,1758
128,14756,8,1350387322,1350390205,0,1,2883
128,14759,8,1351233709,1351235014,0,1,1305
128,14762,8,1351837449,1351837757,0,2,308
128,14762,8,1351851006,1351851197,0,2,191
128,14767,8,1353045613,1353047564,0,1,1951
128,14772,8,1353825715,1353827331,0,2,1616
128,14772,8,1353839861,1353841935,0,2,2074
128,14779,8,1356678791,1356679490,0,1,699
128,14783,8,1357198995,1357200074,0,1,1079
128,14785,8,1357453801,1357455827,0,1,2026
128,14789,35,1358154595,1358155990,0,1,1395
128,14791,5,1358491908,1358492134,0,2,226
128,14791,8,1358501413,1358501929,0,2,516
128,14793,8,1359111478,1359111592,0,2,114
128,14793,5,1359111592,1359111932,0,2,340
128,14794,8,1359266453,1359266698,0,1,245
129,14805,253,1336103415,1336114316,0,1,10901
129,14856,35,1349684299,1349684359,0,1,60
129,14860,253,1351348677,1351348737,0,1,60
129,14861,35,1351599649,1351599709,0,1,60
129,14876,253,1354515198,1354515668,0,1,470
129,14885,253,1356693255,1356694123,0,1,868
130,14914,8,1334056184,1334057356,0,1,1172
130,14920,297,1334879186,1334879246,0,1,60
130,14969,212,1342098171,1342098231,0,1,60
130,14974,875,1344165664,1344165724,0,1,60
130,14983,212,1347764959,1347766231,0,3,1272
130,14983,35,1347766231,1347767295,0,3,1064
130,14983,351,1347767295,1347767355,0,3,60
131,15019,1005,1339481616,1339483131,0,1,1515
132,15107,35,1351208530,1351210142,0,1,1612
132,15111,35,1351381025,1351381085,0,1,60
132,15114,35,1351599165,1351599225,0,1,60
132,15115,35,1351641021,1351642602,0,1,1581
132,15130,35,1353369459,1353370828,0,1,1369
132,15157,35,1355096839,1355098302,0,1,1463
132,15163,35,1355701138,1355702816,0,1,1678
133,15224,35,1335009949,1335010009,0,1,60
133,15229,35,1336213079,1336213139,0,1,60
133,15231,35,1336563193,1336563253,0,1,60
134,15323,875,1360318741,1360321471,0,1,2730
134,15330,765,1336379737,1336381936,0,1,2199
134,15334,5,1338014849,1338017009,0,1,2160
134,15335,5,1338679412,1338679817,0,1,405
134,15338,5,1339649286,1339650545,0,1,1259
134,15345,21,1342474211,1342474243,0,1,32
134,15346,21,1342528238,1342528889,0,1,651
134,15349,875,1344241759,1344242221,0,1,462
134,15357,5,1350120124,1350120184,0,1,60
134,15360,8,1352177516,1352182662,0,3,5146
134,15360,5,1352183454,1352184534,0,3,1080
134,15360,35,1352184534,1352185008,0,3,474
134,15362,5,1355030197,1355038285,0,1,8088
134,15364,5,1355533726,1355540004,0,1,6278
134,15365,5,1355556477,1355571737,0,2,15260
134,15365,8,1355571737,1355571797,0,2,60
134,15367,5,1355974988,1355975048,0,1,60
134,15373,8,1357608146,1357620069,0,1,11923
134,15374,5,1357806108,1357808168,0,2,2060
134,15374,8,1357811995,1357812460,0,2,465
134,15375,603,1358473613,1358473673,0,1,60
135,15385,297,1333614442,1333616413,0,2,1971
135,15385,284,1333616413,1333616496,0,2,83
135,15387,284,1334017381,1334019211,0,2,1830
135,15387,297,1334019211,1334019349,0,2,138
135,15388,297,1334047899,1334049977,0,2,2078
135,15388,284,1334049977,1334050297,0,2,320
135,15389,71,1334132548,1334132608,0,1,60
135,15390,284,1334134244,1334134505,0,1,261
135,15391,284,1334191949,1334194696,0,1,2747
135,15392,297,1334223260,1334225199,0,2,1939
135,15392,284,1334225199,1334225334,0,2,135
135,15393,284,1334277021,1334278864,0,4,1843
135,15393,297,1334278864,1334279212,0,4,348
135,15393,297,1334287211,1334289342,0,4,2131
135,15393,284,1334289342,1334289540,0,4,198
135,15397,284,1334654310,1334655340,0,1,1030
135,15399,284,1334795415,1334797472,0,1,2057
135,15400,284,1334831633,1334831763,0,1,130
135,15401,284,1334881808,1334883705,0,2,1897
135,15401,297,1334883705,1334883945,0,2,240
135,15402,297,1334910086,1334910146,0,1,60
135,15404,284,1335059883,1335059907,0,1,24
135,15407,284,1335411121,1335411136,0,2,15
135,15407,297,1335412848,1335412994,0,2,146
135,15408,71,1335430900,1335433117,0,2,2217
135,15408,284,1335433117,1335433135,0,2,18
135,15412,603,1335664492,1335664668,0,1,176
135,15413,284,1335922474,1335922523,0,2,49
135,15413,284,1335940891,1335940911,0,2,20
135,15414,1,1336115868,1336116375,0,2,507
135,15414,284,1336117659,1336117948,0,2,289
135,15415,284,1336180859,1336181234,0,1,375
135,15416,297,1336352297,1336362130,0,1,9833
135,15417,297,1336379273,1336379508,0,2,235
135,15417,284,1336381133,1336381229,0,2,96
135,15418,284,1336523380,1336523411,0,2,31
135,15418,297,1336525280,1336525559,0,2,279
135,15419,297,1336551253,1336553104,0,2,1851
135,15419,284,1336553143,1336553382,0,2,239
135,15420,284,1336609239,1336609399,0,1,160
135,15421,284,1336696098,1336699159,0,3,3061
135,15421,297,1336699159,1336699206,0,3,47
135,15421,297,1336699206,1336699319,0,3,113
135,15422,297,1336722669,1336724594,0,2,1925
135,15422,284,1336724645,1336724811,0,2,166
135,15423,603,1336785937,1336787244,0,2,1307
135,15423,21,1336787244,1336798153,0,2,10909
135,15428,71,1337074622,1337075066,0,1,444
135,15430,71,1337158199,1337160273,0,1,2074
135,15431,284,1337214695,1337217867,0,1,3172
135,15434,284,1337645080,1337645099,0,2,19
135,15434,71,1337647185,1337647205,0,2,20
135,15435,284,1337677942,1337677973,0,1,31
135,15442,297,1338167025,1338167144,0,1,119
135,15443,71,1338196310,1338196373,0,1,63
135,15444,297,1338253293,1338253510,0,1,217
135,15445,297,1338279700,1338281638,0,2,1938
135,15445,284,1338281638,1338281738,0,2,100
135,15446,297,1338336719,1338337090,0,1,371
135,15447,297,1338368076,1338368136,0,1,60
135,15449,21,1338765302,1338765480,0,2,178
135,15449,21,1338765480,1338765935,0,2,455
135,15450,297,1338886181,1338888208,0,2,2027
135,15450,284,1338888243,1338889578,0,2,1335
135,15457,284,1339979512,1339981559,0,1,2047
135,15459,284,1340238683,1340240531,0,4,1848
135,15459,297,1340240531,1340241162,0,4,631
135,15459,71,1340254851,1340254860,0,4,9
135,15459,284,1340256573,1340256702,0,4,129
135,15462,297,1341795779,1341795965,0,1,186
135,15464,284,1341966785,1341968808,0,2,2023
135,15464,297,1341968808,1341969479,0,2,671
135,15465,297,1341996791,1341998952,0,2,2161
135,15465,284,1341999050,1341999368,0,2,318
135,15467,284,1342138831,1342138946,0,2,115
135,15467,297,1342140779,1342141052,0,2,273
135,15472,71,1342659665,1342659725,0,1,60
135,15473,297,1343118894,1343120961,0,1,2067
135,15474,297,1343625133,1343625719,0,2,586
135,15474,603,1343626965,1343627820,0,2,855
135,15478,71,1344586759,1344586872,0,1,113
135,15480,71,1344815538,1344815770,0,1,232
135,15482,297,1344929457,1344931371,0,2,1914
135,15482,284,1344931398,1344932785,0,2,1387
135,15487,284,1345453754,1345453801,0,1,47
135,15489,284,1346887318,1346887958,0,2,640
135,15489,21,1346888946,1346889290,0,2,344
135,15491,297,1347524777,1347526977,0,2,2200
135,15491,284,1347527019,1347528142,0,2,1123
135,15494,284,1350031724,1350032921,0,1,1197
135,15496,284,1350602478,1350602562,0,1,84
135,15498,71,1350981037,1350981044,0,2,7
135,15498,284,1350982863,1350982955,0,2,92
135,15499,297,1351036578,1351036615,0,1,37
135,15500,284,1351068728,1351068761,0,1,33
135,15502,297,1351153313,1351155323,0,2,2010
135,15502,284,1351155323,1351155394,0,2,71
135,15503,297,1351209855,1351210006,0,1,151
135,15506,284,1351391903,1351412334,0,1,20431
135,15508,297,1351469509,1351470231,0,1,722
135,15509,297,1351641557,1351641638,0,1,81
135,15510,297,1351664423,1351666235,0,2,1812
135,15510,284,1351666250,1351666424,0,2,174
135,15512,284,1352157800,1352159881,0,2,2081
135,15512,71,1352159881,1352159941,0,2,60
135,15513,71,1352187733,1352187827,0,1,94
135,15514,284,1352244041,1352244170,0,1,129
135,15515,297,1352276414,1352278372,0,2,1958
135,15515,284,1352278421,1352279806,0,2,1385
135,15518,21,1352678181,1352678821,0,1,640
135,15519,11,1352773034,1352775523,0,1,2489
135,15520,284,1353021547,1353024426,0,4,2879
135,15520,71,1353024426,1353024716,0,4,290
135,15520,71,1353024716,1353024724,0,4,8
135,15520,297,1353035576,1353036527,0,4,951
135,15521,284,1353055098,1353055156,0,1,58
135,15526,297,1353376803,1353382394,0,1,5591
135,15527,284,1353402072,1353402220,0,1,148
135,15528,297,1353456355,1353456526,0,1,171
135,15530,297,1353572212,1353572272,0,1,60
135,15531,284,1353574386,1353574471,0,1,85
135,15533,875,1353727278,1353728473,0,2,1195
135,15533,875,1353745282,1353745612,0,2,330
135,15536,297,1353888040,1353888100,0,1,60
135,15537,71,1353917884,1353918053,0,2,169
135,15537,284,1353919914,1353920613,0,2,699
135,15538,297,1353975079,1353975740,0,1,661
135,15540,284,1354063367,1354065453,0,2,2086
135,15540,297,1354065453,1354065513,0,2,60
135,15541,284,1354145064,1354145169,0,1,105
135,15547,71,1354579131,1354579307,0,1,176
135,15548,297,1354609406,1354611320,0,2,1914
135,15548,284,1354611329,1354611370,0,2,41
135,15550,297,1354695837,1354697766,0,1,1929
135,15552,284,1354783626,1354783627,0,2,1
135,15552,284,1354783627,1354783703,0,2,76
135,15556,297,1355097529,1355097900,0,1,371
135,15559,297,1355213756,1355215501,0,2,1745
135,15559,284,1355215576,1355215755,0,2,179
135,15560,284,1355268231,1355268438,0,2,207
135,15560,297,1355270403,1355270464,0,2,61
135,15561,284,1355562604,1355562745,0,1,141
135,15566,284,1355873062,1355875781,0,2,2719
135,15566,284,1355875920,1355877350,0,2,1430
135,15574,1,1357102188,1357102248,0,1,60
135,15576,284,1357255269,1357256520,0,1,1251
135,15580,297,1357603137,1357603197,0,1,60
135,15581,297,1357633427,1357635256,0,1,1829
135,15582,297,1357689339,1357689526,0,1,187
135,15583,284,1357721511,1357721671,0,1,160
135,15585,297,1357806658,1357808638,0,2,1980
135,15585,284,1357808662,1357808996,0,2,334
135,15592,297,1358208123,1358227677,0,2,19554
135,15592,297,1358227677,1358227737,0,2,60
135,15593,284,1358229767,1358230702,0,1,935
135,15594,284,1358757841,1358757886,0,1,45
135,15595,297,1358823537,1358823597,0,1,60
135,15596,284,1358845693,1358845792,0,1,99
135,15600,284,1359329591,1359329686,0,2,95
135,15600,297,1359331604,1359331664,0,2,60
135,15601,297,1359362063,1359363864,0,1,1801
135,15603,297,1359503880,1359504030,0,1,150
135,15604,297,1359523935,1359525740,0,2,1805
135,15604,284,1359525740,1359525883,0,2,143
135,15605,5,1359591557,1359591568,0,2,11
135,15605,284,1359591568,1359593179,0,2,1611
135,15606,297,1359677075,1359677270,0,1,195
135,15607,284,1359708190,1359708213,0,1,23
135,15611,284,1359933703,1359935834,0,1,2131
135,15613,297,1360051422,1360053310,0,2,1888
135,15613,284,1360053310,1360053455,0,2,145
135,15614,21,1360312706,1360314922,0,2,2216
135,15614,284,1360314922,1360315006,0,2,84
135,15615,297,1360634927,1360642092,0,1,7165
135,15616,284,1360659530,1360659692,0,1,162
135,15617,284,1360711943,1360714229,0,1,2286
135,15618,297,1360743921,1360745945,0,2,2024
135,15618,284,1360745945,1360746089,0,2,144
136,15619,284,1360797561,1360801885,0,1,4324
136,15620,253,1333530573,1333530633,0,1,60
136,15625,253,1334652830,1334652890,0,1,60
136,15626,253,1334703688,1334703748,0,1,60
136,15629,5,1334993110,1334995498,0,1,2388
136,15630,253,1335171597,1335171657,0,1,60
136,15631,253,1335221899,1335221959,0,1,60
136,15633,35,1335950204,1335950443,0,2,239
136,15633,640,1335950443,1335950755,0,2,312
136,15635,5,1336117103,1336119271,0,1,2168
136,15637,35,1336555687,1336557521,0,1,1834
136,15640,35,1336884966,1336885026,0,1,60
136,15641,253,1337072936,1337072996,0,1,60
136,15643,253,1337174652,1337176286,0,1,1634
136,15646,253,1337295370,1337295430,0,1,60
136,15650,284,1338021514,1338022998,0,2,1484
136,15650,253,1338022998,1338023728,0,2,730
136,15651,284,1338157293,1338158931,0,1,1638
136,15678,5,1341585888,1341587666,0,1,1778
136,15679,35,1341648913,1341658844,0,1,9931
136,15685,5,1342190670,1342190730,0,1,60
136,15689,8,1343129709,1343131693,0,2,1984
136,15689,5,1343131693,1343131753,0,2,60
136,15691,1,1344155787,1344156190,0,1,403
136,15696,253,1345298603,1345298663,0,1,60
136,15705,253,1351033662,1351033722,0,1,60
136,15706,253,1351120244,1351122368,0,1,2124
136,15707,253,1351160444,1351161139,0,1,695
136,15708,253,1351206548,1351207902,0,1,1354
136,15709,5,1351251668,1351258106,0,1,6438
136,15711,253,1351508694,1351510642,0,1,1948
136,15714,253,1351858119,1351858179,0,1,60
136,15717,253,1352284529,1352286629,0,1,2100
136,15721,253,1353411966,1353413763,0,1,1797
136,15729,253,1354016937,1354016997,0,1,60
136,15735,5,1355566003,1355567548,0,2,1545
136,15735,8,1355569493,1355569553,0,2,60
136,15737,1,1356086288,1356086348,0,1,60
136,15738,5,1356166390,1356168922,0,1,2532
136,15741,8,1356693521,1356693541,0,2,20
136,15741,5,1356693541,1356693601,0,2,60
136,15751,284,1358335403,1358335463,0,1,60
136,15760,35,1359192648,1359202859,0,1,10211
136,15765,351,1359798865,1359798925,0,1,60
137,15771,5,1350902662,1350902737,0,2,75
137,15771,8,1350902737,1350903082,0,2,345
137,15795,351,1352599156,1352602715,0,1,3559
137,15800,297,1353059435,1353061145,0,1,1710
137,15801,351,1353133754,1353134975,0,1,1221
137,15805,297,1353405488,1353406629,0,1,1141
137,15807,297,1353492757,1353493991,0,1,1234
137,15812,5,1353731027,1353732601,0,1,1574
137,15813,8,1353754807,1353759785,0,1,4978
137,15814,351,1353808168,1353810153,0,1,1985
137,15825,297,1354529730,1354530841,0,1,1111
137,15829,297,1354703589,1354704693,0,1,1104
137,15831,297,1354789205,1354790312,0,1,1107
137,15861,297,1356689659,1356691502,0,1,1843
137,15862,351,1356743677,1356744915,0,1,1238
137,15863,21,1356780533,1356780593,0,1,60
137,15864,428,1356831816,1356853026,0,1,21210
137,15872,297,1357294616,1357298003,0,1,3387
137,15876,5,1357552344,1357554922,0,1,2578
137,15878,297,1357641672,1357642930,0,1,1258
138,15918,35,1333512583,1333512747,0,1,164
138,15924,77,1339294832,1339294892,0,1,60
138,15938,21,1342178853,1342178913,0,1,60
138,15941,11,1344869520,1344873018,0,1,3498
138,15944,284,1345424069,1345427718,0,1,3649
138,15946,253,1347197575,1347197635,0,1,60
138,15953,284,1351294864,1351296947,0,1,2083
138,15954,77,1351384044,1351385086,0,1,1042
138,15957,449,1353126704,1353127767,0,1,1063
138,15958,77,1353148874,1353148934,0,1,60
138,15964,336,1354434161,1354434623,0,2,462
138,15964,651,1354434623,1354434683,0,2,60
138,15974,253,1355820397,1355821053,0,2,656
138,15974,35,1355821053,1355821102,0,2,49
138,15983,77,1360051699,1360052053,0,1,354
139,15988,449,1333804225,1333805782,0,1,1557
139,16004,765,1336835386,1336835446,0,1,60
139,16009,1005,1338127193,1338127607,0,2,414
139,16009,765,1338127607,1338128650,0,2,1043
139,16031,35,1344947881,1344948465,0,1,584
139,16032,253,1345215914,1345221009,0,2,5095
139,16032,21,1345224938,1345224998,0,2,60
139,16033,59,1345259735,1345259795,0,1,60
139,16034,35,1347199293,1347199353,0,1,60
139,16035,59,1347678076,1347692704,0,2,14628
139,16035,253,1347692704,1347692740,0,2,36
139,16036,284,1347709336,1347709354,0,2,18
139,16036,284,1347716237,1347717503,0,2,1266
139,16037,253,1349279815,1349281176,0,1,1361
139,16038,449,1349691514,1349692952,0,1,1438
139,16040,253,1350038915,1350040263,0,1,1348
139,16042,35,1350112923,1350123845,0,2,10922
139,16042,449,1350129328,1350131120,0,2,1792
139,16046,35,1350646921,1350646981,0,1,60
139,16051,35,1351255232,1351256748,0,2,1516
139,16051,1005,1351256748,1351256808,0,2,60
139,16052,35,1351411032,1351411092,0,1,60
139,16055,253,1351504107,1351505121,0,1,1014
139,16064,59,1353067875,1353067935,0,1,60
139,16065,253,1353224157,1353224217,0,1,60
139,16069,253,1353686396,1353687475,0,1,1079
139,16070,35,1353737577,1353737637,0,1,60
139,16071,253,1354010009,1354011338,0,1,1329
139,16073,59,1354432308,1354432368,0,1,60
139,16074,35,1354494343,1354495488,0,1,1145
139,16082,35,1355496818,1355496878,0,1,60
139,16086,59,1355632182,1355632242,0,1,60
139,16092,35,1356164318,1356164988,0,1,670
139,16093,35,1356215076,1356215136,0,1,60
139,16096,35,1356945139,1356963248,0,2,18109
139,16096,253,1356963248,1356963308,0,2,60
139,16097,253,1356979211,1356980281,0,2,1070
139,16097,35,1356980281,1356980341,0,2,60
139,16104,284,1357812270,1357812730,0,2,460
139,16104,35,1357825800,1357825860,0,2,60
139,16106,35,1357906928,1357906988,0,1,60
139,16107,35,1358145464,1358147746,0,1,2282
139,16109,253,1358416171,1358416181,0,2,10
139,16109,59,1358416181,1358416241,0,2,60
141,16227,59,1334121782,1334122154,0,2,372
141,16227,603,1334132216,1334132648,0,2,432
141,16233,59,1334759887,1334759947,0,1,60
141,16237,59,1335220463,1335220637,0,3,174
141,16237,480,1335222119,1335222309,0,3,190
141,16237,5,1335222309,1335222977,0,3,668
141,16238,5,1335266667,1335267674,0,2,1007
141,16238,59,1335270287,1335271274,0,2,987
141,16251,59,1337235793,1337236403,0,2,610
141,16251,603,1337243599,1337243714,0,2,115
141,16252,603,1337260198,1337260215,0,2,17
141,16252,59,1337263759,1337264339,0,2,580
141,16257,59,1338089311,1338089498,0,2,187
141,16257,59,1338094204,1338094872,0,2,668
141,16259,59,1338350863,1338351068,0,1,205
141,16260,59,1338557905,1338558453,0,1,548
141,16263,59,1339055534,1339055750,0,3,216
141,16263,603,1339056719,1339056792,0,3,73
141,16263,603,1339056792,1339057122,0,3,330
141,16264,59,1339081961,1339082206,0,1,245
141,16271,59,1340782651,1340783536,0,1,885
141,16272,59,1340806698,1340807557,0,1,859
141,16274,59,1341228717,1341228994,0,2,277
141,16274,59,1341242603,1341243345,0,2,742
141,16275,59,1341565071,1341565385,0,2,314
141,16275,603,1341566361,1341566943,0,2,582
141,16277,59,1341649315,1341649791,0,2,476
141,16277,59,1341654337,1341654765,0,2,428
141,16279,59,1341749524,1341750304,0,1,780
141,16287,59,1342514624,1342514850,0,2,226
141,16287,603,1342515981,1342516041,0,2,60
141,16288,603,1342531410,1342531613,0,1,203
141,16290,59,1343125678,1343125878,0,1,200
141,16291,59,1343141130,1343141843,0,1,713
141,16296,59,1344600532,1344604829,0,2,4297
141,16296,59,1344604849,1344605578,0,2,729
141,16299,59,1344932037,1344932801,0,1,764
141,16300,59,1344957077,1344957506,0,1,429
141,16305,59,1347526176,1347526451,0,1,275
141,16306,59,1350039892,1350040310,0,2,418
141,16306,35,1350051911,1350052051,0,2,140
141,16307,59,1351052905,1351053211,0,1,306
141,16312,59,1352380491,1352380551,0,1,60
141,16315,59,1353483422,1353483973,0,2,551
141,16315,59,1353503281,1353503341,0,2,60
141,16323,35,1358002440,1358002500,0,1,60
141,16325,59,1359176290,1359176350,0,1,60
141,16327,59,1360052141,1360053205,0,1,1064
142,16333,21,1334369021,1334372155,0,1,3134
142,16335,5,1334987176,1334989580,0,1,2404
142,16337,297,1335220218,1335220278,0,1,60
142,16340,336,1335528146,1335528206,0,1,60
142,16344,5,1336200077,1336201949,0,1,1872
142,16359,5,1338015327,1338021276,0,1,5949
142,16360,263,1338894642,1338895308,0,1,666
142,16363,21,1339364877,1339364937,0,1,60
142,16370,336,1340099261,1340099321,0,1,60
142,16379,603,1341660097,1341660157,0,1,60
142,16380,5,1341715769,1341727907,0,1,12138
142,16381,5,1341825296,1341826447,0,2,1151
142,16381,8,1341826447,1341826507,0,2,60
142,16383,336,1342086704,1342086764,0,1,60
142,16389,253,1344507472,1344507532,0,1,60
142,16405,253,1351598458,1351598518,0,1,60
142,16407,336,1351757421,1351757955,0,1,534
142,16412,21,1353014341,1353014401,0,1,60
142,16420,449,1354343467,1354343527,0,1,60
142,16421,35,1354419593,1354419653,0,1,60
142,16429,21,1355024914,1355026473,0,2,1559
142,16429,603,1355026473,1355027003,0,2,530
142,16430,640,1355063692,1355063752,0,1,60
142,16434,5,1355647907,1355650307,0,1,2400
142,16436,5,1356159105,1356159612,0,2,507
142,16436,8,1356162764,1356165898,0,2,3134
142,16438,5,1356677600,1356686770,0,1,9170
142,16439,5,1356696990,1356697050,0,1,60
142,16440,253,1356763608,1356764891,0,1,1283
142,16441,449,1356916602,1356916662,0,1,60
142,16442,603,1357098947,1357099007,0,1,60
142,16443,21,1357126150,1357126210,0,1,60
142,16444,21,1357164257,1357165940,0,2,1683
142,16444,603,1357165940,1357166000,0,2,60
142,16445,8,1357533393,1357533453,0,1,60
142,16446,603,1357893370,1357894772,0,1,1402
142,16448,263,1358510614,1358510674,0,1,60
142,16450,297,1359111733,1359112017,0,1,284
143,16465,35,1334277819,1334287877,0,1,10058
143,16480,35,1335531110,1335531441,0,1,331
143,16488,5,1336795352,1336796697,0,1,1345
143,16492,2151,1337050052,1337051247,0,1,1195
143,16516,480,1339226985,1339227101,0,3,116
143,16516,5,1339227101,1339227133,0,3,32
143,16516,8,1339227485,1339228765,0,3,1280
143,16535,77,1341721409,1341721427,0,1,18
143,16536,77,1341756274,1341756303,0,1,29
143,16545,35,1342495237,1342496068,0,1,831
143,16546,35,1342514958,1342515519,0,2,561
143,16546,253,1342515519,1342515953,0,2,434
143,16552,35,1343470494,1343470554,0,1,60
143,16563,5,1345253828,1345253888,0,1,60
143,16596,104,1354338787,1354340897,0,1,2110
143,16601,35,1354956910,1354956939,0,1,29
143,16615,5,1357210664,1357210724,0,1,60
143,16630,8,1360049170,1360049809,0,1,639
143,16633,284,1360294329,1360294781,0,1,452
144,16655,21,1337035730,1337035790,0,1,60
144,16656,21,1337168650,1337169931,0,1,1281
144,16664,640,1339569966,1339575021,0,1,5055
145,16727,640,1350994266,1350994326,0,1,60
145,16729,284,1351156405,1351156465,0,1,60
145,16731,104,1351326713,1351329004,0,1,2291
145,16743,59,1352595487,1352595547,0,1,60
146,16789,5,1334455564,1334455874,0,1,310
146,16808,5,1336793568,1336794053,0,3,485
146,16808,8,1336794053,1336795454,0,3,1401
146,16808,71,1336803234,1336804472,0,3,1238
146,16809,5,1336829505,1336830695,0,1,1190
146,16810,5,1336853822,1336855137,0,3,1315
146,16810,260,1336855137,1336855241,0,3,104
146,16810,1005,1336855241,1336858767,0,3,3526
146,16811,77,1336891500,1336892943,0,2,1443
146,16811,428,1336892943,1336893709,0,2,766
146,16814,5,1337056671,1337056781,0,1,110
146,16818,428,1338073028,1338073924,0,2,896
146,16818,71,1338094132,1338094192,0,2,60
146,16819,5,1338094746,1338097898,0,1,3152
146,16829,336,1339915421,1339916675,0,3,1254
146,16829,5,1339916675,1339917324,0,3,649
146,16829,263,1339935005,1339935065,0,3,60
146,16833,336,1340785306,1340786805,0,2,1499
146,16833,5,1340786805,1340794047,0,2,7242
146,16834,5,1340808096,1340809201,0,2,1105
146,16834,336,1340809201,1340811288,0,2,2087
146,16845,5,1342351332,1342352668,0,2,1336
146,16845,336,1342352668,1342353767,0,2,1099
146,16858,336,1344661020,1344662786,0,1,1766
146,16859,5,1344691711,1344695367,0,1,3656
146,16860,5,1344760062,1344760435,0,5,373
146,16860,8,1344769132,1344770237,0,5,1105
146,16860,5,1344771827,1344772695,0,5,868
146,16860,21,1344772695,1344773965,0,5,1270
146,16860,77,1344774630,1344774927,0,5,297
146,16862,28,1345445543,1345448003,0,2,2460
146,16862,253,1345448003,1345449689,0,2,1686
146,16864,11,1349688969,1349689327,0,2,358
146,16864,5,1349689327,1349692632,0,2,3305
146,16865,5,1350463400,1350464982,0,2,1582
146,16865,263,1350464982,1350465568,0,2,586
146,16871,5,1351390761,1351391522,0,1,761
146,16872,5,1351431527,1351431587,0,1,60
146,16875,5,1351763003,1351763063,0,1,60
146,16876,260,1351781922,1351781982,0,1,60
146,16881,5,1352274827,1352281596,0,3,6769
146,16881,8,1352281596,1352286001,0,3,4405
146,16881,5,1352290011,1352290071,0,3,60
146,16882,260,1352620275,1352621388,0,2,1113
146,16882,5,1352621388,1352621991,0,2,603
146,16883,5,1352634839,1352634899,0,1,60
146,16884,253,1352710489,1352711136,0,4,647
146,16884,35,1352711136,1352711848,0,4,712
146,16884,480,1352711848,1352712105,0,4,257
146,16884,5,1352712105,1352715965,0,4,3860
146,16886,336,1352774060,1352775057,0,2,997
146,16886,5,1352775057,1352775479,0,2,422
146,16887,5,1352793170,1352793230,0,1,60
146,16891,253,1353408937,1353409696,0,1,759
146,16892,11,1353915390,1353915897,0,4,507
146,16892,5,1353915897,1353916250,0,4,353
146,16892,5,1353927416,1353928918,0,4,1502
146,16892,77,1353930672,1353931115,0,4,443
146,16894,263,1354113322,1354114584,0,1,1262
146,16897,253,1354436541,1354436974,0,1,433
146,16898,5,1354463665,1354470235,0,1,6570
146,16910,77,1355638506,1355640446,0,3,1940
146,16910,21,1355640446,1355640872,0,3,426
146,16910,5,1355640872,1355643921,0,3,3049
146,16911,336,1355662378,1355663498,0,1,1120
146,16912,5,1355811728,1355814289,0,1,2561
146,16915,284,1356695731,1356703505,0,1,7774
146,16916,5,1356749689,1356749749,0,1,60
146,16917,35,1356770233,1356770293,0,1,60
146,16918,253,1356845603,1356846537,0,2,934
146,16918,284,1356846537,1356847628,0,2,1091
146,16919,11,1357468626,1357470701,0,1,2075
147,16938,77,1359708793,1359709260,0,2,467
147,16938,21,1359710926,1359711586,0,2,660
147,16941,284,1333924588,1333924859,0,2,271
147,16941,35,1333924859,1333926803,0,2,1944
147,16943,35,1334011237,1334013296,0,2,2059
147,16943,35,1334030070,1334031289,0,2,1219
147,16945,35,1334115786,1334117251,0,3,1465
147,16945,35,1334127534,1334128294,0,3,760
147,16945,35,1334135520,1334135580,0,3,60
147,16948,35,1334213547,1334214948,0,1,1401
147,16950,35,1334301514,1334303281,0,1,1767
147,16951,35,1334376873,1334376933,0,1,60
147,16953,35,1334529062,1334529122,0,1,60
147,16955,351,1334701247,1334702307,0,2,1060
147,16955,35,1334702307,1334702367,0,2,60
147,16956,35,1334788911,1334790767,0,1,1856
147,16957,35,1334818082,1334819744,0,1,1662
147,16959,875,1334988007,1335000159,0,3,12152
147,16959,875,1335000159,1335000888,0,3,729
147,16959,35,1335000888,1335002596,0,3,1708
147,16960,284,1335133942,1335134526,0,2,584
147,16960,35,1335134526,1335134586,0,2,60
147,16961,35,1335163924,1335165341,0,1,1417
147,16963,35,1335249861,1335251021,0,1,1160
147,16965,35,1335307359,1335309468,0,1,2109
147,16966,35,1335393897,1335393957,0,1,60
147,16967,35,1335422954,1335424575,0,1,1621
147,16969,35,1335566667,1335566727,0,1,60
147,16970,35,1335587393,1335588967,0,1,1574
147,16972,35,1335912054,1335914066,0,1,2012
147,16973,35,1335932042,1335932102,0,1,60
147,16975,35,1336343537,1336343597,0,1,60
147,16976,35,1336373223,1336374967,0,1,1744
147,16977,35,1336430493,1336430553,0,1,60
147,16978,35,1336517003,1336518792,0,1,1789
147,16979,35,1336538650,1336540167,0,1,1517
147,16980,35,1336603300,1336605235,0,1,1935
147,16982,35,1336718938,1336720526,0,1,1588
147,16983,35,1336776172,1336777471,0,2,1299
147,16983,35,1336796156,1336796216,0,2,60
147,16987,35,1336948866,1336948926,0,1,60
147,16989,35,1337035551,1337035611,0,1,60
147,16990,35,1337064598,1337066125,0,1,1527
147,16991,35,1337121764,1337123837,0,1,2073
147,16992,35,1337143933,1337145308,0,1,1375
147,16993,35,1337380927,1337382668,0,1,1741
147,16994,35,1337401628,1337403289,0,1,1661
147,16995,35,1337640244,1337641995,0,1,1751
147,16996,35,1337669572,1337670891,0,1,1319
147,16999,35,1337985762,1337987084,0,1,1322
147,17000,35,1338007215,1338008959,0,1,1744
147,17002,35,1338763514,1338765221,0,1,1707
147,17003,35,1338849838,1338851681,0,1,1843
147,17004,35,1338879102,1338880532,0,1,1430
147,17006,35,1339022618,1339022678,0,1,60
147,17007,35,1339051856,1339053370,0,1,1514
147,17008,35,1339109023,1339109083,0,1,60
147,17009,35,1339217510,1339220207,0,1,2697
147,17011,35,1339368092,1339370023,0,1,1931
147,17012,35,1339397384,1339398905,0,1,1521
147,17013,35,1339454588,1339454648,0,1,60
147,17014,35,1339483979,1339485457,0,1,1478
147,17015,35,1339561032,1339561748,0,2,716
147,17015,35,1339574169,1339576012,0,2,1843
147,17016,35,1339627389,1339627449,0,1,60
147,17017,35,1339656930,1339658166,0,1,1236
147,17020,35,1340002126,1340003759,0,1,1633
147,17021,35,1340232244,1340233993,0,1,1749
147,17022,35,1340261533,1340262925,0,1,1392
147,17023,35,1340750836,1340769237,0,1,18401
147,17024,35,1340772995,1340775293,0,1,2298
147,17025,35,1341287531,1341287591,0,1,60
147,17026,35,1341556151,1341557560,0,1,1409
147,17028,35,1341873660,1341873720,0,1,60
147,17030,640,1342340246,1342341605,0,4,1359
147,17030,5,1342341605,1342342219,0,4,614
147,17030,5,1342349084,1342350702,0,4,1618
147,17030,351,1342350702,1342351068,0,4,366
147,17031,35,1342493423,1342494558,0,1,1135
147,17032,35,1342833282,1342834576,0,1,1294
147,17034,35,1343460026,1343460086,0,1,60
147,17036,875,1343641881,1343642994,0,2,1113
147,17036,35,1343642994,1343643054,0,2,60
147,17039,35,1344664019,1344665891,0,1,1872
147,17041,428,1344743472,1344743681,0,3,209
147,17041,428,1344746373,1344748041,0,3,1668
147,17041,35,1344748041,1344748101,0,3,60
147,17042,35,1345251729,1345252834,0,1,1105
147,17043,35,1346845197,1346845257,0,1,60
147,17044,35,1346914036,1346914096,0,1,60
147,17045,35,1347663219,1347682580,0,2,19361
147,17045,35,1347682580,1347682640,0,2,60
147,17047,35,1350024669,1350024729,0,1,60
147,17048,35,1350103862,1350105457,0,1,1595
147,17050,351,1350646801,1350646861,0,1,60
147,17052,35,1350974903,1350974963,0,1,60
147,17053,35,1351032166,1351051831,0,1,19665
147,17054,35,1351054695,1351054755,0,1,60
147,17055,35,1351144901,1351144961,0,1,60
147,17056,35,1351154636,1351156462,0,1,1826
147,17058,35,1351234265,1351234886,0,2,621
147,17058,35,1351246807,1351248311,0,2,1504
147,17062,35,1352273963,1352274023,0,1,60
147,17068,5,1355978141,1355978201,0,1,60
147,17073,5,1357458064,1357458124,0,1,60
147,17075,35,1357690967,1357691027,0,1,60
148,17080,35,1360820492,1360822070,0,1,1578
148,17149,21,1352702349,1352711151,0,1,8802
148,17158,21,1354693138,1354713336,0,1,20198
149,17204,336,1334821784,1334821844,0,1,60
149,17210,2151,1335407361,1335407421,0,1,60
149,17213,2151,1335686035,1335686095,0,1,60
149,17225,11,1336812333,1336815218,0,2,2885
149,17225,253,1336815218,1336815278,0,2,60
149,17231,2151,1337245460,1337245520,0,1,60
149,17238,2151,1338274865,1338274925,0,1,60
149,17242,2151,1338977806,1338977866,0,1,60
149,17246,640,1339323639,1339323699,0,1,60
150,17261,1005,1333982626,1333982686,0,1,60
150,17272,1005,1336052223,1336052283,0,1,60
150,17273,260,1336119057,1336119156,0,1,99
150,17281,1005,1337397769,1337397844,0,3,75
150,17281,71,1337400066,1337400079,0,3,13
150,17281,1005,1337413118,1337413266,0,3,148
150,17285,1005,1338002391,1338004204,0,1,1813
150,17289,1005,1339408201,1339408261,0,1,60
150,17303,1005,1341584911,1341584921,0,1,10
150,17314,428,1342180999,1342181059,0,1,60
150,17319,428,1342481000,1342496915,0,1,15915
150,17328,1005,1344515033,1344516631,0,1,1598
150,17329,260,1345295704,1345297051,0,1,1347
150,17336,1005,1349999051,1349999111,0,1,60
150,17338,35,1350119050,1350119741,0,1,691
150,17341,104,1351250336,1351263712,0,2,13376
150,17341,35,1351263712,1351263772,0,2,60
150,17342,5,1351322697,1351322757,0,1,60
150,17351,651,1353126887,1353144303,0,1,17416
150,17361,1005,1354946723,1354948950,0,4,2227
150,17361,5,1354948950,1354948972,0,4,22
150,17361,8,1354948972,1354959077,0,4,10105
150,17361,480,1354962888,1354962948,0,4,60
150,17362,336,1354969086,1354969146,0,1,60
150,17367,5,1355647278,1355651400,0,1,4122
150,17372,1005,1356211011,1356211041,0,1,30
150,17374,104,1357792133,1357792544,0,1,411
151,17386,35,1333506918,1333506978,0,1,60
151,17387,11,1333619964,1333620024,0,1,60
151,17388,351,1333844657,1333845757,0,2,1100
151,17388,35,1333845757,1333847146,0,2,1389
151,17389,253,1333878085,1333878464,0,1,379
151,17390,35,1334037435,1334037495,0,1,60
151,17392,35,1334113623,1334113683,0,1,60
151,17393,21,1334199298,1334199358,0,1,60
151,17394,11,1334300749,1334300809,0,1,60
151,17395,11,1334376933,1334378468,0,1,1535
151,17397,5,1334449357,1334449676,0,2,319
151,17397,11,1334449676,1334449736,0,2,60
151,17398,35,1334670276,1334671532,0,2,1256
151,17398,351,1334671532,1334671592,0,2,60
151,17399,35,1334811844,1334811904,0,1,60
151,17400,35,1334872039,1334872099,0,1,60
151,17401,35,1334914256,1334915143,0,3,887
151,17401,5,1334915143,1334915612,0,3,469
151,17401,11,1334931794,1334931854,0,3,60
151,17402,35,1335072980,1335073040,0,1,60
151,17403,253,1335154687,1335155317,0,2,630
151,17403,253,1335157012,1335157072,0,2,60
151,17404,35,1335257866,1335259075,0,2,1209
151,17404,35,1335277233,1335277293,0,2,60
151,17405,875,1335533471,1335536257,0,1,2786
151,17408,428,1335695027,1335695087,0,1,60
151,17409,35,1335929927,1335929987,0,1,60
151,17411,11,1336113879,1336114342,0,4,463
151,17411,5,1336114342,1336114757,0,4,415
151,17411,5,1336126938,1336127341,0,4,403
151,17411,11,1336127341,1336127401,0,4,60
151,17412,284,1336200892,1336201378,0,2,486
151,17412,640,1336201378,1336201896,0,2,518
151,17413,35,1336227370,1336227430,0,1,60
151,17414,35,1336367758,1336367818,0,1,60
151,17416,11,1336487867,1336487927,0,1,60
151,17417,35,1336529241,1336529301,0,1,60
151,17418,351,1336779605,1336780423,0,3,818
151,17418,11,1336780423,1336780970,0,3,547
151,17418,21,1336780970,1336781030,0,3,60
151,17419,11,1336874046,1336874106,0,1,60
151,17420,11,1336895411,1336895826,0,2,415
151,17420,5,1336895826,1336897332,0,2,1506
151,17421,5,1336918691,1336918751,0,1,60
151,17422,35,1336973501,1336974516,0,1,1015
151,17423,253,1337055612,1337057474,0,1,1862
151,17424,428,1337082740,1337082800,0,1,60
151,17425,35,1337134054,1337134114,0,1,60
151,17426,35,1337228950,1337229010,0,1,60
151,17427,5,1337345251,1337345311,0,1,60
151,17429,35,1337832357,1337832417,0,1,60
151,17430,351,1337983165,1337983225,0,1,60
151,17432,35,1338345484,1338345544,0,1,60
151,17433,21,1338688387,1338688447,0,1,60
151,17434,21,1338724388,1338725423,0,2,1035
151,17434,11,1338725423,1338725483,0,2,60
151,17435,35,1338777503,1338777563,0,1,60
151,17436,35,1338864138,1338864198,0,1,60
151,17437,35,1339036508,1339036568,0,1,60
151,17438,35,1339301102,1339301974,0,1,872
151,17439,351,1339396700,1339396760,0,1,60
151,17440,875,1339922142,1339923665,0,2,1523
151,17440,5,1339923665,1339925290,0,2,1625
151,17441,5,1339938746,1339938806,0,1,60
151,17442,253,1340001324,1340002192,0,1,868
151,17443,351,1340025794,1340025854,0,1,60
151,17445,11,1340802481,1340802541,0,1,60
151,17446,35,1341115175,1341116317,0,1,1142
151,17447,35,1341284357,1341284417,0,1,60
151,17448,35,1341375523,1341375583,0,1,60
151,17449,253,1341585965,1341587023,0,1,1058
151,17450,35,1341650682,1341651081,0,3,399
151,17450,35,1341651081,1341669035,0,3,17954
151,17450,35,1341669035,1341669095,0,3,60
151,17451,428,1341713379,1341714250,0,1,871
151,17452,35,1341737484,1341739247,0,1,1763
151,17453,351,1341757858,1341757918,0,1,60
151,17454,35,1341802805,1341802865,0,1,60
151,17455,35,1341841736,1341843422,0,2,1686
151,17455,351,1341843422,1341843482,0,2,60
151,17457,35,1342269281,1342270113,0,3,832
151,17457,480,1342270113,1342270491,0,3,378
151,17457,5,1342270491,1342270995,0,3,504
151,17460,253,1342823946,1342831633,0,2,7687
151,17460,35,1342831633,1342832773,0,2,1140
151,17461,35,1342910166,1342910226,0,1,60
151,17462,351,1343117836,1343119065,0,6,1229
151,17462,11,1343119065,1343119448,0,6,383
151,17462,5,1343119448,1343120472,0,6,1024
151,17462,8,1343120472,1343122102,0,6,1630
151,17462,5,1343137956,1343138256,0,6,300
151,17462,11,1343138256,1343138316,0,6,60
151,17463,11,1343452743,1343453090,0,3,347
151,17463,5,1343453090,1343455801,0,3,2711
151,17463,11,1343455801,1343455861,0,3,60
151,17464,35,1343539818,1343540982,0,1,1164
151,17465,35,1343629704,1343630613,0,3,909
151,17465,480,1343630613,1343631595,0,3,982
151,17465,5,1343631595,1343640133,0,3,8538
151,17466,5,1343656402,1343656626,0,2,224
151,17466,11,1343656626,1343656686,0,2,60
151,17467,35,1343684471,1343684693,0,1,222
151,17469,35,1344502023,1344502083,0,1,60
151,17470,35,1344580198,1344581348,0,1,1150
151,17472,35,1344651855,1344651915,0,1,60
151,17473,5,1344666514,1344666721,0,4,207
151,17473,480,1344666721,1344667543,0,4,822
151,17473,35,1344667543,1344668025,0,4,482
151,17473,253,1344668025,1344668085,0,4,60
151,17475,35,1344770674,1344770734,0,1,60
151,17476,253,1345250289,1345253488,0,2,3199
151,17476,253,1345265619,1345265679,0,2,60
151,17478,5,1347676517,1347676577,0,1,60
151,17479,5,1347717501,1347717561,0,1,60
151,17481,35,1349733218,1349733278,0,1,60
151,17482,351,1349989885,1349989945,0,1,60
151,17483,35,1350023708,1350024491,0,1,783
151,17484,35,1350049499,1350049559,0,1,60
151,17485,35,1350095633,1350095693,0,1,60
151,17486,35,1350127729,1350127789,0,1,60
151,17487,35,1350386772,1350388002,0,2,1230
151,17487,351,1350388002,1350388062,0,2,60
151,17488,5,1350464793,1350465616,0,1,823
151,17490,11,1350897514,1350899567,0,1,2053
151,17491,35,1350979168,1350980581,0,1,1413
151,17493,351,1351072335,1351072395,0,1,60
151,17495,35,1351395362,1351396854,0,1,1492
151,17496,875,1351482769,1351482829,0,1,60
151,17497,875,1351684535,1351685719,0,3,1184
151,17497,603,1351685719,1351693538,0,3,7819
151,17497,35,1351693538,1351693598,0,3,60
151,17498,35,1351757280,1351758140,0,3,860
151,17498,5,1351758140,1351758672,0,3,532
151,17498,11,1351778110,1351778170,0,3,60
151,17499,603,1352286420,1352286480,0,1,60
151,17501,11,1352626176,1352626236,0,1,60
151,17502,35,1352698154,1352699353,0,1,1199
151,17504,11,1353199988,1353200346,0,2,358
151,17504,5,1353200346,1353200406,0,2,60
151,17505,35,1353467498,1353467558,0,1,60
151,17506,875,1353593230,1353593290,0,1,60
151,17507,35,1353656418,1353656478,0,1,60
151,17508,253,1353753252,1353753312,0,1,60
151,17509,35,1353814550,1353815364,0,1,814
151,17511,35,1353983766,1353983826,0,1,60
151,17512,11,1354111686,1354111746,0,1,60
151,17513,35,1354220358,1354221489,0,2,1131
151,17513,351,1354221489,1354221549,0,2,60
151,17514,253,1354334729,1354334789,0,1,60
151,17515,284,1354418219,1354428244,0,1,10025
151,17516,35,1354542495,1354542555,0,1,60
151,17517,35,1354774007,1354788523,0,1,14516
151,17518,253,1354801156,1354803065,0,2,1909
151,17518,351,1354803065,1354803125,0,2,60
151,17521,253,1355046134,1355047318,0,1,1184
151,17522,35,1355124802,1355125089,0,2,287
151,17522,603,1355125089,1355125509,0,2,420
151,17523,35,1355148182,1355149575,0,2,1393
151,17523,351,1355149575,1355149635,0,2,60
151,17524,35,1355294598,1355294658,0,1,60
151,17526,284,1355492112,1355492172,0,1,60
151,17527,35,1355632951,1355633577,0,4,626
151,17527,480,1355633577,1355639257,0,4,5680
151,17527,35,1355639257,1355646658,0,4,7401
151,17527,35,1355646658,1355646718,0,4,60
151,17530,35,1358161222,1358162422,0,2,1200
151,17530,351,1358162422,1358162482,0,2,60
151,17531,35,1359119748,1359119808,0,1,60
151,17532,35,1359267228,1359268123,0,2,895
151,17532,5,1359268123,1359270637,0,2,2514
151,17533,5,1359296471,1359296716,0,2,245
151,17533,11,1359296716,1359296776,0,2,60
151,17534,35,1359544395,1359544455,0,1,60
151,17535,35,1359615974,1359616286,0,1,312
151,17536,253,1359794968,1359798640,0,1,3672
151,17538,11,1360247888,1360247948,0,1,60
152,17539,253,1360828356,1360829019,0,1,663
152,17587,351,1344169810,1344170565,0,1,755
152,17636,35,1359276397,1359276457,0,1,60
153,17646,35,1346912784,1346912844,0,1,60
153,17652,21,1350615089,1350615118,0,1,29
153,17697,449,1357816248,1357816289,0,1,41
154,17718,21,1334485430,1334488548,0,1,3118
154,17740,21,1341737875,1341737935,0,1,60
155,17779,875,1334308954,1334309728,0,1,774
155,17782,35,1334579106,1334579166,0,1,60
155,17788,253,1335004726,1335004786,0,1,60
155,17860,59,1341836352,1341841917,0,1,5565
155,17875,59,1344255064,1344255124,0,1,60
155,17886,77,1350470311,1350470371,0,1,60
155,17897,59,1352113531,1352114454,0,1,923
155,17899,253,1352279867,1352281435,0,1,1568
155,17912,59,1353938255,1353938315,0,1,60
155,17914,59,1354022191,1354022251,0,1,60
155,17916,59,1354661468,1354661528,0,1,60
155,17917,253,1354705578,1354705638,0,1,60
155,17919,59,1354873421,1354873481,0,1,60
155,17925,59,1355492652,1355492712,0,1,60
155,17943,59,1358509610,1358509670,0,1,60
155,17950,59,1359535559,1359536720,0,1,1161
155,17952,59,1359632678,1359633884,0,1,1206
155,17954,59,1359714844,1359714904,0,1,60
155,17964,59,1360664940,1360665000,0,1,60
156,17966,59,1360745102,1360745162,0,1,60
156,17991,603,1337171308,1337171368,0,1,60
156,18000,212,1338102861,1338103487,0,1,626
156,18003,212,1338850368,1338852704,0,1,2336
156,18030,212,1343461114,1343467883,0,1,6769
156,18031,212,1343543451,1343543511,0,1,60
156,18037,212,1351321044,1351325520,0,1,4476
156,18050,603,1353410208,1353410268,0,1,60
156,18071,212,1355548122,1355548182,0,1,60
156,18085,603,1359183982,1359187779,0,1,3797
156,18088,212,1359782182,1359784231,0,1,2049
158,18285,77,1359622411,1359622471,0,1,60
158,18289,449,1359874986,1359874998,0,1,12
158,18294,449,1360229363,1360229794,0,1,431
158,18295,449,1360278436,1360280630,0,1,2194
159,18303,284,1333485235,1333485295,0,1,60
159,18304,284,1333615139,1333615199,0,1,60
159,18305,284,1333874154,1333874746,0,1,592
159,18306,284,1333898880,1333900443,0,1,1563
159,18309,284,1334220241,1334220621,0,1,380
159,18314,284,1334824590,1334824650,0,1,60
159,18316,284,1334909857,1334910486,0,1,629
159,18317,284,1334935695,1334937210,0,1,1515
159,18318,480,1334978452,1334979996,0,1,1544
159,18319,5,1335011813,1335012739,0,1,926
159,18324,284,1335626619,1335626679,0,1,60
159,18326,284,1336034546,1336035114,0,1,568
159,18327,284,1336372702,1336373506,0,1,804
159,18328,5,1336395282,1336397000,0,1,1718
159,18332,284,1336750028,1336750088,0,1,60
159,18334,5,1336827582,1336828260,0,1,678
159,18335,5,1336991327,1336991387,0,1,60
159,18338,284,1337243492,1337258683,0,1,15191
159,18339,5,1337346331,1337346391,0,1,60
159,18340,284,1337391142,1337391974,0,1,832
159,18342,284,1337441033,1337441093,0,1,60
159,18347,284,1337959419,1337959479,0,1,60
159,18349,480,1338101136,1338101682,0,2,546
159,18349,5,1338104678,1338104738,0,2,60
159,18361,284,1339341589,1339341649,0,1,60
159,18363,284,1339427902,1339427962,0,1,60
159,18366,284,1339593307,1339594848,0,1,1541
159,18368,8,1339763174,1339766713,0,1,3539
159,18370,284,1339946928,1339946988,0,1,60
159,18378,35,1341400815,1341401467,0,1,652
159,18384,284,1342340226,1342340984,0,1,758
159,18385,284,1342405413,1342405473,0,1,60
159,18389,284,1343121477,1343121537,0,1,60
159,18391,253,1343471918,1343473422,0,1,1504
159,18393,284,1343624161,1343625134,0,1,973
159,18400,21,1344672053,1344672846,0,3,793
159,18400,5,1344672846,1344673582,0,3,736
159,18400,284,1344687132,1344688584,0,3,1452
159,18404,5,1345282211,1345283197,0,2,986
159,18404,35,1345283197,1345283883,0,2,686
159,18406,284,1345423731,1345427827,0,1,4096
159,18410,8,1355732293,1355732353,0,1,60
159,18413,35,1356240764,1356241985,0,3,1221
159,18413,480,1356243305,1356243402,0,3,97
159,18413,5,1356243402,1356243740,0,3,338
159,18414,284,1356914196,1356915587,0,1,1391
159,18417,8,1357368895,1357370543,0,1,1648
160,18455,5,1339572218,1339572278,0,1,60
160,18461,8,1341559872,1341559932,0,1,60
160,18473,428,1351691385,1351691445,0,1,60
161,18505,260,1333495553,1333495796,0,2,243
161,18505,428,1333495796,1333496159,0,2,363
161,18507,1005,1333581045,1333582256,0,1,1211
161,18511,260,1333855749,1333857248,0,2,1499
161,18511,77,1333857248,1333860345,0,2,3097
161,18512,77,1333878341,1333879620,0,2,1279
161,18512,260,1333879620,1333880129,0,2,509
161,18513,1005,1333926600,1333928612,0,1,2012
161,18514,1005,1334013081,1334014203,0,1,1122
161,18516,260,1334100072,1334100578,0,2,506
161,18516,428,1334100578,1334101039,0,2,461
161,18517,428,1334133082,1334135010,0,1,1928
161,18518,260,1334186491,1334187297,0,1,806
161,18519,428,1334225143,1334227068,0,2,1925
161,18519,260,1334232411,1334232839,0,2,428
161,18520,1005,1334272288,1334287402,0,1,15114
161,18521,428,1334318939,1334318999,0,1,60
161,18522,260,1334366304,1334367211,0,3,907
161,18522,253,1334367211,1334367959,0,3,748
161,18522,104,1334369163,1334372017,0,3,2854
161,18523,260,1334451665,1334453070,0,1,1405
161,18525,253,1334670151,1334671254,0,2,1103
161,18525,260,1334671254,1334672341,0,2,1087
161,18526,1005,1334704484,1334705288,0,1,804
161,18527,1005,1334791225,1334792190,0,1,965
161,18532,1005,1335137057,1335142434,0,1,5377
161,18533,1005,1335179154,1335180031,0,1,877
161,18536,1005,1335309058,1335310355,0,1,1297
161,18537,1005,1335360924,1335360984,0,1,60
161,18538,428,1335396207,1335396683,0,1,476
161,18540,260,1335575639,1335576929,0,3,1290
161,18540,253,1335576929,1335578202,0,3,1273
161,18540,104,1335578202,1335578753,0,3,551
161,18541,35,1335595671,1335597774,0,2,2103
161,18541,336,1335597774,1335598230,0,2,456
161,18544,1005,1335946378,1335947046,0,1,668
161,18546,253,1336107421,1336108452,0,3,1031
161,18546,35,1336112038,1336113918,0,3,1880
161,18546,336,1336113918,1336116703,0,3,2785
161,18549,260,1336346608,1336347356,0,1,748
161,18550,1005,1336389856,1336390708,0,1,852
161,18552,1005,1336519249,1336520153,0,1,904
161,18553,35,1336556565,1336557167,0,3,602
161,18553,35,1336558272,1336559718,0,3,1446
161,18553,260,1336559718,1336560390,0,3,672
161,18554,1005,1336605681,1336605741,0,1,60
161,18555,1005,1336692021,1336692940,0,1,919
161,18556,428,1336792552,1336792994,0,1,442
161,18557,1005,1336868445,1336868505,0,1,60
161,18562,428,1337082493,1337082890,0,1,397
161,18563,1005,1337123713,1337124337,0,1,624
161,18566,1005,1337297026,1337297206,0,1,180
161,18568,11,1337408605,1337409701,0,1,1096
161,18569,5,1337422905,1337424925,0,1,2020
161,18573,260,1337937915,1337938472,0,2,557
161,18573,297,1337938472,1337938532,0,2,60
161,18574,253,1338010208,1338011283,0,2,1075
161,18574,104,1338012860,1338017099,0,2,4239
161,18579,1005,1338765754,1338766609,0,1,855
161,18587,260,1340783184,1340784776,0,1,1592
161,18592,1005,1341489523,1341489583,0,1,60
161,18594,336,1341666795,1341666855,0,1,60
161,18600,1005,1342137982,1342141879,0,1,3897
161,18601,260,1342259636,1342260750,0,2,1114
161,18601,336,1342264888,1342264948,0,2,60
161,18602,260,1342396356,1342397255,0,2,899
161,18602,253,1342397255,1342398208,0,2,953
161,18603,253,1342422603,1342423505,0,2,902
161,18603,260,1342423505,1342424212,0,2,707
161,18605,260,1343440432,1343443027,0,2,2595
161,18605,104,1343443027,1343447702,0,2,4675
161,18606,35,1343476336,1343478285,0,2,1949
161,18606,428,1343478285,1343478345,0,2,60
161,18608,11,1344665750,1344665810,0,1,60
161,18610,260,1345266051,1345267143,0,2,1092
161,18610,253,1345267143,1345267884,0,2,741
161,18611,35,1345292637,1345293594,0,2,957
161,18611,336,1345293594,1345294721,0,2,1127
161,18618,260,1353127630,1353128711,0,2,1081
161,18618,253,1353128711,1353129407,0,2,696
161,18619,253,1354321233,1354322850,0,2,1617
161,18619,104,1354322850,1354323282,0,2,432
161,18622,1005,1354577736,1354578863,0,1,1127
161,18623,260,1354613166,1354614008,0,1,842
161,18626,1005,1354750316,1354751096,0,1,780
161,18627,1005,1354795873,1354796752,0,1,879
161,18629,260,1354886258,1354886658,0,2,400
161,18629,1005,1354886658,1354888486,0,2,1828
161,18630,336,1354938336,1354939365,0,2,1029
161,18630,336,1354950285,1354954353,0,2,4068
161,18631,1005,1355035753,1355036519,0,1,766
161,18634,1005,1355218075,1355218809,0,1,734
161,18635,1005,1355270117,1355270177,0,1,60
161,18641,1005,1355728829,1355730338,0,1,1509
161,18644,1005,1355908986,1355910063,0,1,1077
161,18645,260,1355960748,1355960808,0,1,60
161,18647,260,1356097947,1356099006,0,1,1059
161,18648,1005,1356136330,1356136390,0,1,60
161,18651,1005,1356600835,1356601602,0,1,767
161,18652,297,1356671901,1356671961,0,1,60
161,18657,297,1357100601,1357107304,0,2,6703
161,18657,260,1357108161,1357108221,0,2,60
161,18659,1005,1357283725,1357294031,0,1,10306
161,18662,260,1357550212,1357550272,0,1,60
161,18663,260,1357636501,1357637428,0,1,927
161,18664,1005,1357689213,1357689273,0,1,60
161,18667,1005,1357980521,1357980850,0,1,329
161,18675,260,1358462394,1358462454,0,1,60
161,18677,1005,1358848414,1358848474,0,1,60
161,18679,1005,1359070361,1359070421,0,1,60
161,18680,260,1359106469,1359106529,0,1,60
161,18681,260,1359169230,1359171859,0,2,2629
161,18681,28,1359181231,1359189810,0,2,8579
161,18683,261,1359258513,1359259559,0,1,1046
161,18684,260,1359364664,1359366034,0,1,1370
161,18687,260,1359539009,1359539953,0,1,944
161,18689,260,1359675229,1359675289,0,1,60
161,18691,1005,1359787926,1359787986,0,1,60
161,18693,260,1359935724,1359935784,0,1,60
161,18694,260,1359972452,1359973809,0,1,1357
161,18696,260,1360057620,1360059991,0,1,2371
161,18697,1005,1360107840,1360109448,0,1,1608
161,18699,1005,1360194165,1360195347,0,1,1182
161,18701,1005,1360280576,1360281531,0,1,955
161,18703,260,1360545650,1360546773,0,3,1123
161,18703,253,1360546773,1360549187,0,3,2414
161,18703,336,1360566796,1360566856,0,3,60
161,18705,1005,1360640717,1360640777,0,1,60
161,18706,260,1360661132,1360663040,0,1,1908
161,18707,1005,1360713250,1360713310,0,1,60
161,18708,260,1360748101,1360750008,0,1,1907
161,18709,260,1360799885,1360817374,0,1,17489
162,18711,5,1334043976,1334050029,0,2,6053
162,18711,5,1334050029,1334050541,0,2,512
162,18715,5,1334657249,1334658893,0,1,1644
162,18717,651,1334903072,1334912462,0,2,9390
162,18717,651,1334919275,1334920587,0,2,1312
162,18719,651,1335246656,1335248094,0,2,1438
162,18719,651,1335265520,1335266685,0,2,1165
162,18721,5,1335309301,1335309815,0,1,514
162,18723,651,1335418782,1335418909,0,1,127
162,18724,651,1335442609,1335444242,0,1,1633
162,18727,449,1335923990,1335924261,0,1,271
162,18733,449,1336731771,1336732212,0,1,441
162,18735,651,1337000547,1337001473,0,1,926
162,18743,651,1337937005,1337937540,0,2,535
162,18743,651,1337947213,1337948393,0,2,1180
162,18749,651,1338356365,1338365581,0,2,9216
162,18749,651,1338365581,1338366926,0,2,1345
162,18775,651,1341985352,1341997534,0,2,12182
162,18775,651,1342005644,1342005704,0,2,60
162,18777,449,1342166510,1342166943,0,1,433
162,18778,449,1342510268,1342511170,0,1,902
162,18780,651,1342614818,1342615720,0,1,902
162,18786,449,1344749176,1344750147,0,1,971
162,18797,651,1351034421,1351034947,0,2,526
162,18797,651,1351040468,1351041952,0,2,1484
162,18804,651,1351508705,1351509127,0,1,422
162,18806,428,1351747738,1351748228,0,4,490
162,18806,651,1351748228,1351756482,0,4,8254
162,18806,651,1351756482,1351757093,0,4,611
162,18806,428,1351757093,1351758025,0,4,932
162,18808,449,1351822601,1351822661,0,1,60
162,18826,651,1355492994,1355493054,0,1,60
162,18828,449,1356038159,1356038699,0,1,540
162,18829,449,1356244146,1356244206,0,1,60
162,18830,651,1356677660,1356694111,0,2,16451
162,18830,651,1356694111,1356695829,0,2,1718
162,18840,449,1358804827,1358809179,0,1,4352
162,18843,449,1359519117,1359519326,0,2,209
162,18843,449,1359527847,1359529344,0,2,1497
162,18849,449,1360291816,1360291876,0,1,60
163,18852,2151,1334404381,1334404441,0,1,60
163,18853,2151,1334664970,1334665030,0,1,60
163,18855,77,1334991321,1334995913,0,3,4592
163,18855,77,1334996685,1334997999,0,3,1314
163,18855,449,1334997999,1335000084,0,3,2085
163,18857,2151,1335155575,1335158551,0,1,2976
163,18858,2151,1335270306,1335270366,0,1,60
163,18860,2151,1335392239,1335413092,0,1,20853
163,18861,2151,1335700614,1335700674,0,1,60
163,18862,77,1336187899,1336202550,0,1,14651
163,18863,2151,1336392913,1336392973,0,1,60
163,18864,2151,1336701657,1336701717,0,1,60
163,18865,2151,1336768825,1336768885,0,1,60
163,18866,2151,1337136438,1337137842,0,4,1404
163,18866,35,1337137842,1337139766,0,4,1924
163,18866,35,1337152805,1337154304,0,4,1499
163,18866,2151,1337154304,1337154332,0,4,28
163,18867,2151,1337249380,1337249440,0,1,60
163,18868,2151,1337417447,1337420654,0,2,3207
163,18868,449,1337437808,1337437868,0,2,60
163,18871,2151,1337687017,1337687077,0,1,60
163,18872,2151,1337827830,1337827890,0,1,60
163,18873,2151,1338021943,1338023434,0,1,1491
163,18875,2151,1338119623,1338119683,0,1,60
163,18877,2151,1338724495,1338724555,0,1,60
163,18878,2151,1338776865,1338776925,0,1,60
163,18879,2151,1338810382,1338810442,0,1,60
163,18880,2151,1339070039,1339070099,0,1,60
163,18881,2151,1339155973,1339156033,0,1,60
163,18882,35,1339220483,1339221616,0,3,1133
163,18882,212,1339221616,1339226911,0,3,5295
163,18882,2151,1339228953,1339229178,0,3,225
163,18883,2151,1339327904,1339327964,0,1,60
163,18884,2151,1339370536,1339370596,0,1,60
163,18887,2151,1339568666,1339568963,0,2,297
163,18887,2151,1339577714,1339577774,0,2,60
163,18888,2151,1339758792,1339758852,0,1,60
163,18889,2151,1340021730,1340021790,0,1,60
163,18890,2151,1340757829,1340757889,0,1,60
163,18891,2151,1341523973,1341524006,0,1,33
163,18892,2151,1341744851,1341744911,0,1,60
163,18894,2151,1341836146,1341836206,0,1,60
163,18895,2151,1342059369,1342066574,0,1,7205
163,18896,2151,1342341998,1342342060,0,2,62
163,18896,2151,1342353328,1342353388,0,2,60
163,18897,2151,1342439628,1342439688,0,1,60
163,18898,2151,1342474263,1342474378,0,1,115
163,18900,35,1343449214,1343449486,0,2,272
163,18900,351,1343450264,1343450324,0,2,60
163,18901,35,1343508438,1343510197,0,2,1759
163,18901,2151,1343510197,1343510257,0,2,60
163,18902,2151,1343563162,1343563222,0,1,60
163,18903,2151,1344168299,1344168359,0,1,60
163,18904,2151,1344512726,1344512786,0,1,60
163,18906,2151,1344732818,1344732878,0,1,60
163,18907,2151,1344756209,1344756245,0,2,36
163,18907,2151,1344772683,1344772743,0,2,60
163,18908,2151,1344932390,1344932450,0,1,60
163,18909,35,1345214714,1345216676,0,2,1962
163,18909,2151,1345216676,1345217662,0,2,986
163,18910,2151,1345262259,1345270439,0,2,8180
163,18910,449,1345270439,1345281275,0,2,10836
163,18911,2151,1345303539,1345303599,0,1,60
163,18912,2151,1345344308,1345344368,0,1,60
163,18914,2151,1347536717,1347536777,0,1,60
163,18915,2151,1350044414,1350044474,0,1,60
163,18916,2151,1350129375,1350129435,0,1,60
163,18917,2151,1350906435,1350906495,0,1,60
163,18918,2151,1350993111,1350993171,0,1,60
163,18919,2151,1351403555,1351403615,0,1,60
163,18920,2151,1351511135,1351511195,0,1,60
163,18921,2151,1352721759,1352721819,0,1,60
163,18923,2151,1353140333,1353146827,0,1,6494
163,18924,2151,1353201708,1353201768,0,1,60
163,18925,2151,1353239629,1353239689,0,1,60
163,18926,2151,1353483024,1353485046,0,2,2022
163,18926,35,1353485046,1353485106,0,2,60
163,18927,2151,1353584849,1353584909,0,1,60
163,18928,2151,1353671606,1353671666,0,1,60
163,18930,2151,1353796595,1353796655,0,1,60
163,18931,2151,1353855233,1353855293,0,1,60
163,18932,2151,1354016794,1354016854,0,1,60
163,18933,2151,1354174518,1354174578,0,1,60
163,18934,2151,1354363023,1354363083,0,1,60
163,18935,2151,1354449386,1354449446,0,1,60
163,18936,2151,1354880819,1354880879,0,1,60
163,18937,2151,1354967825,1354967885,0,1,60
163,18938,35,1355033138,1355033198,0,1,60
163,18939,2151,1355098657,1355098717,0,1,60
163,18940,2151,1355177109,1355177169,0,1,60
163,18942,449,1355563515,1355564241,0,1,726
163,18944,2151,1355744784,1355744844,0,1,60
163,18945,2151,1355831207,1355831267,0,1,60
163,18946,2151,1355961906,1355961966,0,1,60
163,18948,2151,1356273713,1356273773,0,1,60
163,18949,2151,1356608758,1356608818,0,1,60
163,18950,2151,1356782039,1356782099,0,1,60
163,18951,2151,1356955001,1356955061,0,1,60
163,18952,2151,1357301716,1357301776,0,1,60
163,18954,2151,1357387004,1357387064,0,1,60
163,18955,2151,1357731917,1357731977,0,1,60
163,18956,2151,1358078406,1358078466,0,1,60
163,18957,2151,1358335918,1358335978,0,1,60
163,18958,2151,1359373567,1359373627,0,1,60
163,18959,2151,1359780012,1359780072,0,1,60
163,18960,2151,1359806118,1359806178,0,1,60
163,18961,2151,1359978328,1359978388,0,1,60
163,18962,2151,1360189316,1360189376,0,1,60
163,18963,2151,1360644172,1360644232,0,1,60
164,18964,2151,1360840822,1360840882,0,1,60
164,18965,35,1333721330,1333721610,0,1,280
164,18966,284,1333847498,1333848995,0,2,1497
164,18966,5,1333848995,1333849479,0,2,484
164,18967,284,1333871557,1333871617,0,1,60
164,18968,284,1334070724,1334070784,0,1,60
164,18970,284,1334322584,1334322644,0,1,60
164,18973,284,1334848740,1334848800,0,1,60
164,18974,284,1334908176,1334908680,0,2,504
164,18974,284,1334923231,1334923291,0,2,60
164,18977,253,1335062158,1335062660,0,1,502
164,18978,284,1335445303,1335445363,0,1,60
164,18980,253,1335607126,1335607146,0,2,20
164,18980,284,1335609143,1335609203,0,2,60
164,18982,104,1335687121,1335687181,0,1,60
164,18984,428,1336095026,1336095369,0,2,343
164,18984,1005,1336095369,1336096811,0,2,1442
164,18985,449,1336118439,1336122719,0,2,4280
164,18985,284,1336127774,1336127834,0,2,60
164,18986,284,1336183566,1336183808,0,2,242
164,18986,35,1336183808,1336184197,0,2,389
164,18987,284,1336221192,1336221252,0,1,60
164,18988,284,1336489884,1336489944,0,1,60
164,18989,35,1336558344,1336559301,0,2,957
164,18989,284,1336576440,1336576500,0,2,60
164,18991,480,1336817707,1336818812,0,3,1105
164,18991,284,1336818812,1336819330,0,3,518
164,18991,284,1336820623,1336820683,0,3,60
164,18992,284,1336883914,1336888957,0,1,5043
164,18993,284,1337173324,1337173384,0,1,60
164,18995,284,1337988460,1337990331,0,1,1871
164,18996,253,1338023953,1338024013,0,1,60
164,18997,284,1338077084,1338078352,0,2,1268
164,18997,253,1338078352,1338078501,0,2,149
164,18998,284,1338120036,1338120652,0,2,616
164,18998,284,1338123408,1338123468,0,2,60
164,19000,284,1338682868,1338683280,0,2,412
164,19000,35,1338683280,1338683715,0,2,435
164,19001,284,1338730805,1338730865,0,1,60
164,19004,284,1339207578,1339213805,0,3,6227
164,19004,284,1339224223,1339225507,0,3,1284
164,19004,21,1339225507,1339225618,0,3,111
164,19005,21,1339235211,1339236600,0,2,1389
164,19005,35,1339236600,1339237657,0,2,1057
164,19006,284,1339324907,1339333460,0,1,8553
164,19007,284,1339910569,1339912265,0,1,1696
164,19008,284,1340808102,1340808162,0,1,60
164,19013,253,1341559278,1341560398,0,1,1120
164,19014,284,1341713962,1341716164,0,3,2202
164,19014,253,1341730122,1341730635,0,3,513
164,19014,35,1341730635,1341731864,0,3,1229
164,19017,253,1342001734,1342002113,0,1,379
164,19021,8,1342340759,1342342667,0,2,1908
164,19021,5,1342342667,1342343779,0,2,1112
164,19023,765,1342958884,1342961546,0,2,2662
164,19023,284,1342961546,1342961606,0,2,60
164,19024,5,1343454835,1343456501,0,1,1666
164,19047,284,1353136131,1353137554,0,1,1423
164,19057,480,1354957213,1354957569,0,2,356
164,19057,5,1354957816,1354958097,0,2,281
165,19098,875,1352466410,1352466644,0,1,234
166,19253,5,1353041172,1353041232,0,1,60
166,19261,11,1355973453,1355973513,0,1,60
167,19292,28,1343455362,1343456443,0,1,1081
168,19351,8,1334310596,1334316285,0,1,5689
168,19358,8,1334830066,1334839006,0,1,8940
168,19360,5,1334925291,1334926072,0,1,781
168,19362,8,1335063599,1335063846,0,3,247
168,19362,5,1335063846,1335064388,0,3,542
168,19362,336,1335073660,1335073720,0,3,60
168,19370,35,1335601889,1335603380,0,1,1491
168,19371,603,1335685110,1335685392,0,3,282
168,19371,603,1335693029,1335693836,0,3,807
168,19371,35,1335693836,1335700029,0,3,6193
168,19373,1,1335953390,1335954036,0,1,646
168,19374,284,1336048196,1336049154,0,2,958
168,19374,11,1336049154,1336049904,0,2,750
168,19389,8,1336989888,1336990449,0,1,561
168,19391,8,1337075677,1337076126,0,1,449
168,19393,8,1337162673,1337162770,0,1,97
168,19413,8,1338711406,1338713849,0,1,2443
168,19424,5,1339410306,1339413709,0,1,3403
168,19443,8,1341482978,1341485624,0,1,2646
168,19446,5,1341741770,1341743468,0,1,1698
168,19449,5,1341999454,1342003988,0,1,4534
168,19453,8,1342426573,1342427019,0,1,446
168,19464,28,1345278625,1345283527,0,1,4902
168,19466,8,1345457851,1345457911,0,1,60
168,19467,35,1347202084,1347202144,0,1,60
168,19468,8,1347530109,1347530990,0,1,881
168,19471,284,1349693790,1349694777,0,2,987
168,19471,11,1349694777,1349695281,0,2,504
168,19478,8,1352627242,1352629878,0,1,2636
168,19485,8,1353832709,1353836349,0,1,3640
169,19522,71,1338202158,1338202218,0,1,60
169,19524,71,1338334742,1338334802,0,1,60
169,19528,71,1339581536,1339581596,0,1,60
169,19529,71,1339756589,1339756649,0,1,60
169,19533,5,1342108445,1342108505,0,1,60
169,19541,351,1356144706,1356144971,0,2,265
169,19541,21,1356145971,1356147385,0,2,1414
170,19619,449,1351661149,1351662152,0,1,1003
170,19642,449,1355878619,1355878679,0,1,60
171,19701,284,1339404349,1339411530,0,1,7181
171,19718,284,1341988234,1341988294,0,1,60
172,19837,59,1338249616,1338249676,0,1,60
172,19854,59,1339909189,1339909714,0,1,525
172,19889,35,1344937783,1344938684,0,1,901
173,19893,71,1333523476,1333531007,0,2,7531
173,19893,480,1333531007,1333531495,0,2,488
173,19913,480,1335599667,1335599727,0,1,60
173,19914,480,1335653728,1335653788,0,1,60
173,19940,5,1338110678,1338111613,0,1,935
173,19993,71,1343126946,1343127372,0,1,426
173,20009,5,1344770896,1344770956,0,1,60
173,20014,35,1345329411,1345330802,0,4,1391
173,20014,212,1345330802,1345330976,0,4,174
173,20014,212,1345346686,1345347474,0,4,788
173,20014,35,1345347474,1345347914,0,4,440
174,20027,28,1333620761,1333621054,0,2,293
174,20027,11,1333621054,1333622028,0,2,974
174,20050,28,1335620791,1335621971,0,1,1180
174,20052,284,1336353937,1336353997,0,1,60
174,20055,8,1336733059,1336733197,0,1,138
174,20066,11,1337937087,1337940503,0,1,3416
174,20070,11,1338559113,1338559906,0,1,793
174,20080,5,1339917404,1339918317,0,2,913
174,20080,11,1339927604,1339931833,0,2,4229
174,20083,8,1341122663,1341122723,0,1,60
174,20097,11,1347634254,1347634855,0,1,601
174,20099,253,1350052416,1350052476,0,1,60
174,20102,1005,1350611517,1350612414,0,1,897
174,20109,1005,1351404803,1351405735,0,1,932
174,20116,21,1353010822,1353010882,0,1,60
174,20124,1,1356818579,1356818639,0,1,60
174,20125,603,1356857731,1356857791,0,1,60
174,20134,8,1359713680,1359713740,0,1,60
175,20138,71,1333533075,1333533135,0,1,60
175,20139,71,1333620436,1333620496,0,1,60
175,20147,71,1334838485,1334839689,0,1,1204
175,20155,71,1335953914,1335954727,0,1,813
175,20166,71,1337689794,1337691048,0,1,1254
175,20176,71,1339160917,1339160977,0,1,60
175,20179,71,1339411143,1339411311,0,1,168
175,20187,71,1340794660,1340795309,0,1,649
175,20188,35,1341113765,1341113825,0,1,60
175,20189,71,1341225874,1341226961,0,1,1087
175,20194,35,1341578470,1341578530,0,1,60
175,20200,71,1342526424,1342526484,0,1,60
175,20201,71,1343128633,1343128693,0,1,60
175,20203,71,1344253038,1344253098,0,1,60
175,20212,71,1351161216,1351161276,0,1,60
175,20214,71,1351503593,1351503653,0,1,60
175,20217,71,1351849700,1351849760,0,1,60
175,20220,71,1352809116,1352809176,0,1,60
175,20221,71,1353058338,1353058398,0,1,60
175,20223,71,1354010548,1354010767,0,1,219
175,20244,71,1357294868,1357294928,0,1,60
175,20248,71,1357642209,1357642269,0,1,60
175,20253,71,1358423783,1358423843,0,1,60
175,20259,71,1359716732,1359716792,0,1,60
177,20349,5,1333530351,1333533085,0,1,2734
177,20365,35,1334808294,1334808677,0,1,383
177,20406,5,1337396025,1337396085,0,1,60
179,20501,449,1333804314,1333807937,0,1,3623
179,20506,77,1334488625,1334488685,0,1,60
179,20519,35,1335580857,1335581762,0,1,905
179,20524,35,1336097679,1336097711,0,1,32
179,20527,21,1336566858,1336569608,0,1,2750
179,20528,71,1336716021,1336717914,0,2,1893
179,20528,297,1336727739,1336729441,0,2,1702
179,20531,59,1336835493,1336835553,0,1,60
179,20532,449,1336889781,1336890640,0,4,859
179,20532,263,1336890640,1336890700,0,4,60
179,20532,263,1336909020,1336909729,0,4,709
179,20532,449,1336909729,1336909789,0,4,60
179,20537,449,1337401100,1337403158,0,2,2058
179,20537,449,1337416398,1337416660,0,2,262
179,20540,59,1338089613,1338092275,0,1,2662
179,20547,21,1339027835,1339028468,0,1,633
179,20555,263,1340620412,1340620472,0,1,60
179,20557,253,1341115307,1341116716,0,1,1409
179,20561,765,1341608669,1341609970,0,1,1301
179,20562,260,1341839869,1341841476,0,2,1607
179,20562,77,1341841476,1341842155,0,2,679
179,20564,263,1342160668,1342161886,0,2,1218
179,20564,260,1342161886,1342163687,0,2,1801
179,20569,35,1343532482,1343534070,0,1,1588
179,20572,449,1345456846,1345456906,0,1,60
179,20575,263,1347539330,1347539390,0,1,60
179,20578,449,1350999047,1350999107,0,1,60
179,20582,5,1353124351,1353124411,0,1,60
179,20584,449,1353645157,1353645217,0,1,60
179,20590,71,1354873389,1354886071,0,1,12682
179,20591,765,1354944972,1354961095,0,1,16123
179,20597,35,1356766578,1356772292,0,1,5714
179,20603,263,1358232049,1358233750,0,1,1701
179,20604,253,1358497177,1358500139,0,1,2962
180,20620,603,1339229597,1339249800,0,1,20203
180,20624,212,1339589639,1339601229,0,1,11590
180,20634,212,1341547214,1341547274,0,1,60
180,20638,212,1342043868,1342043928,0,1,60
180,20640,212,1342416070,1342416130,0,1,60
180,20642,212,1344176778,1344177659,0,2,881
180,20642,603,1344177659,1344177719,0,2,60
180,20644,212,1344663407,1344663467,0,1,60
180,20648,603,1347627965,1347628074,0,1,109
180,20651,212,1350009791,1350009851,0,1,60
180,20653,212,1350078984,1350079044,0,1,60
180,20655,21,1350473739,1350474799,0,1,1060
180,20658,212,1351052551,1351054536,0,2,1985
180,20658,875,1351054536,1351072381,0,2,17845
180,20660,212,1351223054,1351223114,0,1,60
180,20661,21,1351260731,1351260791,0,1,60
180,20662,212,1351303415,1351303475,0,1,60
180,20663,603,1351483702,1351483762,0,1,60
180,20665,480,1351598685,1351598745,0,1,60
180,20667,212,1351737840,1351737900,0,1,60
180,20669,212,1352171486,1352171546,0,1,60
180,20671,212,1352689063,1352689123,0,1,60
180,20672,480,1352722202,1352722262,0,1,60
180,20673,212,1353037494,1353037554,0,1,60
180,20675,212,1353361490,1353361550,0,1,60
180,20679,212,1353727682,1353727742,0,1,60
180,20682,212,1354155384,1354155444,0,1,60
180,20686,212,1354765435,1354765495,0,1,60
180,20688,21,1355499046,1355499106,0,1,60
180,20690,59,1356147548,1356147608,0,1,60
180,20694,212,1357208349,1357208409,0,1,60
180,20695,212,1357470331,1357470391,0,1,60
180,20701,212,1360033083,1360033143,0,1,60
181,20702,212,1360636301,1360636361,0,1,60
181,20740,449,1337353913,1337354005,0,1,92
181,20751,253,1338200433,1338200534,0,1,101
181,20766,77,1339219676,1339221764,0,1,2088
181,20794,765,1341584398,1341584542,0,1,144
182,20914,651,1333720724,1333720784,0,1,60
182,20917,651,1333981537,1333982327,0,1,790
182,20918,212,1334070994,1334071054,0,1,60
182,20919,651,1334152951,1334153011,0,1,60
182,20920,651,1334235289,1334235975,0,1,686
182,20921,651,1334319948,1334320008,0,1,60
182,20923,212,1334489529,1334489589,0,1,60
182,20924,651,1334583957,1334584017,0,1,60
182,20925,651,1334756944,1334757004,0,1,60
182,20926,651,1334837724,1334837784,0,1,60
182,20927,651,1334927026,1334927086,0,1,60
182,20928,212,1335002951,1335011891,0,1,8940
182,20929,212,1335070709,1335071270,0,2,561
182,20929,875,1335071270,1335071330,0,2,60
182,20931,651,1335440930,1335440990,0,1,60
182,20932,651,1335523863,1335523923,0,1,60
182,20933,212,1335567944,1335568004,0,1,60
182,20934,212,1335618238,1335618298,0,1,60
182,20935,212,1335693764,1335693824,0,1,60
182,20937,212,1336102496,1336103126,0,2,630
182,20937,59,1336104857,1336104917,0,2,60
182,20938,212,1336137598,1336137658,0,1,60
182,20939,212,1336178858,1336180357,0,1,1499
182,20940,212,1336342040,1336342100,0,1,60
182,20941,253,1336826801,1336826861,0,1,60
182,20942,212,1336898370,1336900083,0,2,1713
182,20942,35,1336900083,1336900330,0,2,247
182,20944,212,1338562401,1338564351,0,2,1950
182,20944,59,1338564351,1338564411,0,2,60
182,20947,875,1339234109,1339237585,0,1,3476
182,20955,21,1344167351,1344167411,0,1,60
182,20964,253,1353405151,1353405211,0,1,60
182,20971,212,1355559768,1355569264,0,1,9496
182,20972,875,1355620646,1355620999,0,1,353
182,20974,351,1357975235,1357975295,0,1,60
183,20978,351,1333538135,1333538680,0,1,545
183,20980,765,1333720166,1333720322,0,1,156
183,20982,260,1333975042,1333975073,0,1,31
183,20983,260,1334012096,1334014300,0,1,2204
183,20986,260,1334098797,1334100937,0,1,2140
183,20987,260,1334185285,1334187375,0,1,2090
183,20988,260,1334224333,1334225332,0,1,999
183,20989,260,1334271711,1334273836,0,1,2125
183,20991,351,1334317987,1334320806,0,1,2819
183,20992,260,1334358076,1334360351,0,1,2275
183,20994,260,1334404755,1334404837,0,1,82
183,20996,260,1334584131,1334584173,0,1,42
183,20997,449,1334676656,1334677484,0,1,828
183,20998,351,1334705926,1334705986,0,1,60
183,20999,449,1334762610,1334763852,0,1,1242
183,21000,260,1334791983,1334794478,0,1,2495
183,21001,260,1334846911,1334847286,0,1,375
183,21002,260,1334877780,1334879989,0,1,2209
183,21003,260,1334933774,1334933842,0,1,68
183,21005,260,1335136571,1335138858,0,1,2287
183,21006,260,1335192907,1335193163,0,1,256
183,21007,260,1335222047,1335224451,0,1,2404
183,21013,260,1335452145,1335452201,0,1,56
183,21014,351,1335531561,1335534563,0,1,3002
183,21015,260,1335568317,1335568377,0,1,60
183,21017,351,1335618127,1335620991,0,1,2864
183,21018,260,1335659203,1335661509,0,1,2306
183,21019,260,1335696053,1335696070,0,1,17
183,21020,260,1335914014,1335916364,0,1,2350
183,21021,351,1335956139,1335959058,0,1,2919
183,21024,260,1336346178,1336348354,0,1,2176
183,21026,260,1336392513,1336392532,0,1,19
183,21028,260,1336488930,1336490025,0,1,1095
183,21029,351,1336522489,1336522515,0,1,26
183,21030,260,1336569092,1336569148,0,1,56
183,21031,260,1336605007,1336607300,0,1,2293
183,21032,351,1336693945,1336706343,0,1,12398
183,21034,351,1336780601,1336780733,0,1,132
183,21035,351,1336816290,1336819323,0,1,3033
183,21038,260,1336951168,1336953326,0,1,2158
183,21040,449,1337009598,1337010452,0,1,854
183,21042,260,1337093707,1337093955,0,1,248
183,21043,351,1337126079,1337138973,0,1,12894
183,21044,260,1337178262,1337178355,0,1,93
183,21045,260,1337213165,1337215287,0,1,2122
183,21047,260,1337297087,1337297147,0,1,60
183,21052,260,1337643968,1337660863,0,1,16895
183,21053,260,1337698521,1337698796,0,1,275
183,21054,260,1337817336,1337819467,0,1,2131
183,21057,260,1337989308,1337991576,0,1,2268
183,21060,260,1338160198,1338162495,0,1,2297
183,21061,351,1338210100,1338210160,0,1,60
183,21062,351,1338249284,1338263852,0,1,14568
183,21063,449,1338305544,1338306322,0,1,778
183,21064,260,1338336317,1338338427,0,1,2110
183,21065,260,1338471886,1338471929,0,1,43
183,21066,28,1338555927,1338557472,0,2,1545
183,21066,260,1338557472,1338558709,0,2,1237
183,21069,260,1338765200,1338767391,0,1,2191
183,21070,260,1338813347,1338813387,0,1,40
183,21071,351,1338854018,1338854304,0,1,286
183,21072,260,1338904858,1338904909,0,1,51
183,21074,260,1339024912,1339026920,0,1,2008
183,21075,260,1339081041,1339081091,0,1,50
183,21080,260,1339370253,1339372386,0,1,2133
183,21082,260,1339425034,1339425094,0,1,60
183,21083,260,1339458945,1339461042,0,1,2097
183,21084,351,1342398351,1342398668,0,1,317
183,21085,765,1342436044,1342437273,0,1,1229
183,21086,260,1342480786,1342480846,0,1,60
183,21089,260,1342569284,1342569344,0,1,60
183,21090,260,1342623349,1342623490,0,1,141
183,21091,260,1347545712,1347547816,0,1,2104
183,21092,260,1347628887,1347628947,0,1,60
183,21095,449,1350574438,1350576056,0,1,1618
183,21096,260,1350603802,1350605919,0,1,2117
183,21097,449,1350661361,1350661421,0,1,60
183,21101,260,1351037206,1351039279,0,1,2073
183,21102,351,1351073264,1351091558,0,2,18294
183,21102,449,1351091558,1351091965,0,2,407
183,21103,260,1351122321,1351124373,0,1,2052
183,21105,260,1351210616,1351227921,0,1,17305
183,21109,260,1351466808,1351481523,0,1,14715
183,21112,260,1351639372,1351655655,0,1,16283
183,21116,260,1351779433,1351779472,0,1,39
183,21117,260,1351813552,1351829714,0,1,16162
183,21119,260,1352123039,1352123083,0,1,44
183,21123,260,1352289806,1352289830,0,1,24
183,21126,260,1352677563,1352679721,0,1,2158
183,21132,260,1353112647,1353127089,0,1,14442
183,21133,260,1353163240,1353163253,0,1,13
183,21136,260,1353369276,1353371403,0,1,2127
183,21137,449,1353424813,1353425698,0,1,885
183,21140,260,1353543482,1353557752,0,1,14270
183,21145,260,1353767567,1353767649,0,1,82
183,21147,260,1353889036,1353889096,0,1,60
183,21149,260,1353972475,1353974754,0,1,2279
183,21151,260,1354060581,1354060641,0,1,60
183,21152,351,1354147982,1354161730,0,1,13748
183,21153,351,1354324217,1354324554,0,1,337
183,21158,260,1354578585,1354580753,0,1,2168
183,21159,260,1354631051,1354631111,0,1,60
183,21160,351,1354667364,1354667809,0,1,445
183,21161,260,1354715026,1354715086,0,1,60
183,21166,260,1355096387,1355098530,0,1,2143
183,21169,449,1355240048,1355241001,0,1,953
183,21172,351,1355531238,1355531298,0,1,60
183,21176,449,1355672048,1355672729,0,1,681
183,21177,260,1355705867,1355708187,0,1,2320
183,21182,449,1356192065,1356192125,0,1,60
183,21183,351,1356229767,1356229827,0,1,60
183,21185,260,1356605282,1356605339,0,1,57
183,21193,260,1357514018,1357514078,0,1,60
184,21226,11,1338702582,1338711459,0,1,8877
184,21227,21,1339074678,1339074738,0,1,60
184,21239,5,1352121340,1352122748,0,1,1408
184,21241,21,1353135802,1353136519,0,1,717
184,21247,480,1354110444,1354110504,0,1,60
184,21249,28,1355402048,1355403646,0,1,1598
184,21254,480,1357103016,1357103663,0,1,647
184,21261,765,1359284651,1359284711,0,1,60
185,21286,603,1337072549,1337082323,0,1,9774
185,21290,603,1337677380,1337678230,0,1,850
185,21343,21,1357029750,1357033180,0,1,3430
186,21362,21,1333926999,1333927059,0,1,60
186,21375,21,1335914081,1335914141,0,1,60
186,21376,21,1336346956,1336347016,0,1,60
186,21377,21,1336518991,1336519051,0,1,60
186,21379,21,1336605537,1336605597,0,1,60
186,21380,253,1336809118,1336809178,0,1,60
186,21382,21,1337038087,1337038147,0,1,60
186,21384,21,1337210434,1337210494,0,1,60
186,21385,21,1337297109,1337297169,0,1,60
186,21386,21,1337605141,1337605201,0,1,60
186,21387,21,1337680853,1337680913,0,1,60
186,21389,21,1338160823,1338160883,0,1,60
186,21390,21,1338247334,1338247394,0,1,60
186,21391,21,1338334089,1338347822,0,1,13733
186,21392,212,1338358522,1338358582,0,1,60
186,21393,21,1338765957,1338766017,0,1,60
186,21394,21,1338851819,1338851879,0,1,60
186,21395,21,1339025289,1339037833,0,1,12544
186,21396,21,1339110917,1339110977,0,1,60
186,21397,21,1339371173,1339371233,0,1,60
186,21398,21,1339456841,1339456901,0,1,60
186,21399,21,1339629778,1339643182,0,1,13404
186,21400,21,1339975218,1339975278,0,1,60
186,21401,21,1340233967,1340248437,0,1,14470
186,21402,21,1340752453,1340752513,0,1,60
186,21403,21,1341270670,1341288817,0,1,18147
186,21404,21,1341357412,1341357472,0,1,60
186,21406,21,1341443492,1341443552,0,1,60
186,21408,21,1341962050,1341962110,0,1,60
186,21409,21,1342134625,1342134685,0,1,60
186,21410,21,1342525870,1342525930,0,1,60
186,21411,21,1342567010,1342567070,0,1,60
186,21412,21,1342655959,1342656019,0,1,60
186,21413,21,1343344233,1343344293,0,1,60
186,21416,21,1351171762,1351171822,0,1,60
186,21418,253,1351850416,1351850476,0,1,60
186,21421,21,1352713328,1352713388,0,1,60
186,21424,21,1353502142,1353502202,0,1,60
186,21426,21,1353925027,1353925087,0,1,60
186,21427,21,1353972000,1353972060,0,1,60
186,21429,21,1354352255,1354352315,0,1,60
186,21435,21,1358425946,1358426006,0,1,60
187,21445,2151,1333491343,1333493676,0,2,2333
187,21445,35,1333493676,1333493736,0,2,60
187,21446,5,1333546002,1333547193,0,3,1191
187,21446,35,1333547193,1333549064,0,3,1871
187,21446,2151,1333549064,1333549124,0,3,60
187,21447,35,1333580851,1333581996,0,1,1145
187,21448,35,1333926076,1333927023,0,1,947
187,21449,5,1333976955,1333977236,0,3,281
187,21449,480,1333977236,1333977984,0,3,748
187,21449,35,1333977984,1333978635,0,3,651
187,21450,35,1334012993,1334014319,0,1,1326
187,21451,5,1334054426,1334055610,0,2,1184
187,21451,35,1334055610,1334055670,0,2,60
187,21452,35,1334099330,1334115549,0,1,16219
187,21454,35,1334155196,1334156722,0,2,1526
187,21454,2151,1334156722,1334156782,0,2,60
187,21455,2151,1334186494,1334188993,0,2,2499
187,21455,35,1334188993,1334201218,0,2,12225
187,21456,5,1334221297,1334221628,0,1,331
187,21457,11,1334236891,1334237441,0,2,550
187,21457,35,1334239296,1334239356,0,2,60
187,21458,2151,1334270578,1334272891,0,2,2313
187,21458,35,1334272891,1334278965,0,2,6074
187,21460,11,1334318343,1334318725,0,2,382
187,21460,35,1334319627,1334320946,0,2,1319
187,21461,2151,1334445986,1334447465,0,4,1479
187,21461,35,1334447465,1334448506,0,4,1041
187,21461,5,1334456033,1334456297,0,4,264
187,21461,480,1334456297,1334458505,0,4,2208
187,21462,5,1334574068,1334575041,0,3,973
187,21462,35,1334575265,1334577133,0,3,1868
187,21462,2151,1334577133,1334577193,0,3,60
187,21463,5,1334669667,1334672677,0,2,3010
187,21463,2151,1334672677,1334672737,0,2,60
187,21464,2151,1334701903,1334704160,0,2,2257
187,21464,35,1334704160,1334705186,0,2,1026
187,21465,336,1334758531,1334759842,0,2,1311
187,21465,77,1334760643,1334761917,0,2,1274
187,21466,2151,1334788318,1334790625,0,2,2307
187,21466,35,1334790625,1334790685,0,2,60
187,21468,5,1334842410,1334843596,0,3,1186
187,21468,35,1334843596,1334845000,0,3,1404
187,21468,2151,1334845000,1334845060,0,3,60
187,21469,2151,1334874709,1334878881,0,2,4172
187,21469,1,1334878881,1334878941,0,2,60
187,21470,8,1334897605,1334898061,0,4,456
187,21470,5,1334911064,1334911415,0,4,351
187,21470,480,1334911415,1334912062,0,4,647
187,21470,35,1334912062,1334912122,0,4,60
187,21471,2151,1335074997,1335075057,0,1,60
187,21472,35,1335222930,1335224054,0,1,1124
187,21473,35,1335255078,1335256968,0,2,1890
187,21473,2151,1335256968,1335257028,0,2,60
187,21474,35,1335395378,1335396410,0,1,1032
187,21475,5,1335424557,1335425858,0,3,1301
187,21475,35,1335425858,1335428141,0,3,2283
187,21475,2151,1335428141,1335428201,0,3,60
187,21476,35,1336201871,1336206022,0,3,4151
187,21476,5,1336213980,1336215646,0,3,1666
187,21476,284,1336215646,1336215706,0,3,60
187,21477,35,1336346196,1336347268,0,1,1072
187,21478,5,1336380617,1336381836,0,3,1219
187,21478,35,1336381836,1336384029,0,3,2193
187,21478,2151,1336384029,1336384089,0,3,60
187,21479,2151,1336516656,1336519054,0,2,2398
187,21479,35,1336519054,1336530168,0,2,11114
187,21480,5,1336554141,1336555099,0,3,958
187,21480,35,1336555099,1336557114,0,3,2015
187,21480,2151,1336558440,1336558500,0,3,60
187,21481,35,1336605655,1336605715,0,1,60
187,21482,2151,1336689173,1336691648,0,2,2475
187,21482,35,1336691648,1336692973,0,2,1325
187,21483,5,1336728334,1336730218,0,2,1884
187,21483,35,1336730499,1336732470,0,2,1971
187,21485,35,1336951328,1336952539,0,1,1211
187,21486,5,1336986334,1336987492,0,3,1158
187,21486,35,1336987492,1336989735,0,3,2243
187,21486,2151,1336989735,1336989795,0,3,60
187,21487,35,1337037384,1337037444,0,1,60
187,21488,2151,1337077581,1337077641,0,1,60
187,21489,35,1337124163,1337125479,0,1,1316
187,21490,5,1337160218,1337161104,0,2,886
187,21490,35,1337161104,1337161164,0,2,60
187,21491,35,1337210547,1337211648,0,1,1101
187,21492,5,1337241131,1337241397,0,4,266
187,21492,480,1337241397,1337242079,0,4,682
187,21492,35,1337242079,1337243221,0,4,1142
187,21492,104,1337243221,1337243281,0,4,60
187,21493,35,1337296534,1337296594,0,1,60
187,21494,5,1337591545,1337592368,0,2,823
187,21494,35,1337592368,1337592428,0,2,60
187,21495,35,1337642153,1337645320,0,2,3167
187,21495,5,1337650591,1337650651,0,2,60
187,21496,11,1337676005,1337677628,0,3,1623
187,21496,35,1337677628,1337679509,0,3,1881
187,21496,2151,1337679509,1337679569,0,3,60
187,21497,35,1337814948,1337815968,0,1,1020
187,21498,5,1337836832,1337837878,0,2,1046
187,21498,35,1337837878,1337839951,0,2,2073
187,21499,5,1337937894,1337938749,0,2,855
187,21499,35,1337938749,1337938809,0,2,60
187,21500,35,1338160539,1338161531,0,1,992
187,21501,5,1338202048,1338203134,0,3,1086
187,21501,35,1338203134,1338205105,0,3,1971
187,21501,2151,1338205105,1338205165,0,3,60
187,21503,1,1338277356,1338277416,0,1,60
187,21504,35,1338333291,1338334373,0,2,1082
187,21504,5,1338346449,1338346940,0,2,491
187,21505,2151,1338367929,1338367989,0,1,60
187,21506,2151,1338503970,1338504030,0,1,60
187,21507,8,1338541216,1338543038,0,2,1822
187,21507,35,1338543038,1338543098,0,2,60
187,21508,35,1338765291,1338766360,0,1,1069
187,21509,5,1338804213,1338805162,0,3,949
187,21509,35,1338805162,1338807138,0,3,1976
187,21509,2151,1338807138,1338807198,0,3,60
187,21510,1,1338878835,1338878895,0,1,60
187,21511,5,1338982510,1338982602,0,2,92
187,21511,35,1338983500,1338983560,0,2,60
187,21512,5,1339070143,1339071658,0,2,1515
187,21512,35,1339071658,1339072953,0,2,1295
187,21513,35,1339110883,1339110943,0,1,60
187,21514,35,1339153453,1339155793,0,1,2340
187,21515,1,1339370999,1339371137,0,1,138
187,21516,1,1339405137,1339409829,0,2,4692
187,21516,2151,1339409829,1339409889,0,2,60
187,21517,1,1339457684,1339457744,0,1,60
187,21518,2151,1339495862,1339495922,0,1,60
187,21519,1,1339543711,1339543771,0,1,60
187,21520,2151,1339577637,1339577697,0,1,60
187,21521,35,1339629287,1339629347,0,1,60
187,21522,5,1339663849,1339664896,0,3,1047
187,21522,35,1339664896,1339667360,0,3,2464
187,21522,2151,1339669104,1339669164,0,3,60
187,21523,2151,1339753630,1339753690,0,1,60
187,21524,2151,1339927402,1339927607,0,1,205
187,21525,35,1339975051,1339976039,0,1,988
187,21526,5,1340009208,1340010305,0,2,1097
187,21526,35,1340010305,1340010847,0,2,542
187,21527,35,1340234065,1340234125,0,1,60
187,21528,5,1340268111,1340269196,0,3,1085
187,21528,35,1340269196,1340271103,0,3,1907
187,21528,2151,1340271103,1340271163,0,3,60
187,21529,5,1341220154,1341221170,0,3,1016
187,21529,35,1341221170,1341223280,0,3,2110
187,21529,2151,1341223280,1341223340,0,3,60
187,21530,35,1341270932,1341272004,0,1,1072
187,21531,5,1341304825,1341305790,0,3,965
187,21531,35,1341305790,1341308236,0,3,2446
187,21531,2151,1341308236,1341308296,0,3,60
187,21532,35,1341357274,1341358532,0,1,1258
187,21533,1,1341397862,1341402314,0,2,4452
187,21533,2151,1341402314,1341402374,0,2,60
187,21534,1,1341445665,1341445725,0,1,60
187,21535,1,1341484254,1341488102,0,2,3848
187,21535,2151,1341488102,1341488162,0,2,60
187,21536,35,1341530693,1341531845,0,1,1152
187,21537,5,1341566310,1341567352,0,3,1042
187,21537,35,1341567352,1341569247,0,3,1895
187,21537,2151,1341569247,1341569307,0,3,60
187,21539,35,1341789273,1341789333,0,1,60
187,21540,5,1341824086,1341825215,0,3,1129
187,21540,35,1341825215,1341827204,0,3,1989
187,21540,2151,1341827204,1341827264,0,3,60
187,21541,35,1341962091,1341963247,0,1,1156
187,21542,5,1341995591,1341996496,0,3,905
187,21542,35,1341996496,1341998739,0,3,2243
187,21542,2151,1341998739,1341998799,0,3,60
187,21547,2151,1342232883,1342232943,0,1,60
187,21549,1,1342509154,1342509214,0,1,60
187,21550,35,1342567289,1342568494,0,1,1205
187,21551,5,1343118510,1343118570,0,1,60
187,21552,35,1343344468,1343344528,0,1,60
187,21556,5,1343638605,1343639454,0,3,849
187,21556,35,1343639454,1343641564,0,3,2110
187,21556,2151,1343641564,1343641624,0,3,60
187,21560,35,1345454543,1345456096,0,2,1553
187,21560,2151,1345456096,1345456156,0,2,60
187,21561,5,1346850757,1346851956,0,2,1199
187,21561,35,1346851956,1346854626,0,2,2670
187,21562,2151,1346899268,1346902528,0,1,3260
187,21563,2151,1347229548,1347233156,0,1,3608
187,21564,5,1347534364,1347535404,0,2,1040
187,21564,35,1347535404,1347535464,0,2,60
187,21565,5,1347624394,1347624454,0,1,60
187,21566,2151,1347669517,1347674954,0,2,5437
187,21566,2151,1347689398,1347689458,0,2,60
187,21568,2151,1349277897,1349277957,0,1,60
187,21571,1,1350380663,1350384457,0,2,3794
187,21571,2151,1350384457,1350384517,0,2,60
187,21572,5,1350467694,1350468734,0,3,1040
187,21572,35,1350468734,1350471313,0,3,2579
187,21572,2151,1350471313,1350471373,0,3,60
187,21573,1,1350604026,1350604086,0,1,60
187,21574,35,1350650640,1350650700,0,1,60
187,21575,1,1350906205,1350906265,0,1,60
187,21577,1,1350993850,1350994995,0,1,1145
187,21582,5,1351177530,1351177590,0,1,60
187,21583,35,1351206989,1351208474,0,1,1485
187,21584,1,1351253170,1351254436,0,1,1266
187,21586,5,1351517640,1351517700,0,1,60
187,21587,5,1351598861,1351602576,0,2,3715
187,21587,2151,1351602576,1351602636,0,2,60
187,21588,1,1351639649,1351639709,0,1,60
187,21589,1,1351678505,1351678992,0,1,487
187,21590,2151,1351722549,1351730807,0,1,8258
187,21592,5,1351777646,1351780534,0,2,2888
187,21592,2151,1351780534,1351780594,0,2,60
187,21593,1,1351838770,1351843483,0,2,4713
187,21593,2151,1351843483,1351843543,0,2,60
187,21594,5,1352115763,1352116544,0,2,781
187,21594,35,1352116544,1352117279,0,2,735
187,21596,1,1352197936,1352197996,0,1,60
187,21598,35,1352296056,1352296784,0,1,728
187,21599,5,1352379916,1352379976,0,1,60
187,21600,284,1352596077,1352597485,0,3,1408
187,21600,8,1352611606,1352613889,0,3,2283
187,21600,284,1352613889,1352613949,0,3,60
187,21603,2151,1352731312,1352731372,0,1,60
187,21604,35,1352762264,1352763262,0,1,998
187,21605,2151,1352805007,1352805067,0,1,60
187,21606,35,1353021277,1353022306,0,1,1029
187,21609,1,1353411887,1353411947,0,1,60
187,21611,5,1353503742,1353503802,0,1,60
187,21612,35,1353539696,1353539756,0,1,60
187,21614,480,1353594726,1353594786,0,1,60
187,21616,1,1353737441,1353737501,0,1,60
187,21617,2151,1353810374,1353810434,0,1,60
187,21620,35,1353971812,1353971872,0,1,60
187,21621,2151,1354011616,1354011676,0,1,60
187,21622,1,1354056884,1354056944,0,1,60
187,21625,284,1354431309,1354431369,0,1,60
187,21626,1,1354532995,1354534162,0,2,1167
187,21626,2151,1354536615,1354536675,0,2,60
187,21627,35,1354576720,1354576780,0,1,60
187,21628,35,1354632348,1354632408,0,1,60
187,21629,5,1354663969,1354663982,0,1,13
187,21631,2151,1354789028,1354789088,0,1,60
187,21633,8,1354879478,1354890490,0,2,11012
187,21633,5,1354890490,1354890550,0,2,60
187,21634,2151,1354943825,1354953778,0,1,9953
187,21635,5,1355042534,1355043441,0,2,907
187,21635,35,1355043441,1355045790,0,2,2349
187,21637,2151,1355388175,1355388235,0,1,60
187,21638,2151,1355492219,1355492279,0,1,60
187,21639,2151,1355725964,1355726024,0,1,60
187,21642,35,1355872627,1355873888,0,1,1261
187,21643,5,1355912479,1355923699,0,2,11220
187,21643,35,1355925218,1355925278,0,2,60
187,21644,2151,1356251949,1356252009,0,1,60
187,21645,35,1356619372,1356621326,0,2,1954
187,21645,2151,1356621326,1356621386,0,2,60
187,21649,35,1357512203,1357526987,0,1,14784
187,21650,8,1357548665,1357548742,0,2,77
187,21650,5,1357548742,1357548802,0,2,60
187,21651,35,1357600685,1357600745,0,1,60
187,21652,21,1357636810,1357637325,0,1,515
187,21653,5,1357653537,1357653601,0,3,64
187,21653,35,1357654533,1357656202,0,3,1669
187,21653,2151,1357656202,1357656262,0,3,60
187,21655,2151,1357744972,1357745032,0,1,60
187,21659,284,1358000740,1358000800,0,1,60
187,21661,284,1358087230,1358087290,0,1,60
187,21662,35,1358200839,1358200899,0,1,60
187,21664,35,1358289346,1358289406,0,1,60
187,21665,5,1358414262,1358414322,0,1,60
187,21667,5,1358519147,1358520582,0,3,1435
187,21667,35,1358520582,1358522671,0,3,2089
187,21667,2151,1358522671,1358522731,0,3,60
187,21668,5,1358778374,1358779542,0,3,1168
187,21668,35,1358779542,1358781830,0,3,2288
187,21668,2151,1358781830,1358781890,0,3,60
187,21669,35,1358810180,1358811508,0,1,1328
187,21670,35,1358859855,1358861965,0,2,2110
187,21670,2151,1358861965,1358862025,0,2,60
187,21671,35,1359029778,1359029838,0,1,60
187,21673,5,1359262840,1359264381,0,1,1541
187,21675,5,1359380388,1359381339,0,2,951
187,21675,35,1359381339,1359381399,0,2,60
187,21676,1,1359416897,1359416957,0,1,60
187,21678,1,1359497614,1359497674,0,1,60
187,21679,1,1359541243,1359541303,0,1,60
187,21680,2151,1359580107,1359584018,0,2,3911
187,21680,1,1359584018,1359584078,0,2,60
187,21682,1,1359671362,1359671422,0,1,60
187,21683,1,1359712940,1359713000,0,1,60
187,21686,35,1359883548,1359883608,0,1,60
187,21689,5,1360245615,1360245921,0,2,306
187,21689,480,1360245921,1360245981,0,2,60
187,21690,2151,1360550386,1360550446,0,1,60
187,21691,5,1360580929,1360582062,0,2,1133
187,21691,35,1360582062,1360582122,0,2,60
187,21692,1,1360621728,1360621788,0,1,60
187,21693,1,1360708299,1360708359,0,1,60
188,21694,8,1360754788,1360765258,0,2,10470
188,21694,5,1360765364,1360765424,0,2,60
188,21698,284,1356670524,1356670715,0,1,191
188,21700,284,1356732367,1356732385,0,1,18
188,21701,336,1356765596,1356767032,0,1,1436
188,21704,336,1356853346,1356854342,0,1,996
188,21706,5,1356946198,1356947597,0,1,1399
188,21707,284,1357371455,1357372355,0,1,900
188,21709,284,1357437163,1357437229,0,2,66
188,21709,480,1357438638,1357439443,0,2,805
188,21713,8,1359102198,1359102285,0,1,87
188,21715,284,1359173007,1359173067,0,1,60
188,21716,8,1359256368,1359270257,0,1,13889
188,21717,5,1359280466,1359281665,0,2,1199
188,21717,284,1359281665,1359281779,0,2,114
188,21718,284,1359356466,1359356590,0,1,124
188,21721,284,1359539126,1359539776,0,1,650
188,21722,35,1359618316,1359618338,0,1,22
188,21725,253,1359799434,1359801830,0,1,2396
188,21726,284,1359880682,1359880742,0,1,60
188,21734,35,1360577459,1360578863,0,1,1404
188,21736,35,1360665965,1360666064,0,1,99
189,21738,11,1360816315,1360817203,0,1,888
189,21744,284,1334377662,1334378375,0,1,713
189,21750,284,1335054716,1335056161,0,2,1445
189,21750,5,1335056161,1335056610,0,2,449
189,21757,284,1336205024,1336205372,0,1,348
189,21760,35,1336708514,1336712326,0,1,3812
190,21804,253,1334107283,1334108153,0,1,870
190,21805,35,1334200426,1334200855,0,2,429
190,21805,253,1334200855,1334205878,0,2,5023
190,21813,284,1336103311,1336104578,0,1,1267
190,21816,253,1336356616,1336357017,0,1,401
190,21819,253,1336901456,1336902105,0,1,649
190,21821,253,1337046951,1337047250,0,1,299
190,21830,253,1338782639,1338782665,0,1,26
190,21834,28,1338987928,1338992757,0,1,4829
190,21836,253,1339474043,1339474325,0,1,282
190,21847,253,1341972611,1341973754,0,1,1143
190,21857,253,1344238212,1344239315,0,1,1103
190,21860,253,1345253686,1345256165,0,1,2479
190,21864,5,1347744970,1347745030,0,1,60
191,21868,8,1333539216,1333540885,0,1,1669
191,21870,8,1333621773,1333621833,0,1,60
191,21905,8,1335596316,1335598974,0,3,2658
191,21905,71,1335599626,1335599749,0,3,123
191,21905,71,1335604647,1335606624,0,3,1977
191,21906,71,1335619416,1335620535,0,1,1119
191,21907,21,1335652341,1335653648,0,2,1307
191,21907,21,1335654735,1335654795,0,2,60
191,21908,212,1335694604,1335695176,0,4,572
191,21908,603,1335695176,1335695487,0,4,311
191,21908,35,1335695487,1335696095,0,4,608
191,21908,8,1335698902,1335700157,0,4,1255
191,21934,8,1356605714,1356607385,0,1,1671
191,21936,8,1356689741,1356693680,0,1,3939
191,21937,351,1356767604,1356769359,0,1,1755
191,21939,351,1357011571,1357013179,0,1,1608
191,21953,5,1357961060,1357965062,0,1,4002
191,21968,8,1359110181,1359110261,0,1,80
192,21996,8,1333542005,1333542019,0,2,14
192,21996,5,1333542019,1333543199,0,2,1180
192,22001,21,1334114533,1334114593,0,1,60
192,22004,449,1334225812,1334226826,0,3,1014
192,22004,77,1334226826,1334227015,0,3,189
192,22004,284,1334229666,1334229679,0,3,13
192,22005,21,1334292744,1334292804,0,1,60
192,22006,449,1334310830,1334310890,0,1,60
192,22008,1005,1334565096,1334565144,0,3,48
192,22008,765,1334565144,1334566223,0,3,1079
192,22008,8,1334570189,1334570249,0,3,60
192,22010,449,1334829107,1334830200,0,5,1093
192,22010,21,1334830200,1334830556,0,5,356
192,22010,5,1334830556,1334830731,0,5,175
192,22010,8,1334830731,1334830991,0,5,260
192,22010,5,1334843989,1334845262,0,5,1273
192,22011,21,1334889889,1334889949,0,1,60
192,22013,253,1334975679,1334977190,0,2,1511
192,22013,59,1334989588,1334989648,0,2,60
192,22014,71,1335061568,1335061600,0,1,32
192,22015,11,1335111019,1335111079,0,1,60
192,22017,8,1335259384,1335262031,0,1,2647
192,22019,284,1335540211,1335541457,0,1,1246
192,22021,297,1335670727,1335680657,0,1,9930
192,22022,253,1335694896,1335711869,0,1,16973
192,22025,284,1336127368,1336129702,0,3,2334
192,22025,253,1336129702,1336144543,0,3,14841
192,22025,284,1336145125,1336145139,0,3,14
192,22026,284,1336181264,1336182430,0,1,1166
192,22028,5,1336568947,1336569007,0,1,60
192,22031,8,1336897078,1336898552,0,1,1474
192,22033,5,1337085522,1337085582,0,1,60
192,22036,297,1337379230,1337379343,0,1,113
192,22037,8,1337592958,1337595833,0,2,2875
192,22037,11,1337605643,1337606638,0,2,995
192,22039,8,1337679839,1337682180,0,2,2341
192,22039,5,1337682180,1337683613,0,2,1433
192,22040,11,1337853181,1337853241,0,1,60
192,22045,8,1338283205,1338283265,0,1,60
192,22047,8,1338980924,1338980984,0,1,60
192,22053,5,1340103258,1340103318,0,1,60
192,22055,11,1340278290,1340279003,0,1,713
192,22056,28,1340624987,1340626037,0,1,1050
192,22060,11,1341228197,1341229057,0,1,860
192,22061,8,1341312923,1341316994,0,1,4071
192,22062,297,1341375274,1341396717,0,2,21443
192,22062,11,1341396717,1341396777,0,2,60
192,22065,297,1341477463,1341494224,0,2,16761
192,22065,5,1341494244,1341495747,0,2,1503
192,22069,11,1341697944,1341698004,0,1,60
192,22070,297,1341757665,1341759748,0,1,2083
192,22074,5,1342088686,1342090359,0,1,1673
192,22090,8,1344569132,1344571799,0,2,2667
192,22090,21,1344571799,1344571859,0,2,60
192,22092,35,1350085615,1350087048,0,2,1433
192,22092,212,1350087048,1350087108,0,2,60
192,22096,5,1351324303,1351324363,0,1,60
192,22098,5,1351512149,1351512209,0,1,60
192,22100,8,1352460032,1352461066,0,2,1034
192,22100,5,1352461066,1352461126,0,2,60
192,22103,284,1353819577,1353819657,0,1,80
192,22104,8,1354015424,1354015484,0,1,60
192,22107,8,1354619001,1354619043,0,2,42
192,22107,5,1354619055,1354619115,0,2,60
192,22111,5,1355218111,1355218171,0,1,60
192,22112,71,1355393072,1355393132,0,1,60
192,22113,5,1355742599,1355742659,0,1,60
192,22114,297,1355829887,1355829947,0,1,60
192,22115,297,1356091815,1356091875,0,1,60
192,22116,297,1356676225,1356679883,0,1,3658
192,22118,284,1357123328,1357123388,0,1,60
192,22120,8,1357553466,1357554597,0,2,1131
192,22120,5,1357554597,1357554657,0,2,60
192,22121,253,1358511424,1358511446,0,1,22
192,22123,297,1358759293,1358759956,0,2,663
192,22123,21,1358759956,1358760016,0,2,60
192,22124,297,1358843976,1358858705,0,2,14729
192,22124,5,1358858705,1358858765,0,2,60
192,22126,21,1359553280,1359553340,0,1,60
192,22127,297,1359622533,1359624121,0,2,1588
192,22127,449,1359624121,1359629581,0,2,5460
192,22128,35,1359711416,1359711428,0,1,12
193,22187,253,1343470911,1343471868,0,1,957
193,22192,284,1344602287,1344602347,0,1,60
193,22193,284,1344667432,1344670775,0,4,3343
193,22193,284,1344670775,1344671896,0,4,1121
193,22193,253,1344671896,1344673481,0,4,1585
193,22193,253,1344679684,1344680818,0,4,1134
193,22196,21,1345253757,1345254279,0,2,522
193,22196,21,1345257544,1345257604,0,2,60
193,22202,35,1350019472,1350019905,0,1,433
193,22206,765,1350575244,1350575304,0,1,60
193,22209,765,1350951938,1350953532,0,1,1594
193,22210,765,1350999118,1350999178,0,1,60
193,22211,765,1351048523,1351050228,0,2,1705
193,22211,765,1351059658,1351059718,0,2,60
193,22219,765,1351657198,1351657258,0,1,60
193,22220,765,1351675423,1351675483,0,1,60
193,22221,765,1351744635,1351744695,0,1,60
193,22226,765,1352258075,1352259820,0,1,1745
193,22228,765,1352375519,1352375579,0,1,60
193,22230,765,1352508351,1352508630,0,2,279
193,22230,765,1352515844,1352515904,0,2,60
193,22235,765,1352721214,1352721274,0,1,60
193,22241,765,1353366847,1353374900,0,2,8053
193,22241,35,1353374900,1353375290,0,2,390
193,22242,765,1353415435,1353415495,0,1,60
193,22243,765,1353468804,1353471049,0,2,2245
193,22243,765,1353487653,1353487713,0,2,60
193,22247,765,1353633297,1353637389,0,2,4092
193,22247,651,1353637389,1353638444,0,2,1055
193,22248,765,1353732774,1353734872,0,2,2098
193,22248,765,1353744601,1353744661,0,2,60
193,22249,765,1353826176,1353827116,0,2,940
193,22249,253,1353827116,1353827176,0,2,60
193,22250,765,1353903634,1353906065,0,1,2431
193,22251,765,1353971926,1353976485,0,2,4559
193,22251,765,1353976485,1353976545,0,2,60
193,22255,765,1354349646,1354349706,0,1,60
193,22258,765,1354767371,1354769049,0,1,1678
193,22259,765,1354797076,1354797136,0,1,60
193,22260,765,1354922367,1354924175,0,1,1808
193,22261,765,1354953974,1354954034,0,1,60
193,22265,35,1355234655,1355236161,0,2,1506
193,22265,765,1355236161,1355236221,0,2,60
193,22266,765,1355282537,1355284124,0,1,1587
193,22267,765,1355373626,1355373686,0,1,60
193,22269,765,1355526978,1355528604,0,1,1626
193,22273,35,1355811483,1355811615,0,2,132
193,22273,35,1355811615,1355813181,0,2,1566
193,22275,765,1355978825,1355978885,0,1,60
194,22296,5,1336139440,1336139500,0,1,60
194,22298,28,1336351587,1336369653,0,2,18066
194,22298,28,1336369653,1336369713,0,2,60
194,22299,28,1336697550,1336697610,0,1,60
194,22301,28,1337141645,1337141657,0,1,12
194,22302,28,1337647216,1337662952,0,2,15736
194,22302,28,1337662952,1337663334,0,2,382
194,22303,11,1338010184,1338010491,0,1,307
194,22305,28,1338184683,1338184743,0,1,60
194,22308,28,1338770857,1338779267,0,2,8410
194,22308,28,1338779267,1338781655,0,2,2388
194,22311,28,1339303061,1339303274,0,3,213
194,22311,11,1339303274,1339303464,0,3,190
194,22311,5,1339303464,1339303524,0,3,60
194,22313,5,1339760488,1339761593,0,3,1105
194,22313,297,1339761593,1339762275,0,3,682
194,22313,297,1339762275,1339762335,0,3,60
194,22316,28,1342070603,1342072385,0,2,1782
194,22316,5,1342072385,1342072397,0,2,12
194,22320,1,1345426918,1345427555,0,3,637
194,22320,28,1345427891,1345430301,0,3,2410
194,22320,28,1345430301,1345430361,0,3,60
194,22335,28,1353390324,1353390450,0,1,126
194,22341,5,1355560232,1355563191,0,1,2959
194,22343,1,1355973534,1355984274,0,1,10740
194,22346,28,1356665994,1356666211,0,1,217
194,22352,28,1358218703,1358218763,0,1,60
194,22355,1,1359094655,1359095723,0,2,1068
194,22355,1,1359114515,1359114575,0,2,60
194,22358,28,1360634909,1360640909,0,1,6000
195,22360,5,1333869212,1333869805,0,3,593
195,22360,253,1333881107,1333881130,0,3,23
195,22360,59,1333881147,1333881207,0,3,60
195,22362,5,1334815126,1334819071,0,2,3945
195,22362,21,1334819071,1334819127,0,2,56
195,22363,5,1335085384,1335085459,0,2,75
195,22363,5,1335086794,1335086854,0,2,60
195,22364,5,1335580903,1335580997,0,2,94
195,22364,1005,1335601755,1335601815,0,2,60
195,22365,765,1335609668,1335611550,0,2,1882
195,22365,5,1335611550,1335613002,0,2,1452
195,22366,8,1336122256,1336122316,0,1,60
195,22368,5,1336808910,1336809025,0,1,115
195,22369,297,1336884021,1336884032,0,1,11
195,22370,5,1338111092,1338111194,0,1,102
195,22371,59,1338707878,1338707890,0,2,12
195,22371,253,1338707890,1338708687,0,2,797
195,22372,5,1339240986,1339241046,0,1,60
195,22373,5,1339672379,1339672439,0,1,60
195,22374,5,1341396309,1341397233,0,1,924
195,22376,5,1342091259,1342091291,0,1,32
195,22378,1005,1342520117,1342520177,0,1,60
195,22380,5,1344510998,1344511058,0,1,60
195,22381,71,1344576579,1344578271,0,1,1692
195,22382,5,1344757265,1344758362,0,1,1097
195,22383,5,1344767677,1344767737,0,1,60
195,22385,253,1347706112,1347711259,0,1,5147
195,22388,5,1354285504,1354285564,0,1,60
195,22392,5,1359284347,1359284393,0,1,46
196,22393,5,1360837696,1360839017,0,1,1321
196,22394,11,1334203494,1334203717,0,3,223
196,22394,480,1334204118,1334206345,0,3,2227
196,22394,5,1334209311,1334210617,0,3,1306
196,22395,11,1334271052,1334271157,0,1,105
196,22396,480,1334298818,1334298884,0,2,66
196,22396,5,1334299045,1334299133,0,2,88
196,22398,11,1334703373,1334703990,0,1,617
196,22399,480,1334790621,1334807537,0,1,16916
196,22400,11,1334818799,1334818861,0,1,62
196,22401,11,1334876176,1334876356,0,2,180
196,22401,5,1334876709,1334876868,0,2,159
196,22402,5,1334912016,1334912118,0,2,102
196,22402,11,1334912271,1334912652,0,2,381
196,22403,11,1335135381,1335135592,0,3,211
196,22403,5,1335135968,1335136224,0,3,256
196,22403,480,1335136484,1335136544,0,3,60
196,22404,5,1335163801,1335163830,0,1,29
196,22406,5,1335249834,1335249874,0,1,40
196,22407,11,1335308191,1335308406,0,3,215
196,22407,5,1335308778,1335309004,0,3,226
196,22407,480,1335309310,1335309370,0,3,60
196,22408,11,1335394862,1335395493,0,2,631
196,22408,5,1335395493,1335395558,0,2,65
196,22409,5,1335422479,1335422839,0,2,360
196,22409,11,1335427819,1335427955,0,2,136
196,22410,11,1335520360,1335520393,0,1,33
196,22411,11,1335568249,1335568326,0,3,77
196,22411,5,1335568549,1335568611,0,3,62
196,22411,480,1335568692,1335586584,0,3,17892
196,22412,5,1335599048,1335599331,0,1,283
196,22413,11,1335912994,1335913547,0,3,553
196,22413,5,1335913547,1335913582,0,3,35
196,22413,480,1335913787,1335913847,0,3,60
196,22414,5,1335941487,1335942271,0,2,784
196,22414,11,1335942271,1335942298,0,2,27
196,22415,11,1336086610,1336086667,0,2,57
196,22415,480,1336087064,1336087124,0,2,60
196,22416,5,1336121686,1336121810,0,2,124
196,22416,11,1336122049,1336122540,0,2,491
196,22417,11,1336263991,1336264025,0,1,34
196,22418,11,1336344988,1336345343,0,3,355
196,22418,5,1336345753,1336345858,0,3,105
196,22418,480,1336346098,1336346158,0,3,60
196,22419,11,1336374559,1336375005,0,1,446
196,22420,11,1336517839,1336518287,0,2,448
196,22420,480,1336518765,1336518825,0,2,60
196,22421,5,1336546095,1336546157,0,2,62
196,22421,11,1336546467,1336546509,0,2,42
196,22422,11,1336604264,1336604460,0,3,196
196,22422,5,1336604878,1336605045,0,3,167
196,22422,480,1336605332,1336605392,0,3,60
196,22423,5,1336691403,1336691465,0,2,62
196,22423,480,1336691623,1336691683,0,2,60
196,22424,5,1336737381,1336737381,0,3,0
196,22424,5,1336737381,1336737490,0,3,109
196,22424,11,1336738224,1336738251,0,3,27
196,22425,11,1336869342,1336869531,0,1,189
196,22426,640,1336904777,1336905601,0,4,824
196,22426,640,1336912625,1336912701,0,4,76
196,22426,284,1336913054,1336913082,0,4,28
196,22426,351,1336913890,1336914053,0,4,163
196,22427,11,1336950638,1336950680,0,2,42
196,22427,5,1336951056,1336951116,0,2,60
196,22428,11,1336979197,1336979288,0,1,91
196,22429,480,1337037042,1337037102,0,1,60
196,22430,5,1337072456,1337072749,0,2,293
196,22430,11,1337072798,1337072860,0,2,62
196,22431,11,1337123437,1337123645,0,2,208
196,22431,5,1337124023,1337124083,0,2,60
196,22432,11,1337153382,1337153408,0,1,26
196,22433,11,1337210491,1337210897,0,3,406
196,22433,5,1337211302,1337211353,0,3,51
196,22433,480,1337211591,1337211651,0,3,60
196,22434,11,1337252526,1337252611,0,1,85
196,22435,11,1337295418,1337295967,0,3,549
196,22435,5,1337295967,1337296048,0,3,81
196,22435,480,1337296048,1337296913,0,3,865
196,22436,11,1337388137,1337388162,0,1,25
196,22437,21,1337419540,1337425064,0,2,5524
196,22437,11,1337425520,1337425578,0,2,58
196,22438,11,1337640978,1337641099,0,1,121
196,22439,11,1337669198,1337669314,0,1,116
196,22440,5,1337814647,1337814707,0,1,60
196,22441,5,1337939450,1337939500,0,2,50
196,22441,11,1337940088,1337940149,0,2,61
196,22442,11,1337988522,1337988876,0,3,354
196,22442,5,1337988902,1337989120,0,3,218
196,22442,480,1337989120,1338006720,0,3,17600
196,22443,5,1338022693,1338022941,0,2,248
196,22443,11,1338022941,1338023369,0,2,428
196,22444,284,1338073980,1338074044,0,1,64
196,22445,284,1338110765,1338110803,0,2,38
196,22445,351,1338111497,1338111760,0,2,263
196,22446,11,1338159778,1338159897,0,1,119
196,22447,5,1338187640,1338188062,0,2,422
196,22447,11,1338188062,1338188096,0,2,34
196,22448,11,1338249542,1338250012,0,2,470
196,22448,11,1338268894,1338268966,0,2,72
196,22449,11,1338332709,1338332796,0,2,87
196,22449,5,1338333115,1338333175,0,2,60
196,22450,5,1338360172,1338360452,0,2,280
196,22450,11,1338360509,1338360580,0,2,71
196,22451,5,1338540772,1338540981,0,2,209
196,22451,11,1338541516,1338541560,0,2,44
196,22452,284,1338696643,1338697873,0,4,1230
196,22452,480,1338711065,1338711492,0,4,427
196,22452,21,1338711535,1338711767,0,4,232
196,22452,11,1338714086,1338714193,0,4,107
196,22453,11,1338764298,1338764688,0,2,390
196,22453,480,1338764840,1338781803,0,2,16963
196,22454,11,1338850925,1338851566,0,3,641
196,22454,5,1338851628,1338852015,0,3,387
196,22454,480,1338852015,1338852075,0,3,60
196,22455,11,1338878558,1338878621,0,1,63
196,22456,5,1339023986,1339024243,0,2,257
196,22456,480,1339024243,1339024303,0,2,60
196,22457,5,1339051570,1339051627,0,2,57
196,22457,11,1339053076,1339053152,0,2,76
196,22458,11,1339109797,1339110319,0,1,522
196,22459,5,1339370379,1339370730,0,2,351
196,22459,480,1339370730,1339370790,0,2,60
196,22460,11,1339397995,1339398052,0,1,57
196,22461,11,1339455834,1339456000,0,2,166
196,22461,480,1339456613,1339456673,0,2,60
196,22462,11,1339484344,1339484410,0,1,66
196,22463,11,1339542167,1339542222,0,2,55
196,22463,480,1339542748,1339542808,0,2,60
196,22464,5,1339568437,1339568509,0,1,72
196,22465,11,1339628189,1339628369,0,2,180
196,22465,480,1339628887,1339628947,0,2,60
196,22466,8,1339656949,1339658073,0,3,1124
196,22466,5,1339658073,1339658109,0,3,36
196,22466,11,1339658332,1339658361,0,3,29
196,22467,8,1339759450,1339760741,0,3,1291
196,22467,5,1339760741,1339760798,0,3,57
196,22467,11,1339761821,1339761898,0,3,77
196,22468,5,1340233853,1340234096,0,2,243
196,22468,480,1340234096,1340234156,0,2,60
196,22469,11,1340264622,1340264711,0,1,89
196,22471,5,1340779126,1340779315,0,2,189
196,22471,11,1340779464,1340779497,0,2,33
196,22472,5,1341620360,1341620444,0,1,84
196,22473,5,1341647926,1341647972,0,3,46
196,22473,11,1341648387,1341651267,0,3,2880
196,22473,1,1341652402,1341652895,0,3,493
196,22474,11,1341791122,1341791171,0,2,49
196,22474,480,1341791925,1341791985,0,2,60
196,22475,5,1341823780,1341824221,0,2,441
196,22475,11,1341824242,1341824309,0,2,67
196,22476,11,1341876065,1341876151,0,3,86
196,22476,5,1341876566,1341876778,0,3,212
196,22476,480,1341876800,1341876860,0,3,60
196,22477,11,1341962430,1341962565,0,3,135
196,22477,5,1341962953,1341963043,0,3,90
196,22477,480,1341963128,1341979662,0,3,16534
196,22478,5,1341987793,1341987930,0,2,137
196,22478,11,1341987930,1341987956,0,2,26
196,22479,11,1342049974,1342050091,0,2,117
196,22479,480,1342051539,1342051599,0,2,60
196,22480,5,1342085943,1342086026,0,2,83
196,22480,11,1342086571,1342086830,0,2,259
196,22481,11,1342135196,1342135234,0,2,38
196,22481,480,1342135924,1342135984,0,2,60
196,22482,5,1342176633,1342176679,0,2,46
196,22482,11,1342176997,1342177138,0,2,141
196,22483,5,1342223053,1342223112,0,2,59
196,22483,480,1342223314,1342223374,0,2,60
196,22485,11,1342395698,1342395743,0,5,45
196,22485,5,1342396043,1342413140,0,5,17097
196,22485,5,1342413551,1342413616,0,5,65
196,22485,21,1342413875,1342414361,0,5,486
196,22485,11,1342414760,1342414791,0,5,31
196,22486,11,1342480932,1342481485,0,3,553
196,22486,5,1342481514,1342481914,0,3,400
196,22486,480,1342481914,1342481974,0,3,60
196,22487,11,1342514124,1342514141,0,1,17
196,22488,11,1342567220,1342567333,0,1,113
196,22490,21,1342829807,1342830951,0,1,1144
196,22491,480,1342954833,1342955189,0,2,356
196,22491,21,1342955285,1342956174,0,2,889
196,22492,11,1343124428,1343124490,0,1,62
196,22493,11,1343344985,1343345349,0,1,364
196,22494,5,1343432105,1343432165,0,1,60
196,22495,5,1343468212,1343468496,0,2,284
196,22495,21,1343468532,1343468673,0,2,141
196,22496,5,1343521202,1343522081,0,2,879
196,22496,480,1343522081,1343533153,0,2,11072
196,22497,11,1343557134,1343557198,0,1,64
196,22498,5,1343605872,1343606036,0,2,164
196,22498,480,1343606154,1343606214,0,2,60
196,22499,5,1343645613,1343645685,0,1,72
196,22500,35,1344214330,1344228192,0,1,13862
196,22501,5,1344242771,1344242860,0,2,89
196,22501,11,1344243173,1344243254,0,2,81
196,22502,5,1344507829,1344507897,0,2,68
196,22502,11,1344508821,1344509004,0,2,183
196,22503,5,1344555681,1344556052,0,2,371
196,22503,480,1344556052,1344556112,0,2,60
196,22504,5,1344584923,1344585062,0,2,139
196,22504,11,1344585702,1344586299,0,2,597
196,22505,480,1344642382,1344642442,0,1,60
196,22506,5,1344665893,1344669085,0,3,3192
196,22506,5,1344669085,1344669123,0,3,38
196,22506,11,1344670193,1344670225,0,3,32
196,22507,11,1344728113,1344728143,0,2,30
196,22507,5,1344728471,1344728531,0,2,60
196,22508,5,1344751326,1344751489,0,3,163
196,22508,5,1344752837,1344754329,0,3,1492
196,22508,428,1344754362,1344754430,0,3,68
196,22509,480,1344829634,1344832268,0,3,2634
196,22509,5,1344832268,1344833143,0,3,875
196,22509,21,1344833173,1344833313,0,3,140
196,22510,351,1344866342,1344866665,0,1,323
196,22511,11,1344900848,1344900911,0,1,63
196,22512,480,1344929257,1344929301,0,3,44
196,22512,5,1344930944,1344930981,0,3,37
196,22512,11,1344931233,1344931310,0,3,77
196,22513,5,1345163385,1345163671,0,1,286
196,22514,11,1345420753,1345420792,0,2,39
196,22514,5,1345421107,1345421167,0,2,60
196,22515,480,1345448386,1345448415,0,1,29
196,22516,5,1346886422,1346887359,0,1,937
196,22518,11,1347668732,1347668772,0,1,40
196,22519,5,1347699839,1347699862,0,1,23
196,22520,11,1347753388,1347753448,0,1,60
196,22521,11,1349684277,1349685853,0,1,1576
196,22522,11,1349996364,1349996409,0,1,45
196,22525,5,1350112759,1350112813,0,2,54
196,22525,11,1350116672,1350116699,0,2,27
196,22526,480,1350602985,1350603045,0,1,60
196,22528,480,1350973708,1350973757,0,3,49
196,22528,5,1350973983,1350974119,0,3,136
196,22528,11,1350974753,1350974829,0,3,76
196,22529,11,1351033108,1351033122,0,1,14
196,22530,11,1351060971,1351061382,0,1,411
196,22531,11,1351120229,1351120243,0,1,14
196,22532,480,1351147736,1351147747,0,3,11
196,22532,5,1351147895,1351147943,0,3,48
196,22532,11,1351148395,1351148411,0,3,16
196,22533,11,1351206661,1351206683,0,1,22
196,22534,5,1351243523,1351243564,0,2,41
196,22534,11,1351246073,1351246099,0,2,26
196,22535,35,1351298955,1351299005,0,3,50
196,22535,5,1351308609,1351308651,0,3,42
196,22535,21,1351308869,1351308929,0,3,60
196,22536,5,1351332524,1351332564,0,2,40
196,22536,11,1351332851,1351332872,0,2,21
196,22537,11,1351380068,1351380104,0,1,36
196,22538,480,1351420178,1351420201,0,2,23
196,22538,11,1351424577,1351424665,0,2,88
196,22539,11,1351465983,1351466344,0,1,361
196,22540,480,1351492480,1351492704,0,3,224
196,22540,5,1351492704,1351492765,0,3,61
196,22540,11,1351493827,1351493847,0,3,20
196,22541,11,1351638991,1351639475,0,1,484
196,22542,11,1351667041,1351667052,0,1,11
196,22543,11,1351724959,1351725099,0,1,140
196,22544,480,1351750644,1351750692,0,3,48
196,22544,5,1351750873,1351750941,0,3,68
196,22544,11,1351751511,1351751529,0,3,18
196,22545,11,1351811386,1351811415,0,2,29
196,22545,5,1351811681,1351811741,0,2,60
196,22546,5,1351846375,1351846480,0,2,105
196,22546,11,1351846887,1351846894,0,2,7
196,22547,5,1352158373,1352158825,0,2,452
196,22547,480,1352158833,1352158893,0,2,60
196,22548,8,1352184145,1352185172,0,3,1027
196,22548,5,1352185172,1352185480,0,3,308
196,22548,11,1352185494,1352185536,0,3,42
196,22549,11,1352243484,1352243497,0,2,13
196,22549,5,1352243896,1352243956,0,2,60
196,22550,5,1352269989,1352270113,0,2,124
196,22550,351,1352271229,1352271302,0,2,73
196,22552,11,1352507878,1352507902,0,1,24
196,22554,11,1352635725,1352635915,0,1,190
196,22555,5,1352675841,1352676209,0,1,368
196,22556,5,1352702266,1352702286,0,1,20
196,22557,11,1352761386,1352762185,0,2,799
196,22557,480,1352762202,1352762262,0,2,60
196,22558,5,1352788316,1352788535,0,3,219
196,22558,11,1352788892,1352789034,0,3,142
196,22558,351,1352789708,1352789780,0,3,72
196,22559,11,1353020823,1353020885,0,1,62
196,22560,5,1353057314,1353057331,0,2,17
196,22560,11,1353057852,1353057919,0,2,67
196,22561,11,1353123633,1353123794,0,1,161
196,22562,11,1353150494,1353150676,0,1,182
196,22564,5,1353219206,1353219717,0,2,511
196,22564,11,1353224742,1353224757,0,2,15
196,22565,11,1353369054,1353369301,0,1,247
196,22566,5,1353393449,1353393497,0,2,48
196,22566,11,1353393774,1353394047,0,2,273
196,22567,11,1353453299,1353453325,0,1,26
196,22568,5,1353479596,1353479793,0,2,197
196,22568,11,1353481076,1353481102,0,2,26
196,22569,480,1353541584,1353541644,0,1,60
196,22570,5,1353566794,1353566825,0,1,31
196,22571,11,1353728552,1353728623,0,1,71
196,22572,480,1353750368,1353750380,0,2,12
196,22572,21,1353754258,1353754979,0,2,721
196,22575,480,1353917625,1353917639,0,3,14
196,22575,5,1353917891,1353917909,0,3,18
196,22575,11,1353918588,1353918598,0,3,10
196,22578,480,1354145228,1354145288,0,1,60
196,22579,5,1354171975,1354172039,0,1,64
196,22580,11,1354323631,1354323811,0,3,180
196,22580,5,1354324205,1354337476,0,3,13271
196,22580,21,1354337476,1354340550,0,3,3074
196,22581,11,1354356555,1354356578,0,1,23
196,22582,5,1354441123,1354441170,0,2,47
196,22582,11,1354441432,1354441446,0,2,14
196,22584,5,1354516665,1354516792,0,2,127
196,22584,11,1354517182,1354517287,0,2,105
196,22585,480,1354579417,1354579477,0,1,60
196,22586,5,1354604325,1354604346,0,2,21
196,22586,11,1354606064,1354606078,0,2,14
196,22587,11,1354662246,1354662275,0,1,29
196,22588,5,1354690487,1354690705,0,2,218
196,22588,11,1354692907,1354692928,0,2,21
196,22589,11,1354751502,1354751688,0,2,186
196,22589,480,1354752887,1354752947,0,2,60
196,22591,11,1354924901,1354924961,0,1,60
196,22592,480,1354949076,1354954537,0,4,5461
196,22592,21,1354954537,1354954624,0,4,87
196,22592,5,1354955523,1354956911,0,4,1388
196,22592,11,1354956911,1354957702,0,4,791
196,22595,5,1355125875,1355125912,0,3,37
196,22595,11,1355126096,1355126097,0,3,1
196,22595,11,1355126097,1355126140,0,3,43
196,22596,11,1355183074,1355183221,0,1,147
196,22597,480,1355211693,1355211721,0,3,28
196,22597,5,1355211964,1355211995,0,3,31
196,22597,11,1355212401,1355212415,0,3,14
196,22598,480,1355283393,1355283848,0,2,455
196,22598,5,1355283848,1355284701,0,2,853
196,22600,480,1355395425,1355395442,0,2,17
196,22600,11,1355395859,1355397072,0,2,1213
196,22601,351,1355533571,1355533650,0,1,79
196,22602,11,1355566513,1355566521,0,1,8
196,22603,5,1355731217,1355731240,0,1,23
196,22605,11,1355817468,1355817509,0,1,41
196,22606,480,1355875947,1355889867,0,2,13920
196,22606,5,1355889925,1355890895,0,2,970
196,22607,5,1355906588,1355907227,0,2,639
196,22607,11,1355907250,1355907394,0,2,144
196,22608,11,1355960379,1355960402,0,2,23
196,22608,5,1355976834,1355976894,0,2,60
196,22609,11,1356046749,1356047429,0,1,680
196,22610,21,1356143841,1356147420,0,2,3579
196,22610,480,1356163630,1356163690,0,2,60
196,22611,5,1356167847,1356171122,0,2,3275
196,22611,11,1356171140,1356171181,0,2,41
196,22612,480,1356237483,1356237543,0,1,60
196,22613,11,1356254521,1356254537,0,1,16
196,22614,5,1356693171,1356693201,0,2,30
196,22614,11,1356693559,1356693571,0,2,12
196,22615,11,1356740103,1356740134,0,2,31
196,22615,480,1356741275,1356755926,0,2,14651
196,22616,5,1356778479,1356778529,0,2,50
196,22616,11,1356779464,1356779524,0,2,60
196,22617,5,1356843856,1356843916,0,1,60
196,22620,5,1356950332,1356950398,0,1,66
196,22621,5,1357128930,1357128971,0,1,41
196,22622,480,1357173688,1357173748,0,1,60
196,22624,21,1357272189,1357272249,0,1,60
196,22625,11,1357302282,1357302293,0,1,11
196,22626,480,1357365210,1357365270,0,1,60
196,22628,21,1357531402,1357531422,0,1,20
196,22629,480,1357543894,1357543930,0,3,36
196,22629,5,1357544173,1357544235,0,3,62
196,22629,11,1357545133,1357545159,0,3,26
196,22631,480,1357631536,1357631814,0,2,278
196,22631,5,1357631814,1357632830,0,2,1016
196,22632,284,1357701027,1357701061,0,2,34
196,22632,11,1357702042,1357717614,0,2,15572
196,22633,480,1357803493,1357803650,0,3,157
196,22633,5,1357803650,1357803688,0,3,38
196,22633,11,1357804095,1357804133,0,3,38
196,22634,11,1357873888,1357874766,0,3,878
196,22634,480,1357889885,1357890034,0,3,149
196,22634,5,1357890034,1357890427,0,3,393
196,22635,35,1357953535,1357965513,0,1,11978
196,22636,5,1357981715,1357981793,0,1,78
196,22637,5,1358072018,1358072046,0,2,28
196,22637,11,1358072353,1358072414,0,2,61
196,22638,11,1358128631,1358133910,0,2,5279
196,22638,21,1358133910,1358133925,0,2,15
196,22639,21,1358155546,1358155670,0,1,124
196,22640,11,1358220369,1358220537,0,3,168
196,22640,5,1358235483,1358240782,0,3,5299
196,22640,11,1358240782,1358241355,0,3,573
196,22641,5,1358757304,1358757388,0,2,84
196,22641,11,1358757822,1358757922,0,2,100
196,22642,11,1358810830,1358810865,0,2,35
196,22642,480,1358811584,1358811597,0,2,13
196,22643,5,1358833335,1358833371,0,1,36
196,22644,11,1359069594,1359070049,0,1,455
196,22645,11,1359105154,1359105172,0,1,18
196,22647,5,1359185553,1359185580,0,1,27
196,22648,11,1359244254,1359265148,0,2,20894
196,22648,480,1359265148,1359265178,0,2,30
196,22649,5,1359267611,1359267629,0,2,18
196,22649,11,1359268142,1359268195,0,2,53
196,22650,11,1359329079,1359329093,0,1,14
196,22651,5,1359360143,1359360174,0,2,31
196,22651,11,1359360729,1359360754,0,2,25
196,22653,11,1359502440,1359502506,0,1,66
196,22654,480,1359531537,1359531677,0,3,140
196,22654,5,1359531677,1359531734,0,3,57
196,22654,11,1359532120,1359532130,0,3,10
196,22655,11,1359589220,1359589531,0,1,311
196,22656,480,1359617868,1359617976,0,3,108
196,22656,5,1359618088,1359618106,0,3,18
196,22656,11,1359618423,1359618448,0,3,25
196,22657,11,1359675577,1359675590,0,2,13
196,22657,480,1359676750,1359692499,0,2,15749
196,22658,5,1359705624,1359705665,0,2,41
196,22658,11,1359706023,1359706034,0,2,11
196,22659,11,1359761348,1359761393,0,2,45
196,22659,480,1359762303,1359762363,0,2,60
196,22660,5,1359792121,1359792158,0,2,37
196,22660,11,1359793272,1359793293,0,2,21
196,22661,35,1360032873,1360038641,0,1,5768
196,22662,11,1360108876,1360110199,0,1,1323
196,22663,11,1360645670,1360645704,0,3,34
196,22663,5,1360649470,1360649700,0,3,230
196,22663,480,1360649700,1360653403,0,3,3703
196,22665,480,1360742534,1360742694,0,2,160
196,22665,5,1360742694,1360742720,0,2,26
197,22696,651,1336481342,1336483145,0,1,1803
197,22706,21,1337380153,1337380213,0,1,60
197,22720,21,1339575435,1339575495,0,1,60
197,22722,28,1340245538,1340250189,0,1,4651
197,22724,71,1340786880,1340789484,0,1,2604
197,22730,640,1341545607,1341545667,0,1,60
197,22751,253,1344240587,1344240647,0,1,60
197,22768,21,1351413466,1351413526,0,1,60
197,22774,21,1352110343,1352110403,0,1,60
197,22775,21,1352201610,1352201670,0,1,60
197,22776,28,1352274202,1352274262,0,1,60
197,22811,35,1357528188,1357535239,0,2,7051
197,22811,640,1357535239,1357535299,0,2,60
197,22820,640,1358486681,1358486741,0,1,60
197,22823,651,1358855449,1358855509,0,1,60
197,22825,11,1359353823,1359353883,0,1,60
197,22829,21,1359798392,1359798452,0,1,60
197,22833,284,1360673045,1360673557,0,1,512
198,22837,71,1338856664,1338866153,0,1,9489
198,22841,351,1339071077,1339071936,0,1,859
198,22842,71,1339114598,1339116453,0,1,1855
198,22845,351,1339494855,1339495434,0,1,579
198,22846,351,1339543048,1339543348,0,1,300
198,22847,297,1339580332,1339580661,0,1,329
198,22848,351,1339975182,1339975202,0,1,20
198,22849,351,1340007952,1340008619,0,1,667
198,22851,351,1340234434,1340234526,0,1,92
198,22852,71,1340268632,1340271305,0,1,2673
198,22854,1005,1340786937,1340788785,0,1,1848
198,22856,351,1341270139,1341270244,0,1,105
198,22857,71,1341385524,1341385584,0,1,60
198,22859,651,1341456142,1341470202,0,3,14060
198,22859,253,1341470202,1341472253,0,3,2051
198,22859,351,1341472253,1341472313,0,3,60
198,22860,11,1341533745,1341533965,0,1,220
198,22861,71,1341555113,1341555173,0,1,60
198,22862,351,1341635985,1341636539,0,1,554
198,22864,351,1341750410,1341751625,0,1,1215
198,22865,11,1341791843,1341792634,0,2,791
198,22865,71,1341792634,1341793809,0,2,1175
198,22866,21,1341842979,1341843604,0,3,625
198,22866,11,1341843604,1341844590,0,3,986
198,22866,351,1341844590,1341845446,0,3,856
198,22870,351,1342048824,1342048849,0,1,25
198,22871,21,1342097222,1342097517,0,2,295
198,22871,21,1342097517,1342100535,0,2,3018
198,22875,351,1342478819,1342478879,0,1,60
198,22876,351,1342519938,1342519998,0,1,60
199,22883,351,1334207575,1334210763,0,5,3188
199,22883,284,1334219835,1334221018,0,5,1183
199,22883,5,1334221018,1334221156,0,5,138
199,22883,8,1334221156,1334225146,0,5,3990
199,22883,35,1334226105,1334226165,0,5,60
199,22902,351,1336700025,1336703315,0,1,3290
199,22903,284,1336742655,1336742715,0,1,60
199,22911,35,1338078850,1338078910,0,1,60
199,22919,35,1339498408,1339500333,0,1,1925
199,22921,351,1340246785,1340246946,0,2,161
199,22921,351,1340264106,1340264166,0,2,60
199,22922,35,1340778514,1340779459,0,1,945
199,22938,35,1343547598,1343549000,0,1,1402
199,22954,253,1351850104,1351850164,0,1,60
199,22960,297,1353402935,1353403546,0,2,611
199,22960,428,1353403546,1353404486,0,2,940
199,22984,351,1360205769,1360205976,0,2,207
199,22984,351,1360219920,1360221871,0,2,1951
200,23021,35,1342422900,1342423518,0,2,618
200,23021,253,1342423518,1342424551,0,2,1033
200,23032,253,1344670569,1344670629,0,1,60
200,23041,253,1346845870,1346847978,0,1,2108
200,23047,253,1351767167,1351767227,0,1,60
