userID,trajID,poiID,startTime,endTime,#photo,trajLen,poiDuration
10063645@N00,1,17,1168492531,1168492558,3,1,27
10091295@N02,2,1,1190423814,1190423916,4,2,102
10091295@N02,2,12,1190421746,1190421901,3,2,155
10091295@N02,3,28,1190988000,1190988000,1,1,0
10091295@N02,4,10,1191029287,1191029561,5,3,274
10091295@N02,4,17,1191040433,1191041876,3,3,1443
10091295@N02,4,28,1191037444,1191060959,2,3,23515
10091295@N02,5,1,1202516668,1202519120,15,1,2452
10115973@N05,6,18,1356893842,1356893842,1,1,0
10135031@N08,7,18,1276608349,1276608349,1,1,0
10137764@N00,8,3,1338576010,1338576015,2,1,5
10137764@N00,9,3,1338629233,1338657537,90,1,28304
10137764@N00,10,3,1338717763,1338756800,54,1,39037
10137764@N00,11,3,1338802474,1338826889,33,1,24415
10137764@N00,12,3,1338956416,1338956416,1,1,0
10159442@N00,13,1,1160799471,1160800433,7,12,962
10159442@N00,13,4,1160806709,1160809438,5,12,2729
10159442@N00,13,8,1160802950,1160802950,1,12,0
10159442@N00,13,9,1160799011,1160799011,1,12,0
10159442@N00,13,10,1160804614,1160804777,3,12,163
10159442@N00,13,11,1160804352,1160805659,7,12,1307
10159442@N00,13,15,1160801481,1160802410,5,12,929
10159442@N00,13,18,1160800596,1160800611,2,12,15
10159442@N00,13,19,1160803441,1160803571,3,12,130
10159442@N00,13,23,1160803843,1160804154,3,12,311
10159442@N00,13,24,1160807015,1160807443,22,12,428
10159442@N00,13,29,1160799768,1160800019,3,12,251
10159442@N00,14,4,1160879522,1160879597,2,2,75
10159442@N00,14,7,1160891664,1160894039,22,2,2375
10159442@N00,15,3,1246321197,1246321197,1,1,0
10182328@N02,16,17,1187159490,1187159529,2,1,39
10182328@N02,17,17,1187251520,1187251520,1,1,0
10182328@N02,18,24,1187335257,1187335257,1,1,0
10182328@N02,19,17,1187508784,1187508784,1,1,0
10182328@N02,20,3,1187578775,1187578775,1,1,0
10182328@N02,21,17,1187681423,1187682927,4,1,1504
10182328@N02,22,8,1187761363,1187761363,1,1,0
10182328@N02,23,13,1251041605,1251046821,21,1,5216
10182328@N02,24,13,1251298863,1251300306,3,1,1443
10229695@N08,25,23,1219657361,1219657361,1,1,0
10229695@N08,26,18,1331959541,1331959541,1,1,0
10251761@N04,27,1,1204084934,1204085201,2,2,267
10251761@N04,27,9,1204081504,1204081504,1,2,0
10251761@N04,28,1,1204162994,1204162994,1,1,0
10259636@N05,29,3,1344061244,1344061244,1,1,0
10259636@N05,30,10,1352720105,1352720105,1,1,0
10275618@N05,31,9,1262519741,1262519741,1,1,0
10287726@N02,32,2,1375412323,1375412584,2,6,261
10287726@N02,32,3,1375415274,1375415274,1,6,0
10287726@N02,32,8,1375422989,1375425858,14,6,2869
10287726@N02,32,9,1375416929,1375421119,3,6,4190
10287726@N02,32,17,1375406504,1375406504,1,6,0
10287726@N02,32,29,1375415715,1375415715,1,6,0
10287726@N02,33,1,1375497933,1375509475,16,5,11542
10287726@N02,33,3,1375513696,1375513696,1,5,0
10287726@N02,33,17,1375494129,1375497337,5,5,3208
10287726@N02,33,18,1375510509,1375510509,1,5,0
10287726@N02,33,29,1375497686,1375497686,1,5,0
10287726@N02,34,11,1375580312,1375581076,5,3,764
10287726@N02,34,17,1375571537,1375571537,1,3,0
10287726@N02,34,23,1375581641,1375581641,1,3,0
10295204@N00,35,2,1191454870,1191455305,2,1,435
10318705@N00,36,1,1364199840,1364199840,1,1,0
10332960@N03,37,3,1255648016,1255650221,5,2,2205
10332960@N03,37,17,1255647888,1255647888,1,2,0
10332960@N03,38,3,1255701736,1255701851,2,1,115
10332960@N03,39,3,1332744430,1332746606,8,3,2176
10332960@N03,39,9,1332744199,1332744199,1,3,0
10332960@N03,39,17,1332746489,1332746489,1,3,0
10335112@N05,40,15,1249645744,1249645851,2,2,107
10335112@N05,40,18,1249634897,1249634937,2,2,40
10335112@N05,41,1,1249701828,1249712164,24,5,10336
10335112@N05,41,2,1249689707,1249693678,21,5,3971
10335112@N05,41,8,1249713363,1249716559,29,5,3196
10335112@N05,41,15,1249713293,1249713293,1,5,0
10335112@N05,41,29,1249701687,1249712965,3,5,11278
10335112@N05,42,10,1249789047,1249789314,4,3,267
10335112@N05,42,11,1249788596,1249790102,8,3,1506
10335112@N05,42,23,1249788518,1249788562,3,3,44
10340081@N02,43,10,1249048800,1249048800,1,2,0
10340081@N02,43,18,1249048800,1249048800,1,2,0
10340081@N02,44,1,1249604117,1249604117,1,3,0
10340081@N02,44,3,1249608626,1249608956,2,3,330
10340081@N02,44,8,1249605497,1249605497,1,3,0
10352479@N07,45,9,1128195227,1128195374,2,1,147
10354154@N05,46,16,1315296567,1315296567,1,3,0
10354154@N05,46,18,1315296802,1315297866,9,3,1064
10354154@N05,46,29,1315296935,1315296968,6,3,33
103542358@N03,47,3,1342590927,1342590927,1,1,0
103767813@N04,48,18,1379809838,1379809838,1,1,0
10444870@N04,49,12,1365494194,1365494194,1,1,0
10486919@N00,50,17,1321417176,1321417176,1,1,0
10486919@N00,51,22,1321597743,1321597743,1,1,0
10486919@N00,52,9,1322030699,1322030699,1,1,0
10486919@N00,53,29,1325850805,1325850805,1,1,0
10486919@N00,54,29,1327506013,1327506013,1,1,0
10486919@N00,55,29,1327567321,1327567321,1,1,0
10486919@N00,56,29,1330238255,1330238255,1,1,0
10486919@N00,57,17,1332568164,1332568164,1,1,0
10486919@N00,58,19,1344407324,1344407324,1,1,0
10486919@N00,59,29,1344506822,1344506822,1,1,0
10486919@N00,60,8,1345444860,1345444860,1,1,0
10486919@N00,61,27,1346130899,1346130899,1,1,0
10486919@N00,62,29,1347196831,1347196831,1,1,0
10486919@N00,63,11,1347534057,1347534057,1,2,0
10486919@N00,63,17,1347511184,1347511184,1,2,0
10486919@N00,64,23,1347709804,1347709804,1,1,0
10486919@N00,65,29,1350176653,1350176653,1,1,0
10486919@N00,66,29,1350886279,1350886279,1,1,0
10486919@N00,67,9,1350979253,1350979253,1,3,0
10486919@N00,67,15,1350955282,1350955282,1,3,0
10486919@N00,67,28,1350962425,1350962425,1,3,0
10486919@N00,68,1,1351149124,1351149124,1,1,0
10486919@N00,69,5,1352350340,1352350340,1,1,0
10486919@N00,70,11,1353144514,1353144514,1,1,0
10486919@N00,71,15,1354501901,1354501901,1,1,0
10486919@N00,72,15,1354590748,1354590748,1,1,0
105002963@N07,73,3,1380867845,1380867879,2,1,34
105307156@N06,74,1,1375170614,1375170614,1,3,0
105307156@N06,74,2,1375148488,1375148488,1,3,0
105307156@N06,74,7,1375151750,1375151750,1,3,0
105830224@N07,75,17,1381647574,1381647574,1,1,0
10585427@N00,76,29,1362793702,1362793702,1,1,0
10611153@N00,77,8,1161532858,1161532858,1,2,0
10611153@N00,77,9,1161536350,1161536918,2,2,568
10611153@N00,78,1,1161619864,1161623439,3,2,3575
10611153@N00,78,29,1161628774,1161629015,3,2,241
10619879@N00,79,2,1270949593,1270965846,11,1,16253
10619879@N00,80,24,1274504528,1274511041,7,1,6513
10655856@N04,81,9,1274404053,1274404821,2,4,768
10655856@N04,81,12,1274416736,1274417376,2,4,640
10655856@N04,81,22,1274398803,1274398803,1,4,0
10655856@N04,81,29,1274406194,1274409470,5,4,3276
10655856@N04,82,8,1274504456,1274504456,1,5,0
10655856@N04,82,13,1274522430,1274522430,1,5,0
10655856@N04,82,16,1274497331,1274497331,1,5,0
10655856@N04,82,19,1274529912,1274529912,1,5,0
10655856@N04,82,29,1274529555,1274529555,1,5,0
108866594@N05,83,9,1372299502,1372299502,1,1,0
10935230@N05,84,10,1190435404,1190435404,1,2,0
10935230@N05,84,23,1190437200,1190437200,1,2,0
10935230@N05,85,27,1198723828,1198724400,2,1,572
10935230@N05,86,18,1206153287,1206153287,1,1,0
10935230@N05,87,15,1230946423,1230947658,4,1,1235
10935230@N05,88,14,1239409156,1239409258,4,2,102
10935230@N05,88,18,1239409972,1239412503,8,2,2531
10935230@N05,89,27,1242110106,1242110106,1,1,0
10935230@N05,90,14,1260397742,1260397742,1,1,0
10935230@N05,91,18,1261447379,1261447840,2,1,461
10935230@N05,92,18,1261539463,1261540027,2,1,564
10978503@N00,93,18,1182654450,1182658612,18,1,4162
10978503@N00,94,18,1193364876,1193408331,29,1,43455
10978503@N00,95,18,1193446383,1193446383,1,1,0
10978503@N00,96,18,1230437470,1230441168,32,1,3698
10978503@N00,97,18,1277527746,1277535363,15,1,7617
11037560@N04,98,1,1192853407,1192856671,2,3,3264
11037560@N04,98,4,1192862997,1192862997,1,3,0
11037560@N04,98,9,1192861907,1192861907,1,3,0
11037560@N04,99,4,1192942590,1192942590,1,6,0
11037560@N04,99,10,1192943055,1192943055,1,6,0
11037560@N04,99,12,1192940945,1192940945,1,6,0
11037560@N04,99,15,1192940569,1192940569,1,6,0
11037560@N04,99,16,1192940155,1192940155,1,6,0
11037560@N04,99,19,1192943826,1192943826,1,6,0
11037560@N04,100,12,1250222401,1250222401,1,1,0
11037560@N04,101,4,1276655633,1276655633,1,3,0
11037560@N04,101,10,1276655974,1276655974,1,3,0
11037560@N04,101,19,1276655952,1276655952,1,3,0
11037560@N04,102,8,1277440257,1277440907,3,1,650
11037560@N04,103,15,1277702278,1277702333,2,1,55
11037560@N04,104,8,1277786005,1277786005,1,2,0
11037560@N04,104,18,1277791299,1277791557,4,2,258
11037560@N04,105,9,1277876430,1277876430,1,1,0
11037560@N04,106,9,1278376185,1278376185,1,2,0
11037560@N04,106,29,1278378398,1278379049,4,2,651
11037560@N04,107,9,1278560049,1278560049,1,1,0
11037560@N04,108,21,1279596629,1279596703,2,1,74
11037560@N04,109,9,1281062416,1281063078,6,2,662
11037560@N04,109,18,1281060491,1281060491,1,2,0
11037560@N04,110,9,1281246059,1281246756,3,1,697
11037560@N04,111,9,1281594010,1281594010,1,1,0
11037560@N04,112,9,1281838433,1281840266,10,1,1833
11037560@N04,113,9,1281937120,1281940350,3,1,3230
11037560@N04,114,9,1282021736,1282022297,3,1,561
11037560@N04,115,9,1282184574,1282185924,4,1,1350
11037560@N04,116,9,1282446952,1282449287,9,1,2335
11037560@N04,117,9,1282616441,1282616441,1,1,0
11037560@N04,118,9,1282785107,1282790847,5,1,5740
11037560@N04,119,9,1282883060,1282883900,7,1,840
11037560@N04,120,10,1304159394,1304159394,1,1,0
11037560@N04,121,2,1311312913,1311315435,7,2,2522
11037560@N04,121,4,1311311112,1311311112,1,2,0
11037560@N04,122,9,1313208565,1313211931,11,3,3366
11037560@N04,122,15,1313206844,1313206844,1,3,0
11037560@N04,122,17,1313209306,1313209306,1,3,0
11037560@N04,123,17,1335226045,1335226093,2,2,48
11037560@N04,123,28,1335225478,1335225808,4,2,330
11037560@N04,124,28,1335656748,1335657485,6,1,737
11037560@N04,125,2,1337488904,1337488971,2,1,67
11037560@N04,126,2,1340417799,1340419472,8,2,1673
11037560@N04,126,4,1340417527,1340417823,3,2,296
11037560@N04,127,15,1341712968,1341712968,1,3,0
11037560@N04,127,19,1341719351,1341719609,5,3,258
11037560@N04,127,29,1341712659,1341719821,3,3,7162
11037560@N04,128,4,1342852421,1342852440,2,2,19
11037560@N04,128,28,1342853851,1342853851,1,2,0
11037560@N04,129,9,1346037374,1346037374,1,2,0
11037560@N04,129,29,1346032350,1346032350,1,2,0
11037560@N04,130,17,1346122632,1346122632,1,1,0
11037560@N04,131,3,1346994377,1346994416,2,1,39
11037560@N04,132,10,1347849006,1347849006,1,1,0
11037560@N04,133,23,1351049399,1351049399,1,1,0
11037560@N04,134,2,1353633962,1353633997,3,1,35
11037560@N04,135,9,1354181346,1354181375,3,1,29
11037560@N04,136,23,1355095141,1355095141,1,1,0
11037560@N04,137,19,1356861424,1356861424,1,1,0
11037560@N04,138,8,1366764571,1366764571,1,1,0
11037560@N04,139,9,1368781414,1368781480,2,1,66
11037560@N04,140,9,1372560915,1372560915,1,2,0
11037560@N04,140,13,1372559952,1372560055,2,2,103
11037560@N04,141,4,1373948177,1373948203,2,2,26
11037560@N04,141,23,1373949495,1373949495,1,2,0
11037560@N04,142,3,1375684104,1375684104,1,3,0
11037560@N04,142,9,1375678794,1375682596,11,3,3802
11037560@N04,142,28,1375683894,1375683894,1,3,0
11037560@N04,143,9,1376032201,1376036854,5,1,4653
11037560@N04,144,9,1376195744,1376195837,2,1,93
11037560@N04,145,9,1376623598,1376643665,15,1,20067
11037560@N04,146,12,1376822490,1376822500,2,1,10
11037560@N04,147,9,1376908009,1376908009,1,1,0
11052246@N03,148,8,1292569181,1292569181,1,1,0
11154928@N04,149,1,1227141747,1227150707,47,2,8960
11154928@N04,149,29,1227141029,1227141335,7,2,306
11154928@N04,150,9,1250309465,1250329830,15,5,20365
11154928@N04,150,15,1250308662,1250308675,3,5,13
11154928@N04,150,17,1250310605,1250310605,1,5,0
11154928@N04,150,19,1250310044,1250310046,2,5,2
11154928@N04,150,29,1250309186,1250309186,1,5,0
11155365@N03,151,1,1265854680,1265854680,1,1,0
11183658@N04,152,29,1110594393,1110632125,45,1,37732
11188541@N02,153,19,1310382249,1310382249,1,1,0
11199896@N00,154,9,1285064312,1285064312,1,1,0
11217157@N00,155,11,1354329436,1354329436,1,1,0
11250813@N04,156,19,1267241789,1267241789,1,1,0
11257766@N04,157,1,1185248232,1185248232,1,2,0
11257766@N04,157,29,1185275171,1185275171,1,2,0
11257766@N04,158,9,1187689896,1187689896,1,1,0
11257766@N04,159,9,1189762733,1189762733,1,1,0
11261325@N03,160,17,1253950062,1253954209,14,1,4147
11261325@N03,161,8,1260259755,1260259862,4,1,107
11261325@N03,162,20,1260411332,1260411383,2,1,51
11261325@N03,163,9,1261632286,1261632286,1,1,0
11261325@N03,164,1,1267672551,1267672943,7,6,392
11261325@N03,164,2,1267678339,1267678339,1,6,0
11261325@N03,164,4,1267678099,1267678116,2,6,17
11261325@N03,164,9,1267675064,1267675171,5,6,107
11261325@N03,164,19,1267675483,1267676700,8,6,1217
11261325@N03,164,29,1267672243,1267674015,14,6,1772
11261325@N03,165,4,1269146573,1269146608,3,1,35
11261325@N03,166,29,1269510998,1269510998,1,1,0
11261325@N03,167,9,1272942352,1272942403,3,2,51
11261325@N03,167,15,1272942453,1272942453,1,2,0
11261325@N03,168,9,1281837055,1281837900,5,2,845
11261325@N03,168,17,1281838594,1281838594,1,2,0
11261325@N03,169,15,1285468633,1285468661,3,1,28
11261325@N03,170,20,1304741576,1304745631,11,1,4055
11261325@N03,171,3,1311898133,1311900214,3,1,2081
11261325@N03,172,19,1313130639,1313130639,1,1,0
11261325@N03,173,19,1313193535,1313195611,4,1,2076
11261325@N03,174,20,1313726499,1313726575,5,1,76
11261325@N03,175,19,1323062697,1323062704,6,1,7
11261325@N03,176,19,1323765408,1323773450,31,1,8042
11261325@N03,177,12,1337417326,1337417326,1,1,0
11285171@N07,178,17,1344307502,1344307502,1,1,0
11393152@N08,179,9,1277272290,1277272290,1,1,0
11393152@N08,180,9,1277783565,1277783565,1,2,0
11393152@N08,180,17,1277783396,1277783396,1,2,0
11452054@N00,181,19,1388495092,1388495092,1,1,0
11493297@N06,182,9,1276915624,1276915624,1,1,0
11509228@N00,183,19,1206223850,1206223850,1,1,0
11516475@N00,184,1,1309834445,1309834445,1,1,0
11613952@N05,185,17,1174715929,1174715929,1,3,0
11613952@N05,185,18,1174710049,1174710049,1,3,0
11613952@N05,185,29,1174718836,1174718836,1,3,0
11706283@N04,186,16,1375342134,1375342134,1,1,0
11706283@N04,187,5,1379820883,1379820883,1,1,0
11731004@N08,188,9,1333689970,1333689970,1,2,0
11731004@N08,188,12,1333691614,1333691614,1,2,0
11731004@N08,189,9,1333798092,1333798558,3,1,466
11731004@N08,190,7,1333858630,1333858630,1,1,0
11779319@N07,191,8,1350174039,1350174039,1,1,0
11881702@N00,192,4,1289355863,1289355867,2,1,4
11881702@N00,193,1,1289430117,1289440702,11,5,10585
11881702@N00,193,3,1289441574,1289448117,5,5,6543
11881702@N00,193,9,1289450972,1289451929,2,5,957
11881702@N00,193,17,1289449110,1289449110,1,5,0
11881702@N00,193,29,1289430011,1289450431,4,5,20420
11881702@N00,194,15,1289516300,1289516300,1,3,0
11881702@N00,194,16,1289517046,1289517046,1,3,0
11881702@N00,194,17,1289526615,1289526615,1,3,0
11943954@N03,195,9,1158407734,1158407734,1,1,0
11943954@N03,196,9,1344126875,1344126875,1,1,0
11943954@N03,197,9,1351682662,1351682662,1,1,0
11956371@N07,198,3,1264208411,1264212064,21,2,3653
11956371@N07,198,9,1264204875,1264206758,8,2,1883
12039629@N00,199,15,1062920224,1062920224,1,1,0
12053105@N03,200,1,1345337256,1345345856,10,1,8600
12053105@N03,201,1,1345420845,1345457825,23,1,36980
12061846@N00,202,1,1281754885,1281761092,5,7,6207
12061846@N00,202,8,1281768580,1281768580,1,7,0
12061846@N00,202,9,1281762406,1281762406,1,7,0
12061846@N00,202,10,1281787531,1281787572,2,7,41
12061846@N00,202,15,1281772806,1281772806,1,7,0
12061846@N00,202,19,1281749129,1281749947,2,7,818
12061846@N00,202,29,1281761213,1281761213,1,7,0
120694055@N06,203,1,1395446094,1395450068,3,3,3974
120694055@N06,203,3,1395451077,1395451861,5,3,784
120694055@N06,203,29,1395450199,1395450199,1,3,0
12085221@N00,204,1,1183006953,1183009190,4,1,2237
12113931@N03,205,12,1339756411,1339756628,11,1,217
12168005@N00,206,9,1271204146,1271204146,1,1,0
12240334@N05,207,28,1241357323,1241357323,1,1,0
12271948@N00,208,8,1306230815,1306230815,1,1,0
12329069@N00,209,27,1207273771,1207273771,1,1,0
12329069@N00,210,20,1213926812,1213927538,2,1,726
12383598@N00,211,3,1306402127,1306402127,1,2,0
12383598@N00,211,17,1306402990,1306412140,2,2,9150
12401232@N02,212,9,1346211533,1346211533,1,1,0
12453610@N06,213,29,1270466244,1270466244,1,1,0
12463089@N04,214,17,1324092612,1324092612,1,1,0
12495774@N02,215,1,1195195766,1195195766,1,2,0
12495774@N02,215,8,1195168545,1195168545,1,2,0
12495774@N02,216,29,1195254687,1195254687,1,1,0
12495774@N02,217,27,1195350398,1195350398,1,1,0
12495774@N02,218,1,1195511941,1195511941,2,2,0
12495774@N02,218,29,1195511941,1195511941,1,2,0
12495774@N02,219,3,1195597528,1195597528,1,5,0
12495774@N02,219,4,1195597528,1195597528,1,5,0
12495774@N02,219,7,1195597528,1195597528,1,5,0
12495774@N02,219,9,1195597528,1195597528,1,5,0
12495774@N02,219,29,1195597528,1195597528,1,5,0
12495774@N02,220,3,1196988544,1196988544,1,1,0
12495774@N02,221,29,1202597473,1202597473,1,1,0
12495774@N02,222,1,1334037456,1334037456,1,5,0
12495774@N02,222,3,1334033485,1334034081,3,5,596
12495774@N02,222,9,1334020886,1334022939,3,5,2053
12495774@N02,222,15,1334039108,1334039108,1,5,0
12495774@N02,222,18,1334039597,1334039597,1,5,0
12495774@N02,223,2,1334111748,1334122172,6,2,10424
12495774@N02,223,4,1334104521,1334104521,1,2,0
12495774@N02,224,18,1334190232,1334190232,1,1,0
12495774@N02,225,9,1334280246,1334280246,1,1,0
12531656@N00,226,18,1282125180,1282125180,1,1,0
12531656@N00,227,16,1283575193,1283575193,1,1,0
12614773@N07,228,17,1243162718,1243162718,1,1,0
12658277@N00,229,1,1079116830,1079125734,12,4,8904
12658277@N00,229,8,1079111642,1079113940,8,4,2298
12658277@N00,229,9,1079127351,1079127351,1,4,0
12658277@N00,229,11,1079131562,1079132583,9,4,1021
12658277@N00,230,9,1276592067,1276594352,2,1,2285
12658277@N00,231,1,1276638484,1276658042,10,1,19558
12658277@N00,232,23,1276737814,1276741718,3,1,3904
12697623@N06,233,19,1187431589,1187431589,1,1,0
12698489@N00,234,18,1312864234,1312864234,1,2,0
12698489@N00,234,19,1312863491,1312863491,1,2,0
12698489@N00,235,9,1312970494,1312970494,1,1,0
12698489@N00,236,9,1313038522,1313038522,1,1,0
12771303@N00,237,3,1087611470,1087611470,1,1,0
12771303@N00,238,4,1088371194,1088372796,2,2,1602
12771303@N00,238,24,1088372380,1088372380,1,2,0
12771303@N00,239,18,1088833108,1088833108,1,1,0
12771303@N00,240,4,1099876414,1099876414,1,4,0
12771303@N00,240,11,1099875841,1099875841,1,4,0
12771303@N00,240,12,1099876026,1099876026,1,4,0
12771303@N00,240,24,1099876378,1099876378,1,4,0
12771303@N00,241,1,1106978366,1106978366,1,1,0
12771303@N00,242,24,1108934527,1108934527,1,1,0
12771303@N00,243,4,1109989234,1109989234,1,1,0
12771303@N00,244,29,1111662706,1111662706,1,1,0
12771303@N00,245,3,1111794865,1111794865,1,1,0
12771303@N00,246,2,1115511711,1115511711,1,2,0
12771303@N00,246,24,1115511480,1115511490,2,2,10
12771303@N00,247,15,1148852193,1148852193,1,1,0
12771303@N00,248,4,1155358241,1155358721,2,2,480
12771303@N00,248,24,1155356666,1155360465,10,2,3799
12771303@N00,249,3,1167552406,1167557711,4,1,5305
12771303@N00,250,23,1197867799,1197867940,2,1,141
12771303@N00,251,4,1201328645,1201330049,3,2,1404
12771303@N00,251,24,1201328051,1201328121,2,2,70
12771303@N00,252,4,1202001741,1202001741,1,2,0
12771303@N00,252,24,1201999145,1201999154,2,2,9
12771303@N00,253,3,1202091414,1202091414,1,1,0
12771303@N00,254,9,1238745822,1238745822,1,1,0
12771303@N00,255,9,1358146570,1358146708,3,1,138
12793495@N05,256,8,1230588345,1230588345,1,1,0
12793495@N05,257,3,1233104717,1233104717,1,1,0
12915821@N00,258,1,1053826874,1053840046,7,1,13172
12917962@N00,259,9,1376646743,1376646760,2,1,17
12917962@N00,260,3,1376710767,1376710853,2,4,86
12917962@N00,260,13,1376712468,1376712468,1,4,0
12917962@N00,260,15,1376710751,1376710751,1,4,0
12917962@N00,260,16,1376726478,1376726478,1,4,0
12917962@N00,261,13,1376790301,1376790301,1,1,0
12930951@N07,262,15,1315645023,1315645759,2,1,736
12930951@N07,263,2,1329016582,1329021246,12,1,4664
12930951@N07,264,8,1332658849,1332658868,2,2,19
12930951@N07,264,15,1332659087,1332659948,5,2,861
12930951@N07,265,8,1333708461,1333708524,2,3,63
12930951@N07,265,16,1333708902,1333708927,2,3,25
12930951@N07,265,19,1333708076,1333708320,2,3,244
12982579@N00,266,8,1347857119,1347857119,1,6,0
12982579@N00,266,9,1347870088,1347876420,16,6,6332
12982579@N00,266,16,1347857333,1347857352,2,6,19
12982579@N00,266,19,1347876823,1347883694,11,6,6871
12982579@N00,266,23,1347866280,1347868840,10,6,2560
12982579@N00,266,29,1347869255,1347870040,5,6,785
13016459@N08,267,17,1191790570,1191790570,1,3,0
13016459@N08,267,19,1191790081,1191790347,4,3,266
13016459@N08,267,23,1191788446,1191788446,1,3,0
13081891@N02,268,24,1368943949,1368944145,2,1,196
13326386@N00,269,9,1219386485,1219386697,2,1,212
13359264@N00,270,1,1327019036,1327025972,3,2,6936
13359264@N00,270,9,1327027831,1327027833,2,2,2
13379143@N00,271,13,1164901593,1164901593,1,1,0
13379143@N00,272,28,1301898228,1301898228,1,1,0
13518023@N03,273,3,1368849724,1368849724,1,1,0
13518023@N03,274,1,1368929340,1368931148,3,3,1808
13518023@N03,274,24,1368944269,1368944269,1,3,0
13518023@N03,274,29,1368926676,1368926680,2,3,4
13518023@N03,275,1,1396769086,1396769086,1,7,0
13518023@N03,275,3,1396751051,1396757307,18,7,6256
13518023@N03,275,8,1396765389,1396765389,1,7,0
13518023@N03,275,16,1396768156,1396768233,5,7,77
13518023@N03,275,19,1396764144,1396764182,3,7,38
13518023@N03,275,28,1396757372,1396757619,6,7,247
13518023@N03,275,29,1396768888,1396769752,4,7,864
13518023@N03,276,28,1396825580,1396825592,3,1,12
13518023@N03,277,15,1396929432,1396929436,2,1,4
13531471@N02,278,15,1359708377,1359708382,2,1,5
13630479@N04,279,17,1310698451,1310698451,1,1,0
13839209@N00,280,4,1208091015,1208091021,2,2,6
13839209@N00,280,10,1208080984,1208086176,3,2,5192
13897419@N02,281,18,1067313600,1067313600,1,1,0
13996991@N07,282,10,1333176728,1333177724,3,4,996
13996991@N07,282,15,1333171441,1333182077,2,4,10636
13996991@N07,282,19,1333175044,1333175044,1,4,0
13996991@N07,282,23,1333176925,1333176925,1,4,0
13996991@N07,283,1,1333238539,1333249334,15,2,10795
13996991@N07,283,29,1333249895,1333250028,2,2,133
13996991@N07,284,1,1333350880,1333350880,1,4,0
13996991@N07,284,3,1333345732,1333346195,5,4,463
13996991@N07,284,9,1333329846,1333349389,11,4,19543
13996991@N07,284,29,1333334531,1333357370,7,4,22839
13998657@N02,285,14,1382497167,1382497167,1,1,0
14057878@N00,286,11,1114858665,1114858665,1,1,0
14057878@N00,287,11,1115647873,1115647992,10,1,119
14057878@N00,288,1,1125833223,1125834389,7,1,1166
14057878@N00,289,8,1133864219,1133864688,7,1,469
14057878@N00,290,28,1136093184,1136093184,1,1,0
14057878@N00,291,18,1157281469,1157283938,58,1,2469
14057878@N00,292,3,1162270632,1162270632,1,2,0
14057878@N00,292,23,1162270630,1162270630,1,2,0
14057878@N00,293,12,1168497883,1168497909,4,1,26
14057878@N00,294,12,1192604032,1192604032,1,2,0
14057878@N00,294,15,1192606374,1192606510,3,2,136
14057878@N00,295,3,1192849613,1192849613,1,1,0
14057878@N00,296,17,1194958303,1194958763,70,1,460
14057878@N00,297,14,1203742135,1203742135,1,1,0
14057878@N00,298,17,1203827849,1203828129,5,2,280
14057878@N00,298,28,1203827311,1203827311,1,2,0
14057878@N00,299,20,1204188392,1204192572,35,1,4180
14057878@N00,300,16,1208673025,1208673025,1,1,0
14057878@N00,301,13,1211015133,1211032436,6,1,17303
14057878@N00,302,16,1211616299,1211616614,2,2,315
14057878@N00,302,29,1211618119,1211618119,1,2,0
14057878@N00,303,19,1215003083,1215005194,29,1,2111
14057878@N00,304,15,1217661220,1217664662,8,1,3442
14057878@N00,305,13,1217757079,1217757114,2,2,35
14057878@N00,305,15,1217738819,1217740264,2,2,1445
14057878@N00,306,3,1218270698,1218270856,2,2,158
14057878@N00,306,17,1218270585,1218270667,2,2,82
14057878@N00,307,13,1218346072,1218346679,2,1,607
14057878@N00,308,3,1218539030,1218539322,4,2,292
14057878@N00,308,13,1218539554,1218539554,1,2,0
14057878@N00,309,18,1218621119,1218622516,8,2,1397
14057878@N00,309,29,1218623250,1218623280,2,2,30
14057878@N00,310,12,1218717884,1218718310,2,1,426
14057878@N00,311,3,1218804384,1218804384,1,3,0
14057878@N00,311,9,1218804029,1218804029,1,3,0
14057878@N00,311,29,1218801476,1218803828,6,3,2352
14057878@N00,312,11,1218850184,1218850184,1,2,0
14057878@N00,312,19,1218841990,1218887981,19,2,45991
14057878@N00,313,19,1218971256,1218971256,1,1,0
14057878@N00,314,19,1219290781,1219291841,42,1,1060
14057878@N00,315,18,1220180823,1220183625,50,1,2802
14057878@N00,316,8,1224559393,1224563244,7,4,3851
14057878@N00,316,13,1224592852,1224596074,6,4,3222
14057878@N00,316,15,1224565059,1224565207,2,4,148
14057878@N00,316,18,1224566509,1224568683,10,4,2174
14057878@N00,317,9,1224652564,1224652564,1,4,0
14057878@N00,317,17,1224659441,1224659441,1,4,0
14057878@N00,317,28,1224649467,1224649467,1,4,0
14057878@N00,317,29,1224650747,1224652309,2,4,1562
14057878@N00,318,9,1230796481,1230802826,19,1,6345
14057878@N00,319,8,1234601471,1234601471,1,1,0
14057878@N00,320,3,1238818184,1238818847,6,1,663
14057878@N00,321,20,1240643972,1240644001,2,1,29
14057878@N00,322,12,1241097203,1241097203,1,1,0
14057878@N00,323,12,1241180499,1241182609,10,1,2110
14057878@N00,324,12,1241232949,1241269630,9,1,36681
14057878@N00,325,12,1241327056,1241366780,8,1,39724
14057878@N00,326,9,1245841992,1245841992,1,2,0
14057878@N00,326,29,1245842079,1245842836,17,2,757
14057878@N00,327,19,1248439485,1248442104,57,1,2619
14057878@N00,328,17,1251293033,1251301374,95,1,8341
14057878@N00,329,11,1253942632,1253942632,1,1,0
14057878@N00,330,11,1254143100,1254143100,1,1,0
14057878@N00,331,11,1254230270,1254230270,1,1,0
14057878@N00,332,12,1267250103,1267250103,1,1,0
14057878@N00,333,12,1288347531,1288347531,1,1,0
14057878@N00,334,12,1300000636,1300000636,3,1,0
14057878@N00,335,12,1300062891,1300062891,1,1,0
14057878@N00,336,12,1301622291,1301622291,1,1,0
14057878@N00,337,12,1302407503,1302407503,2,1,0
14057878@N00,338,19,1308909023,1308915567,68,1,6544
14057878@N00,339,3,1310625945,1310625945,1,2,0
14057878@N00,339,9,1310623259,1310623259,1,2,0
14057878@N00,340,3,1312001006,1312001006,1,1,0
14057878@N00,341,9,1316917219,1316918430,8,1,1211
14057878@N00,342,12,1366969454,1366988031,31,1,18577
14057878@N00,343,12,1367423775,1367423775,1,1,0
14060303@N05,344,1,1341285952,1341285952,1,2,0
14060303@N05,344,19,1341263334,1341263334,1,2,0
14084937@N03,345,1,1111468514,1111468514,1,2,0
14084937@N03,345,29,1111468320,1111471365,6,2,3045
14097066@N00,346,9,1305598113,1305598113,1,1,0
14113765@N00,347,1,1063076387,1063076387,1,1,0
14120346@N05,348,21,1185808827,1185808827,1,1,0
14146962@N07,349,1,1033071069,1033071086,2,3,17
14146962@N07,349,8,1033069584,1033069584,1,3,0
14146962@N07,349,29,1033071079,1033071079,1,3,0
14146962@N07,350,7,1033855626,1033855626,1,1,0
14146962@N07,351,7,1171663400,1171663520,2,1,120
14146962@N07,352,18,1171755037,1171755037,1,1,0
14146962@N07,353,1,1171823401,1171824361,4,1,960
14196341@N08,354,1,1301560695,1301560695,1,2,0
14196341@N08,354,8,1301562313,1301562313,1,2,0
14196341@N08,355,29,1301616523,1301616684,2,1,161
14196341@N08,356,17,1301720916,1301720916,1,2,0
14196341@N08,356,18,1301713863,1301713863,1,2,0
14197131@N05,357,14,1275534275,1275534275,1,2,0
14197131@N05,357,18,1275515666,1275515794,6,2,128
14197131@N05,358,1,1275593513,1275607966,168,2,14453
14197131@N05,358,29,1275593057,1275593321,6,2,264
14228046@N03,359,9,1255074881,1255076428,3,1,1547
14228046@N03,360,9,1255173231,1255173231,1,2,0
14228046@N03,360,29,1255149009,1255150390,3,2,1381
14228046@N03,361,29,1257332631,1257332631,1,1,0
14280458@N05,362,1,1088604000,1088604000,1,1,0
14309459@N00,363,1,1287720817,1287720817,1,1,0
14340225@N03,364,3,1123681266,1123681867,4,1,601
14360576@N06,365,1,1346475371,1346501503,2,12,26132
14360576@N06,365,3,1346495838,1346495838,1,12,0
14360576@N06,365,8,1346482472,1346482668,2,12,196
14360576@N06,365,9,1346476391,1346501018,5,12,24627
14360576@N06,365,10,1346479811,1346480012,4,12,201
14360576@N06,365,11,1346478829,1346478874,3,12,45
14360576@N06,365,12,1346475229,1346475245,2,12,16
14360576@N06,365,15,1346482847,1346483348,5,12,501
14360576@N06,365,17,1346477155,1346477155,1,12,0
14360576@N06,365,18,1346483676,1346483676,1,12,0
14360576@N06,365,23,1346478784,1346479549,4,12,765
14360576@N06,365,29,1346475892,1346497473,4,12,21581
14360576@N06,366,7,1346547373,1346548289,8,3,916
14360576@N06,366,20,1346561523,1346561904,2,3,381
14360576@N06,366,21,1346557633,1346557781,2,3,148
14360576@N06,367,15,1346673248,1346673248,1,2,0
14360576@N06,367,18,1346672698,1346672698,1,2,0
14360576@N06,368,9,1346763468,1346763468,1,3,0
14360576@N06,368,14,1346727876,1346727876,1,3,0
14360576@N06,368,24,1346751272,1346751351,3,3,79
14360576@N06,369,14,1346804730,1346837696,16,1,32966
14360576@N06,370,9,1346937857,1346938800,5,8,943
14360576@N06,370,10,1346934436,1346935236,4,8,800
14360576@N06,370,12,1346926380,1346926380,1,8,0
14360576@N06,370,14,1346909589,1346917891,6,8,8302
14360576@N06,370,19,1346933073,1346933073,1,8,0
14360576@N06,370,22,1346927041,1346927041,1,8,0
14360576@N06,370,23,1346934008,1346936632,4,8,2624
14360576@N06,370,29,1346939111,1346939111,1,8,0
14360576@N06,371,9,1346996372,1346996372,1,4,0
14360576@N06,371,15,1346994541,1346994541,1,4,0
14360576@N06,371,19,1346995396,1346998766,6,4,3370
14360576@N06,371,29,1346997436,1346997549,3,4,113
14527198@N00,372,9,1262165596,1262166829,3,1,1233
14578360@N00,373,4,1194665894,1194665894,1,2,0
14578360@N00,373,24,1194665739,1194665739,1,2,0
14592086@N08,374,1,1388209938,1388209938,1,2,0
14592086@N08,374,19,1388210110,1388210110,1,2,0
14607519@N07,375,9,1282806330,1282814512,3,1,8182
14607519@N07,376,9,1282874836,1282874836,1,1,0
14631845@N05,377,9,1352529123,1352529123,1,1,0
14631845@N05,378,3,1352593072,1352593072,1,2,0
14631845@N05,378,9,1352595968,1352598184,8,2,2216
14683455@N00,379,9,1248052269,1248053028,11,1,759
14683455@N00,380,9,1281320475,1281321859,31,1,1384
14683455@N00,381,9,1281581587,1281586130,33,1,4543
14683455@N00,382,9,1281665582,1281669761,66,1,4179
14683455@N00,383,9,1281759601,1281761082,14,1,1481
14683455@N00,384,24,1311566117,1311566117,1,1,0
14707646@N05,385,29,1199660623,1199660623,1,1,0
14711846@N00,386,10,1310545581,1310546076,5,3,495
14711846@N00,386,11,1310546048,1310546048,1,3,0
14711846@N00,386,15,1310547531,1310547531,1,3,0
14711846@N00,387,1,1310600997,1310609026,18,8,8029
14711846@N00,387,2,1310619789,1310625952,4,8,6163
14711846@N00,387,4,1310618103,1310619244,2,8,1141
14711846@N00,387,8,1310610123,1310610174,2,8,51
14711846@N00,387,9,1310599998,1310609421,3,8,9423
14711846@N00,387,17,1310600391,1310600391,1,8,0
14711846@N00,387,19,1310598881,1310599010,2,8,129
14711846@N00,387,29,1310609918,1310609918,1,8,0
14711846@N00,388,8,1310950894,1310950894,1,1,0
14761813@N00,389,19,1136953081,1136953081,1,1,0
14761813@N00,390,16,1145257201,1145257201,1,1,0
14761813@N00,391,14,1148255799,1148261136,3,1,5337
14761813@N00,392,14,1148338254,1148338254,1,1,0
14761813@N00,393,1,1148461306,1148469665,12,1,8359
14761813@N00,394,8,1148627642,1148627812,5,2,170
14761813@N00,394,19,1148626441,1148626441,1,2,0
14829735@N00,395,7,1154145541,1154145541,1,2,0
14829735@N00,395,29,1154161921,1154164629,5,2,2708
14829735@N00,396,14,1347974435,1347974435,1,1,0
14843938@N06,397,3,1336900208,1336900208,1,1,0
14869313@N00,398,2,1148085649,1148085649,1,3,0
14869313@N00,398,4,1148085538,1148085538,1,3,0
14869313@N00,398,15,1148081801,1148081933,2,3,132
14878709@N00,399,15,1324429169,1324429177,2,1,8
14900985@N07,400,3,1307419620,1307419620,1,1,0
14900985@N07,401,29,1377170489,1377179770,25,1,9281
14902480@N02,402,13,1295912455,1295912455,1,1,0
14902480@N02,403,13,1295994868,1295994946,2,2,78
14902480@N02,403,28,1296016074,1296016074,1,2,0
14915235@N00,404,3,1130332952,1130332952,1,1,0
14915235@N00,405,18,1157278079,1157278861,3,1,782
14915235@N00,406,8,1169866087,1169866087,1,1,0
14915235@N00,407,12,1255231462,1255231462,1,1,0
14915235@N00,408,9,1259374839,1259379311,5,2,4472
14915235@N00,408,29,1259373273,1259373302,2,2,29
14915235@N00,409,3,1271233657,1271233657,1,1,0
14915235@N00,410,3,1271552930,1271552930,1,1,0
14915235@N00,411,3,1327199300,1327199374,2,3,74
14915235@N00,411,9,1327198696,1327198696,1,3,0
14915235@N00,411,12,1327198118,1327204010,2,3,5892
14929150@N08,412,29,1203529944,1203529962,4,1,18
15042961@N00,413,1,1286329603,1286329735,2,1,132
15042961@N00,414,16,1286442349,1286442349,1,1,0
15042961@N00,415,1,1289133186,1289133186,1,1,0
15058166@N06,416,9,1248760254,1248760254,1,1,0
15058166@N06,417,9,1280407084,1280407084,1,1,0
15086444@N00,418,1,1314922854,1314932325,13,1,9471
15097772@N08,419,19,1242024329,1242025309,5,1,980
15256562@N00,420,20,1347073590,1347075894,6,1,2304
15256562@N00,421,9,1392512832,1392512832,1,1,0
15297910@N00,422,7,1346537116,1346537116,1,1,0
15373853@N00,423,4,1349755425,1349755425,1,1,0
15373853@N00,424,24,1349926644,1349926644,1,1,0
15373853@N00,425,1,1350542879,1350542879,1,1,0
15373853@N00,426,24,1350643517,1350643517,1,1,0
15373853@N00,427,11,1350683141,1350683141,1,1,0
15373853@N00,428,12,1351152431,1351152431,1,1,0
15373853@N00,429,20,1351314011,1351314011,1,1,0
15373853@N00,430,20,1351479462,1351479462,1,1,0
15373853@N00,431,24,1352445988,1352445988,1,1,0
15373853@N00,432,8,1352606597,1352606597,1,1,0
15373853@N00,433,8,1354364739,1354364739,1,2,0
15373853@N00,433,19,1354364368,1354364368,1,2,0
15373853@N00,434,16,1354842963,1354842963,1,1,0
15373853@N00,435,11,1360286127,1360286127,1,2,0
15373853@N00,435,23,1360286339,1360286339,1,2,0
15373853@N00,436,12,1369446973,1369446973,1,1,0
15452495@N00,437,14,1148341506,1148341506,1,1,0
15462727@N07,438,1,1301013167,1301025950,12,7,12783
15462727@N07,438,3,1301018861,1301019577,6,7,716
15462727@N07,438,8,1301012153,1301028491,33,7,16338
15462727@N07,438,9,1301019845,1301020704,9,7,859
15462727@N07,438,15,1301012607,1301027400,31,7,14793
15462727@N07,438,18,1301012554,1301026051,10,7,13497
15462727@N07,438,19,1301021385,1301022231,11,7,846
15541961@N07,439,8,1262292978,1262292978,1,1,0
15545969@N06,440,19,1251337210,1251337532,11,1,322
15545969@N06,441,13,1345278166,1345278166,1,1,0
15545969@N06,442,29,1375757199,1375757199,1,1,0
15545969@N06,443,29,1375838135,1375850103,5,1,11968
15545969@N06,444,3,1376061681,1376061917,2,2,236
15545969@N06,444,13,1376037983,1376050667,2,2,12684
15584779@N00,445,15,1296018738,1296018738,1,1,0
15786211@N00,446,1,1376829001,1376829001,1,3,0
15786211@N00,446,3,1376848273,1376851920,2,3,3647
15786211@N00,446,16,1376843908,1376843908,1,3,0
15879717@N00,447,1,1324347141,1324347141,1,2,0
15879717@N00,447,3,1324336895,1324337420,3,2,525
16048448@N00,448,15,1058944796,1058951428,4,1,6632
16048448@N00,449,1,1059009520,1059022608,15,6,13088
16048448@N00,449,8,1059036123,1059036123,1,6,0
16048448@N00,449,9,1059024227,1059024668,4,6,441
16048448@N00,449,15,1059036374,1059045896,2,6,9522
16048448@N00,449,19,1059034051,1059034445,3,6,394
16048448@N00,449,29,1059008672,1059023548,5,6,14876
16048448@N00,450,7,1059116600,1059117113,7,4,513
16048448@N00,450,10,1059099615,1059100982,6,4,1367
16048448@N00,450,11,1059100075,1059100231,3,4,156
16048448@N00,450,18,1059109198,1059109198,1,4,0
16048448@N00,451,8,1059305694,1059305694,1,2,0
16048448@N00,451,18,1059298168,1059298168,1,2,0
16056465@N00,452,16,1320970777,1320970777,1,1,0
16056465@N00,453,3,1321056869,1321056981,2,1,112
16177445@N00,454,24,1169337702,1169337702,1,1,0
16190595@N05,455,9,1343969665,1343969665,1,1,0
16190595@N05,456,9,1344738307,1344739492,2,1,1185
16190595@N05,457,9,1345428361,1345431541,3,1,3180
16190595@N05,458,9,1375322678,1375329447,4,1,6769
16190595@N05,459,9,1375407407,1375428789,10,1,21382
16190595@N05,460,9,1375499418,1375520466,22,2,21048
16190595@N05,460,29,1375500212,1375500212,1,2,0
16190595@N05,461,9,1375675680,1375682964,10,1,7284
16190595@N05,462,9,1375764776,1375773075,23,1,8299
16190595@N05,463,9,1375839536,1375840037,4,1,501
16190595@N05,464,9,1376010852,1376017922,20,3,7070
16190595@N05,464,17,1376009992,1376009992,1,3,0
16190595@N05,464,29,1376011649,1376011649,1,3,0
16190595@N05,465,9,1376273391,1376284322,15,1,10931
16190595@N05,466,9,1376363427,1376379198,8,1,15771
16190595@N05,467,9,1376619777,1376638697,8,1,18920
16190595@N05,468,9,1376882813,1376890719,8,1,7906
16190595@N05,469,9,1376964526,1376967671,8,1,3145
16190595@N05,470,9,1377052549,1377054826,4,2,2277
16190595@N05,470,17,1377052310,1377052310,1,2,0
16231283@N08,471,8,1197361902,1197361902,1,1,0
16231283@N08,472,8,1197450810,1197454097,20,1,3287
16231283@N08,473,8,1197621263,1197621585,6,1,322
16231283@N08,474,8,1197955069,1197955069,1,1,0
16231283@N08,475,8,1198151492,1198151510,2,1,18
16261194@N00,476,1,1185599278,1185607253,40,2,7975
16261194@N00,476,29,1185598156,1185609147,3,2,10991
16261194@N00,477,18,1197245209,1197245209,1,2,0
16261194@N00,477,22,1197251666,1197251666,1,2,0
16312054@N06,478,29,1249976628,1249983074,8,1,6446
16431396@N00,479,29,1254996456,1254996456,1,1,0
16497759@N07,480,8,1313905341,1313905341,1,2,0
16497759@N07,480,29,1313903955,1313903955,1,2,0
16497759@N07,481,4,1313976182,1313977857,2,4,1675
16497759@N07,481,9,1313981177,1313981177,1,4,0
16497759@N07,481,22,1313986193,1313986257,2,4,64
16497759@N07,481,24,1313976192,1313976192,1,4,0
16523911@N06,482,19,1340761169,1340761169,1,1,0
16699584@N02,483,16,1275711611,1275711611,1,1,0
16699584@N02,484,16,1396070544,1396070544,1,1,0
16818309@N05,485,19,1219091543,1219091543,1,1,0
16857543@N07,486,1,1260516988,1260516988,1,1,0
16857543@N07,487,28,1260687080,1260688570,21,1,1490
16857543@N07,488,11,1262076312,1262076312,1,1,0
16912628@N03,489,27,1376186653,1376186653,1,1,0
16964259@N00,490,15,1397706007,1397706007,1,1,0
17098929@N00,491,17,1310537262,1310537262,1,1,0
17098929@N00,492,13,1310801682,1310801682,1,1,0
17098929@N00,493,13,1310863364,1310863364,1,1,0
17098929@N00,494,15,1374586862,1374586862,1,1,0
17098929@N00,495,8,1374677163,1374677163,1,1,0
17151040@N00,496,8,1385767862,1385767862,1,2,0
17151040@N00,496,18,1385785206,1385785268,2,2,62
17306001@N00,497,28,1281664901,1281664912,2,1,11
17306001@N00,498,3,1281768911,1281769191,2,2,280
17306001@N00,498,18,1281766347,1281766685,2,2,338
17306001@N00,499,4,1347610950,1347610950,1,1,0
17306001@N00,500,27,1347677688,1347715677,12,1,37989
17306001@N00,501,8,1359711614,1359711614,1,1,0
17358831@N00,502,4,1237512788,1237520152,11,1,7364
17358831@N00,503,4,1270107919,1270109777,4,1,1858
17358831@N00,504,4,1305242684,1305242684,1,1,0
17374073@N00,505,8,1146618995,1146618995,1,1,0
17374073@N00,506,8,1193704375,1193722488,3,1,18113
17424601@N00,507,8,1182585922,1182585922,1,3,0
17424601@N00,507,15,1182586149,1182586149,1,3,0
17424601@N00,507,18,1182580842,1182580842,1,3,0
17424601@N00,508,9,1182659884,1182659884,1,1,0
17431309@N00,509,17,1072995972,1072995972,1,1,0
17437328@N00,510,9,1213155125,1213155125,1,1,0
17505188@N06,511,15,1187652403,1187652403,1,1,0
17505188@N06,512,8,1187776527,1187776614,3,3,87
17505188@N06,512,9,1187769443,1187769443,1,3,0
17505188@N06,512,23,1187743147,1187745987,2,3,2840
17643132@N00,513,3,1310007003,1310007228,7,7,225
17643132@N00,513,9,1310003162,1310006950,34,7,3788
17643132@N00,513,11,1310002479,1310002700,7,7,221
17643132@N00,513,13,1310008252,1310008252,1,7,0
17643132@N00,513,19,1310001843,1310014534,21,7,12691
17643132@N00,513,28,1310007856,1310008493,5,7,637
17643132@N00,513,29,1310004777,1310013579,16,7,8802
17643132@N00,514,1,1310066140,1310076601,42,5,10461
17643132@N00,514,4,1310089488,1310090265,10,5,777
17643132@N00,514,9,1310084705,1310085015,5,5,310
17643132@N00,514,19,1310087091,1310087438,2,5,347
17643132@N00,514,29,1310076993,1310082563,28,5,5570
17643132@N00,515,9,1310241801,1310242704,5,1,903
17677513@N00,516,19,1261619291,1261619291,1,1,0
17677513@N00,517,19,1372420733,1372420733,1,1,0
17728900@N00,518,10,1284878740,1284878740,1,1,0
17774272@N00,519,29,1296449144,1296449144,1,1,0
17774272@N00,520,21,1296532716,1296532716,1,1,0
17908180@N00,521,9,1250881403,1250881403,1,1,0
17946351@N00,522,1,1189663753,1189663753,1,1,0
17956027@N00,523,14,1382335656,1382335656,1,1,0
17956027@N00,524,14,1382535691,1382535691,1,1,0
17956027@N00,525,3,1382615363,1382615363,1,1,0
18095953@N00,526,18,1159143472,1159143472,1,1,0
18237964@N00,527,2,1226370395,1226370395,1,2,0
18237964@N00,527,29,1226373190,1226374912,3,2,1722
18276635@N00,528,1,1147997204,1147997204,1,4,0
18276635@N00,528,9,1147997585,1148009218,2,4,11633
18276635@N00,528,17,1147990023,1147990023,1,4,0
18276635@N00,528,29,1147996539,1148030721,5,4,34182
18276635@N00,529,11,1148125189,1148125189,1,3,0
18276635@N00,529,15,1148123110,1148123110,1,3,0
18276635@N00,529,18,1148122014,1148122014,1,3,0
18276635@N00,530,15,1148154363,1148154363,1,1,0
18276635@N00,531,3,1148199235,1148200687,2,1,1452
18276635@N00,532,9,1148286704,1148286704,1,1,0
18346531@N00,533,21,1143254828,1143254919,2,1,91
18352975@N00,534,29,1123120800,1123120800,1,1,0
18352975@N00,535,29,1147577900,1147577900,1,1,0
18352975@N00,536,22,1174018964,1174018964,1,1,0
18352975@N00,537,8,1184675745,1184675745,1,1,0
18352975@N00,538,29,1198225680,1198225680,1,1,0
18352975@N00,539,15,1229255971,1229255971,1,1,0
18402635@N00,540,1,1194322595,1194323148,5,3,553
18402635@N00,540,3,1194322521,1194322521,1,3,0
18402635@N00,540,9,1194323139,1194323139,1,3,0
18502987@N00,541,19,1186965486,1186965486,1,1,0
18966576@N00,542,8,1339647392,1339647392,1,5,0
18966576@N00,542,9,1339644093,1339644747,4,5,654
18966576@N00,542,16,1339642802,1339643528,5,5,726
18966576@N00,542,18,1339641470,1339641819,4,5,349
18966576@N00,542,29,1339643560,1339644152,2,5,592
19153501@N00,543,2,1213479874,1213487280,22,4,7406
19153501@N00,543,4,1213478986,1213479854,5,4,868
19153501@N00,543,11,1213478890,1213478890,1,4,0
19153501@N00,543,23,1213477626,1213477626,1,4,0
19229064@N00,544,9,1279934146,1279934146,1,1,0
19425349@N00,545,9,1249095423,1249104345,8,2,8922
19425349@N00,545,29,1249096281,1249096820,3,2,539
19432794@N00,546,24,1249794440,1249794440,1,1,0
19432794@N00,547,14,1266540019,1266540019,1,1,0
19432794@N00,548,21,1268969808,1268969808,1,1,0
19432794@N00,549,9,1275711662,1275714176,2,1,2514
19432794@N00,550,27,1277521632,1277522105,2,1,473
19432794@N00,551,21,1325473426,1325473426,1,1,0
19432794@N00,552,8,1330327455,1330327455,1,1,0
19432794@N00,553,8,1332379392,1332379392,1,1,0
19432794@N00,554,4,1334803099,1334803511,5,1,412
19432794@N00,555,21,1335999810,1335999810,1,1,0
19432794@N00,556,21,1375595821,1375595821,1,1,0
19471305@N00,557,21,1153573440,1153573440,1,1,0
19471305@N00,558,21,1153911812,1153911812,1,1,0
19471305@N00,559,21,1154349281,1154349281,1,1,0
19471305@N00,560,21,1155007187,1155007187,1,1,0
19471305@N00,561,21,1155038298,1155038298,1,1,0
19471305@N00,562,21,1192106620,1192106620,1,1,0
19471305@N00,563,21,1192458630,1192458630,1,1,0
19471305@N00,564,18,1193552698,1193552698,1,1,0
19471305@N00,565,21,1193728098,1193728098,1,1,0
19471305@N00,566,21,1194006329,1194006329,1,1,0
19471305@N00,567,21,1198819552,1198819774,6,1,222
19471305@N00,568,21,1200059181,1200059732,2,1,551
19471305@N00,569,28,1297423356,1297423356,1,1,0
19471305@N00,570,8,1345925507,1345925507,1,1,0
19471305@N00,571,15,1360850644,1360850644,1,1,0
19471305@N00,572,9,1363615577,1363615577,1,1,0
19471305@N00,573,15,1365387362,1365387362,1,1,0
19471305@N00,574,15,1366597166,1366597166,1,1,0
19471305@N00,575,28,1391681776,1391681776,2,1,0
19473027@N00,576,12,1152504702,1152504747,4,1,45
19473027@N00,577,19,1153701103,1153701103,5,1,0
19473027@N00,578,19,1154325242,1154325242,2,1,0
19473027@N00,579,15,1154582076,1154582584,4,1,508
19473027@N00,580,19,1154912479,1154912479,1,1,0
19473027@N00,581,9,1155073930,1155073930,2,4,0
19473027@N00,581,12,1155073930,1155073930,2,4,0
19473027@N00,581,18,1155073930,1155073930,2,4,0
19473027@N00,581,19,1155074338,1155074339,3,4,1
19473027@N00,582,19,1155240580,1155240580,1,1,0
19473027@N00,583,19,1155353834,1155353834,1,1,0
19473027@N00,584,15,1159528662,1159528662,1,2,0
19473027@N00,584,22,1159535043,1159535043,3,2,0
19473027@N00,585,13,1161775205,1161775461,14,1,256
19473027@N00,586,12,1165406506,1165412271,21,1,5765
19473027@N00,587,12,1165546640,1165547206,7,1,566
19473027@N00,588,12,1166775521,1166775521,1,1,0
19473027@N00,589,23,1197333653,1197333653,1,1,0
19473027@N00,590,22,1199070591,1199070677,2,1,86
19473027@N00,591,21,1202777658,1202787114,9,1,9456
19473027@N00,592,15,1203122419,1203122539,4,1,120
19473027@N00,593,27,1203483074,1203483170,3,1,96
19473027@N00,594,14,1203916434,1203916434,1,1,0
19473027@N00,595,22,1204430242,1204430242,1,1,0
19473027@N00,596,8,1219807797,1219807797,1,1,0
19473027@N00,597,3,1226963291,1226963291,1,1,0
19473027@N00,598,15,1231426692,1231426692,1,1,0
19473027@N00,599,23,1231935792,1231935792,1,1,0
19473027@N00,600,3,1232035379,1232035379,1,1,0
19473027@N00,601,8,1234180744,1234180744,1,1,0
19473027@N00,602,3,1235380751,1235380751,1,1,0
19473027@N00,603,3,1236160471,1236182629,22,1,22158
19473027@N00,604,3,1237144568,1237144574,2,1,6
19473027@N00,605,12,1237568790,1237568795,2,1,5
19473027@N00,606,9,1237727193,1237727193,1,2,0
19473027@N00,606,17,1237724256,1237724256,1,2,0
19473027@N00,607,29,1238151014,1238151014,1,1,0
19473027@N00,608,8,1241570151,1241570151,1,1,0
19473027@N00,609,9,1242601833,1242601833,1,2,0
19473027@N00,609,17,1242601824,1242601824,1,2,0
19473027@N00,610,19,1244615469,1244615469,1,1,0
19473027@N00,611,23,1245887277,1245887277,1,1,0
19473027@N00,612,12,1248064837,1248064837,1,1,0
19473027@N00,613,18,1248142564,1248142564,1,1,0
19473027@N00,614,22,1249102354,1249102354,1,1,0
19473027@N00,615,2,1250552730,1250552730,1,1,0
19473027@N00,616,9,1250582372,1250582372,1,1,0
19473027@N00,617,12,1253227328,1253227328,1,1,0
19473027@N00,618,19,1253617488,1253617488,1,1,0
19473027@N00,619,19,1254874488,1254874488,1,1,0
19473027@N00,620,3,1256700991,1256700991,1,1,0
19473027@N00,621,9,1257832773,1257832933,2,1,160
19473027@N00,622,17,1258625185,1258625185,1,1,0
19473027@N00,623,18,1259127505,1259127527,2,1,22
19473027@N00,624,15,1259386693,1259390010,4,1,3317
19473027@N00,625,8,1260236962,1260236962,1,1,0
19473027@N00,626,8,1260848553,1260848553,1,1,0
19473027@N00,627,13,1261013841,1261021385,3,1,7544
19473027@N00,628,3,1261473175,1261473175,1,1,0
19473027@N00,629,28,1264999115,1264999115,1,1,0
19473027@N00,630,15,1266048116,1266048116,1,1,0
19473027@N00,631,28,1267159904,1267160994,2,1,1090
19473027@N00,632,14,1267251248,1267251248,1,1,0
19473027@N00,633,17,1269222142,1269222142,1,1,0
19473027@N00,634,29,1269332985,1269332985,1,1,0
19473027@N00,635,19,1269395211,1269395211,1,1,0
19473027@N00,636,3,1269665149,1269665149,1,1,0
19473027@N00,637,27,1270703729,1270703729,1,1,0
19473027@N00,638,17,1271314863,1271314863,1,1,0
19473027@N00,639,19,1271564891,1271564891,1,1,0
19473027@N00,640,9,1271827968,1271827977,2,1,9
19473027@N00,641,8,1272089062,1272094864,3,2,5802
19473027@N00,641,15,1272088841,1272095097,2,2,6256
19473027@N00,642,15,1272263510,1272267868,11,2,4358
19473027@N00,642,18,1272263617,1272263629,2,2,12
19473027@N00,643,8,1272338074,1272338074,1,1,0
19473027@N00,644,9,1272694347,1272694347,1,3,0
19473027@N00,644,15,1272693700,1272693935,2,3,235
19473027@N00,644,16,1272694072,1272694072,1,3,0
19473027@N00,645,9,1272956382,1272956382,1,1,0
19473027@N00,646,3,1273197978,1273198152,4,2,174
19473027@N00,646,19,1273198340,1273198340,1,2,0
19473027@N00,647,3,1277709427,1277709427,1,2,0
19473027@N00,647,9,1277706731,1277706731,1,2,0
19473027@N00,648,19,1278137436,1278137483,2,1,47
19473027@N00,649,13,1278214430,1278214430,1,1,0
19473027@N00,650,22,1279608678,1279608678,1,1,0
19473027@N00,651,12,1280553202,1280553202,1,1,0
19473027@N00,652,16,1280651197,1280651197,1,3,0
19473027@N00,652,19,1280646240,1280648874,4,3,2634
19473027@N00,652,29,1280650463,1280650775,2,3,312
19473027@N00,653,28,1283064703,1283064703,1,1,0
19473027@N00,654,14,1283318814,1283318814,1,1,0
19473027@N00,655,14,1283399496,1283399570,2,1,74
19473027@N00,656,12,1283474164,1283492780,15,1,18616
19473027@N00,657,12,1286088813,1286088822,2,2,9
19473027@N00,657,14,1286088945,1286089030,2,2,85
19473027@N00,658,27,1287206999,1287207787,5,1,788
19473027@N00,659,19,1289113717,1289113717,1,1,0
19473027@N00,660,22,1290310943,1290310967,2,1,24
19473027@N00,661,3,1290822490,1290822490,1,2,0
19473027@N00,661,13,1290822731,1290822731,1,2,0
19473027@N00,662,3,1291352525,1291352525,1,2,0
19473027@N00,662,19,1291354212,1291354212,1,2,0
19473027@N00,663,28,1291688165,1291691771,2,1,3606
19473027@N00,664,15,1293077811,1293077811,1,2,0
19473027@N00,664,18,1293073708,1293073708,1,2,0
19473027@N00,665,23,1294361252,1294361252,1,1,0
19473027@N00,666,22,1301463615,1301463615,1,1,0
19473027@N00,667,23,1302140162,1302140833,2,1,671
19473027@N00,668,12,1303803000,1303803000,1,1,0
19473027@N00,669,8,1305953040,1305953040,1,1,0
19473027@N00,670,19,1306805715,1306805715,1,1,0
19473027@N00,671,12,1307071911,1307071911,1,1,0
19473027@N00,672,8,1307415518,1307415597,2,4,79
19473027@N00,672,9,1307416194,1307416194,1,4,0
19473027@N00,672,16,1307415886,1307415886,1,4,0
19473027@N00,672,29,1307415896,1307415896,1,4,0
19473027@N00,673,9,1307921584,1307921620,2,1,36
19473027@N00,674,3,1308552701,1308552701,1,1,0
19473027@N00,675,12,1309501966,1309501966,1,1,0
19473027@N00,676,18,1309859725,1309859725,1,1,0
19473027@N00,677,19,1310281246,1310281246,1,2,0
19473027@N00,677,23,1310281703,1310281703,1,2,0
19473027@N00,678,28,1310444533,1310444533,1,1,0
19473027@N00,679,28,1310705264,1310705343,2,1,79
19473027@N00,680,8,1310793459,1310793459,1,3,0
19473027@N00,680,9,1310793728,1310793728,1,3,0
19473027@N00,680,19,1310792248,1310792884,3,3,636
19473027@N00,681,27,1310879876,1310879906,2,1,30
19473027@N00,682,9,1311046309,1311046309,1,3,0
19473027@N00,682,19,1311046932,1311047110,4,3,178
19473027@N00,682,23,1311047129,1311047129,1,3,0
19473027@N00,683,3,1311140261,1311140546,2,1,285
19473027@N00,684,22,1311577659,1311577659,1,1,0
19473027@N00,685,19,1311749900,1311749900,1,1,0
19473027@N00,686,19,1311810403,1311810403,1,1,0
19473027@N00,687,22,1312522131,1312522131,1,1,0
19473027@N00,688,17,1312868801,1312868801,1,1,0
19473027@N00,689,12,1313564065,1313564065,1,2,0
19473027@N00,689,22,1313563808,1313563808,1,2,0
19473027@N00,690,13,1313825356,1313825356,1,4,0
19473027@N00,690,17,1313826683,1313826711,2,4,28
19473027@N00,690,19,1313825081,1313825081,1,4,0
19473027@N00,690,28,1313826309,1313826352,2,4,43
19473027@N00,691,12,1315118953,1315119023,4,4,70
19473027@N00,691,14,1315119081,1315120011,18,4,930
19473027@N00,691,22,1315118680,1315118680,1,4,0
19473027@N00,691,28,1315110925,1315111305,8,4,380
19473027@N00,692,29,1315366125,1315366125,1,1,0
19473027@N00,693,19,1315529840,1315529840,1,1,0
19473027@N00,694,8,1315983820,1315983820,1,3,0
19473027@N00,694,16,1315984045,1315984045,1,3,0
19473027@N00,694,19,1315983765,1315983797,2,3,32
19473027@N00,695,15,1316240578,1316245757,11,3,5179
19473027@N00,695,18,1316245840,1316245955,6,3,115
19473027@N00,695,29,1316240412,1316240548,3,3,136
19473027@N00,696,16,1317449025,1317449237,2,1,212
19473027@N00,697,14,1317537378,1317537378,1,1,0
19473027@N00,698,3,1318569281,1318569281,1,1,0
19473027@N00,699,22,1320388418,1320388418,1,1,0
19473027@N00,700,3,1320542147,1320542147,1,2,0
19473027@N00,700,19,1320562667,1320562778,4,2,111
19473027@N00,701,8,1321169794,1321169794,1,4,0
19473027@N00,701,15,1321169212,1321169346,7,4,134
19473027@N00,701,19,1321170464,1321170491,3,4,27
19473027@N00,701,28,1321160638,1321171306,2,4,10668
19473027@N00,702,15,1321854015,1321854015,1,3,0
19473027@N00,702,18,1321851194,1321851223,3,3,29
19473027@N00,702,29,1321854260,1321854465,3,3,205
19473027@N00,703,15,1322028850,1322029168,6,1,318
19473027@N00,704,15,1322540639,1322540733,4,1,94
19473027@N00,705,8,1322804808,1322804888,4,3,80
19473027@N00,705,15,1322804917,1322805029,9,3,112
19473027@N00,705,18,1322805119,1322805173,2,3,54
19473027@N00,706,15,1322973391,1322978811,8,2,5420
19473027@N00,706,18,1322973224,1322979659,5,2,6435
19473027@N00,707,3,1323148353,1323148353,1,2,0
19473027@N00,707,15,1323147915,1323147915,1,2,0
19473027@N00,708,8,1323412906,1323412906,1,2,0
19473027@N00,708,15,1323413142,1323413428,9,2,286
19473027@N00,709,15,1324272226,1324272452,3,1,226
19473027@N00,710,15,1324702525,1324702525,1,1,0
19473027@N00,711,27,1324954694,1324954694,1,1,0
19473027@N00,712,8,1325553613,1325556036,2,1,2423
19473027@N00,713,23,1326251293,1326253195,9,1,1902
19473027@N00,714,19,1327447303,1327447303,1,1,0
19473027@N00,715,3,1333013078,1333013078,1,1,0
19473027@N00,716,3,1333677844,1333677844,1,1,0
19473027@N00,717,24,1335591162,1335591495,3,1,333
19473027@N00,718,4,1338632575,1338632584,2,1,9
19473027@N00,719,24,1341379275,1341379354,3,1,79
19473027@N00,720,19,1342161902,1342162150,6,1,248
19473027@N00,721,3,1342437793,1342437897,3,1,104
19473027@N00,722,12,1344063487,1344063487,1,1,0
19473027@N00,723,3,1348467248,1348467283,3,1,35
19473027@N00,724,3,1349143665,1349143665,1,1,0
19473027@N00,725,19,1350367000,1350367000,1,1,0
19473027@N00,726,18,1351221100,1351221100,1,1,0
19473027@N00,727,3,1351488334,1351488402,5,1,68
19473027@N00,728,3,1353026414,1353026435,2,1,21
19473027@N00,729,4,1354604961,1354605488,2,1,527
19473027@N00,730,4,1358649341,1358649341,1,1,0
19473027@N00,731,3,1360027302,1360027347,2,1,45
19473027@N00,732,19,1360538803,1360538803,1,1,0
19473027@N00,733,18,1364269001,1364269001,1,1,0
19473027@N00,734,4,1367126896,1367129005,12,3,2109
19473027@N00,734,9,1367126226,1367126291,3,3,65
19473027@N00,734,29,1367126026,1367126123,3,3,97
19473027@N00,735,28,1367209512,1367219632,2,1,10120
19473027@N00,736,3,1367626279,1367626279,1,1,0
19473027@N00,737,14,1367737628,1367737785,4,1,157
19473027@N00,738,9,1368581925,1368581925,1,2,0
19473027@N00,738,19,1368578613,1368578613,1,2,0
19473027@N00,739,2,1368940695,1368940695,1,4,0
19473027@N00,739,3,1368933973,1368940123,11,4,6150
19473027@N00,739,9,1368940238,1368940399,17,4,161
19473027@N00,739,24,1368940824,1368944745,52,4,3921
19473027@N00,740,9,1370303062,1370306679,3,1,3617
19473027@N00,741,8,1370410161,1370410189,2,1,28
19473027@N00,742,9,1371594895,1371595437,2,1,542
19473027@N00,743,9,1371682776,1371686246,4,2,3470
19473027@N00,743,12,1371695986,1371697584,3,2,1598
19473027@N00,744,15,1372491397,1372491529,2,2,132
19473027@N00,744,18,1372492579,1372492579,1,2,0
19473027@N00,745,3,1373090842,1373090842,1,2,0
19473027@N00,745,28,1373090426,1373090426,1,2,0
19473027@N00,746,28,1373524507,1373524507,1,1,0
19473027@N00,747,2,1374444209,1374444628,12,2,419
19473027@N00,747,4,1374444988,1374445302,8,2,314
19473027@N00,748,3,1374813060,1374813060,1,1,0
19473027@N00,749,8,1375504155,1375504155,1,2,0
19473027@N00,749,15,1375503798,1375503798,1,2,0
19473027@N00,750,29,1375872221,1375873575,3,1,1354
19473027@N00,751,3,1375927585,1375927585,1,1,0
19473027@N00,752,15,1376202768,1376202798,2,2,30
19473027@N00,752,18,1376202987,1376202987,1,2,0
19473027@N00,753,19,1376284763,1376284763,1,1,0
19473027@N00,754,18,1376379668,1376379668,1,1,0
19473027@N00,755,3,1376627466,1376627466,1,2,0
19473027@N00,755,12,1376627865,1376627865,1,2,0
19473027@N00,756,3,1377241802,1377241802,1,2,0
19473027@N00,756,19,1377236563,1377236563,1,2,0
19473027@N00,757,29,1378357752,1378357752,1,1,0
19473027@N00,758,8,1378698065,1378698065,1,3,0
19473027@N00,758,15,1378701590,1378701590,1,3,0
19473027@N00,758,23,1378698701,1378698701,1,3,0
19473027@N00,759,15,1378938463,1378951425,46,1,12962
19473027@N00,760,19,1380682914,1380682914,1,1,0
19473027@N00,761,3,1380940042,1380944357,3,1,4315
19473027@N00,762,3,1381811940,1381811940,1,1,0
19473027@N00,763,23,1383099293,1383107889,3,1,8596
19473027@N00,764,19,1384149980,1384149980,1,1,0
19473027@N00,765,3,1384581374,1384581428,2,1,54
19473027@N00,766,29,1386411012,1386411012,1,1,0
19473027@N00,767,3,1386912816,1386912868,2,1,52
19473027@N00,768,19,1387167227,1387167227,1,1,0
19473027@N00,769,13,1389759994,1389759994,1,1,0
19473027@N00,770,12,1390363528,1390363812,11,1,284
19473027@N00,771,8,1390884167,1390884177,2,2,10
19473027@N00,771,19,1390884141,1390884141,1,2,0
19473027@N00,772,8,1390948419,1390948419,1,1,0
19473027@N00,773,8,1391246522,1391246532,5,2,10
19473027@N00,773,19,1391246146,1391253503,4,2,7357
19473027@N00,774,8,1391484037,1391484037,1,2,0
19473027@N00,774,28,1391492975,1391493071,3,2,96
19473027@N00,775,13,1391744266,1391744275,2,1,9
19473027@N00,776,8,1391920306,1391920306,1,2,0
19473027@N00,776,28,1391925621,1391925784,4,2,163
19473027@N00,777,8,1392774365,1392774511,5,2,146
19473027@N00,777,13,1392774171,1392774171,1,2,0
19473027@N00,778,3,1393808395,1393808395,2,2,0
19473027@N00,778,19,1393806491,1393807965,3,2,1474
19473027@N00,779,28,1393906322,1393906322,1,1,0
19473027@N00,780,19,1394085626,1394085626,1,1,0
19473027@N00,781,22,1395288681,1395288681,1,1,0
19473027@N00,782,3,1395650485,1395650775,8,1,290
19473027@N00,783,21,1395808025,1395808117,3,1,92
19473027@N00,784,19,1396409412,1396409523,2,1,111
19473027@N00,785,21,1396493440,1396493502,2,1,62
19473027@N00,786,3,1397094042,1397094271,5,1,229
19473027@N00,787,13,1397799591,1397799591,1,1,0
19473027@N00,788,21,1397880884,1397881760,6,1,876
19473027@N00,789,3,1398149298,1398149298,1,1,0
19473027@N00,790,24,1398481462,1398481462,1,1,0
19486062@N00,791,9,1362441530,1362441530,1,1,0
19511310@N00,792,19,1276058834,1276058834,1,1,0
19511310@N00,793,9,1276152567,1276152834,2,1,267
19565751@N00,794,9,1183780449,1183781333,29,2,884
19565751@N00,794,29,1183781438,1183809754,66,2,28316
19663529@N00,795,18,1092466115,1092466115,1,1,0
19663529@N00,796,9,1131170716,1131170716,1,1,0
19663529@N00,797,15,1134643481,1134643481,1,1,0
19663529@N00,798,20,1138512650,1138512650,1,2,0
19663529@N00,798,22,1138520400,1138521541,2,2,1141
19663529@N00,799,18,1141352368,1141352368,1,2,0
19663529@N00,799,29,1141353339,1141353456,2,2,117
19663529@N00,800,1,1152942249,1152942301,2,4,52
19663529@N00,800,9,1152943517,1152943517,1,4,0
19663529@N00,800,19,1152944255,1152944255,1,4,0
19663529@N00,800,23,1152945038,1152945038,1,4,0
19663529@N00,801,15,1155119902,1155119902,1,1,0
19663529@N00,802,4,1155189187,1155189187,1,3,0
19663529@N00,802,24,1155189358,1155189358,1,3,0
19663529@N00,802,29,1155172029,1155172029,1,3,0
19663529@N00,803,15,1160462123,1160463427,3,1,1304
19663529@N00,804,18,1162083981,1162083981,1,1,0
19813780@N00,805,12,1376990656,1376990656,1,1,0
19867324@N00,806,9,1310603308,1310603308,1,1,0
19909714@N00,807,1,1283144190,1283153505,8,3,9315
19909714@N00,807,3,1283143929,1283155282,4,3,11353
19909714@N00,807,29,1283143689,1283155138,7,3,11449
19909714@N00,808,8,1283298772,1283298772,1,3,0
19909714@N00,808,15,1283299060,1283299098,2,3,38
19909714@N00,808,19,1283298463,1283298463,1,3,0
19994833@N00,809,9,1212980481,1212980481,1,2,0
19994833@N00,809,29,1212979954,1212979954,1,2,0
20038130@N00,810,7,1370759118,1370759118,1,2,0
20038130@N00,810,20,1370739550,1370739550,1,2,0
20038130@N00,811,12,1370848662,1370848662,1,2,0
20038130@N00,811,14,1370822647,1370822647,1,2,0
20038130@N00,812,14,1370912972,1370936238,4,1,23266
20038130@N00,813,14,1371000318,1371000318,1,1,0
20038130@N00,814,9,1371034711,1371034711,1,1,0
20038130@N00,815,14,1371090125,1371110826,3,2,20701
20038130@N00,815,15,1371122783,1371122783,1,2,0
20038130@N00,816,7,1371190471,1371190471,1,1,0
20057047@N00,817,17,1154845673,1154845673,1,1,0
20168471@N00,818,1,1164152991,1164152991,1,1,0
20266194@N00,819,29,1148460766,1148460766,1,1,0
20344209@N00,820,3,1182171860,1182196597,3,2,24737
20344209@N00,820,17,1182196212,1182196212,1,2,0
20409867@N02,821,17,1373428723,1373428723,1,1,0
20409867@N02,822,19,1373494533,1373494533,1,1,0
20474225@N00,823,4,1284724046,1284724046,1,1,0
20483509@N00,824,9,1115906284,1115906284,1,1,0
20483509@N00,825,17,1123215070,1123215070,1,1,0
20483509@N00,826,4,1123909983,1123909983,1,4,0
20483509@N00,826,8,1123908094,1123908094,1,4,0
20483509@N00,826,9,1123931094,1123931094,1,4,0
20483509@N00,826,15,1123908263,1123908263,1,4,0
20483509@N00,827,19,1125291141,1125291141,1,1,0
20483509@N00,828,9,1126417593,1126417593,1,2,0
20483509@N00,828,12,1126418670,1126418670,1,2,0
20483509@N00,829,18,1128173531,1128173531,1,1,0
20483509@N00,830,18,1137905721,1137905721,1,1,0
20483509@N00,831,9,1144377859,1144378029,3,1,170
20483509@N00,832,23,1146292057,1146292057,1,1,0
20483509@N00,833,28,1146395404,1146395822,4,1,418
20483509@N00,834,12,1147593046,1147593046,1,1,0
20483509@N00,835,18,1149903864,1149903922,6,1,58
20483509@N00,836,3,1150020896,1150020896,1,1,0
20483509@N00,837,2,1150092037,1150098844,7,3,6807
20483509@N00,837,4,1150098816,1150098816,1,3,0
20483509@N00,837,24,1150091922,1150092082,3,3,160
20483509@N00,838,4,1153546505,1153546634,2,5,129
20483509@N00,838,15,1153542126,1153543823,8,5,1697
20483509@N00,838,16,1153544651,1153544651,1,5,0
20483509@N00,838,19,1153545015,1153545015,1,5,0
20483509@N00,838,29,1153544737,1153544737,1,5,0
20483509@N00,839,4,1153584508,1153584508,1,1,0
20483509@N00,840,27,1154235718,1154235849,2,1,131
20483509@N00,841,13,1154749627,1154749627,1,2,0
20483509@N00,841,29,1154773613,1154773631,2,2,18
20483509@N00,842,9,1155809019,1155809019,1,1,0
20483509@N00,843,19,1163307114,1163307114,1,1,0
20483509@N00,844,24,1163387181,1163387181,1,1,0
20483509@N00,845,4,1169645490,1169645490,1,1,0
20483509@N00,846,2,1178349173,1178349185,2,1,12
20483509@N00,847,24,1179470923,1179470923,1,1,0
20483509@N00,848,28,1193913863,1193924976,63,1,11113
20483509@N00,849,15,1194672868,1194672911,2,1,43
20483509@N00,850,24,1196825218,1196825218,1,1,0
20483509@N00,851,24,1201056777,1201056777,1,1,0
20483509@N00,852,9,1202249767,1202249787,2,1,20
20483509@N00,853,9,1204614670,1204614670,1,1,0
20483509@N00,854,23,1207465875,1207466053,2,1,178
20483509@N00,855,28,1209295539,1209297438,4,1,1899
20483509@N00,856,9,1210667295,1210667295,1,1,0
20483509@N00,857,4,1211100428,1211100428,1,1,0
20483509@N00,858,8,1211690923,1211690923,1,2,0
20483509@N00,858,11,1211696056,1211696056,1,2,0
20483509@N00,859,24,1213604853,1213604853,1,1,0
20483509@N00,860,19,1213880492,1213880987,3,1,495
20483509@N00,861,24,1213929394,1213929394,1,1,0
20483509@N00,862,15,1223183123,1223183123,1,1,0
20483509@N00,863,3,1225513167,1225513308,2,1,141
20483509@N00,864,19,1234519208,1234519316,6,1,108
20483509@N00,865,4,1245237960,1245237960,1,2,0
20483509@N00,865,24,1245214302,1245214302,1,2,0
20483509@N00,866,24,1245588967,1245589306,2,1,339
20483509@N00,867,9,1245740626,1245740626,1,3,0
20483509@N00,867,15,1245739312,1245740251,2,3,939
20483509@N00,867,16,1245740401,1245740401,1,3,0
20483509@N00,868,23,1246184066,1246184066,1,1,0
20483509@N00,869,4,1249654321,1249654321,1,1,0
20483509@N00,870,4,1250506741,1250506776,2,1,35
20483509@N00,871,10,1252742031,1252742031,1,2,0
20483509@N00,871,11,1252742207,1252742330,2,2,123
20483509@N00,872,11,1252819197,1252819197,1,2,0
20483509@N00,872,23,1252815834,1252815834,1,2,0
20483509@N00,873,12,1255407780,1255431261,4,1,23481
20483509@N00,874,4,1260402836,1260402836,1,1,0
20483509@N00,875,23,1263700671,1263700671,1,1,0
20483509@N00,876,28,1266629584,1266629584,1,1,0
20483509@N00,877,12,1266679359,1266679386,2,1,27
20483509@N00,878,11,1268460065,1268460065,1,1,0
20483509@N00,879,29,1271327722,1271327722,1,1,0
20483509@N00,880,29,1271412885,1271412885,1,1,0
20483509@N00,881,4,1273206198,1273206198,1,3,0
20483509@N00,881,9,1273229321,1273229321,1,3,0
20483509@N00,881,24,1273210422,1273210422,1,3,0
20483509@N00,882,3,1275197825,1275197825,1,3,0
20483509@N00,882,9,1275198695,1275198954,3,3,259
20483509@N00,882,11,1275215993,1275215993,1,3,0
20483509@N00,883,9,1275717984,1275717984,1,1,0
20483509@N00,884,11,1276948965,1276948965,1,1,0
20483509@N00,885,10,1277035351,1277035415,2,2,64
20483509@N00,885,23,1277034851,1277035634,2,2,783
20483509@N00,886,15,1282625438,1282625438,1,1,0
20483509@N00,887,28,1282979759,1282979759,1,1,0
20483509@N00,888,11,1285386078,1285386823,9,1,745
20483509@N00,889,1,1286079399,1286079407,2,1,8
20483509@N00,890,9,1287203618,1287203618,1,1,0
20483509@N00,891,19,1287302005,1287302005,1,2,0
20483509@N00,891,23,1287301767,1287301767,1,2,0
20483509@N00,892,9,1287803047,1287803047,1,2,0
20483509@N00,892,18,1287800557,1287800557,1,2,0
20483509@N00,893,3,1288413585,1288414145,2,1,560
20483509@N00,894,4,1291057639,1291087627,5,1,29988
20483509@N00,895,18,1294461891,1294461891,1,1,0
20483509@N00,896,19,1296211835,1296213797,2,1,1962
20483509@N00,897,9,1304413891,1304413891,1,1,0
20483509@N00,898,19,1309426104,1309426104,1,1,0
20483509@N00,899,3,1311896861,1311900015,10,1,3154
20483509@N00,900,13,1313227671,1313227736,4,1,65
20483509@N00,901,4,1314921432,1314921432,1,1,0
20483509@N00,902,11,1318141660,1318141660,1,1,0
20483509@N00,903,8,1319253761,1319253761,1,2,0
20483509@N00,903,24,1319261107,1319261107,1,2,0
20483509@N00,904,15,1319350675,1319350675,1,1,0
20483509@N00,905,24,1319700338,1319700338,1,1,0
20483509@N00,906,9,1319945354,1319945354,1,2,0
20483509@N00,906,28,1319941909,1319941909,1,2,0
20483509@N00,907,16,1322892344,1322892344,1,3,0
20483509@N00,907,18,1322891996,1322891996,1,3,0
20483509@N00,907,28,1322886722,1322886722,1,3,0
20483509@N00,908,28,1397818495,1397820345,7,1,1850
20541058@N00,909,28,1165714326,1165714326,1,1,0
20542125@N00,910,9,1313905563,1313905608,3,1,45
20545573@N00,911,27,1087002634,1087010429,6,1,7795
20545573@N00,912,3,1122773698,1122780111,9,1,6413
20545573@N00,913,15,1148783736,1148783736,1,3,0
20545573@N00,913,16,1148784603,1148784603,1,3,0
20545573@N00,913,18,1148775349,1148783494,7,3,8145
20545573@N00,914,8,1259980762,1259981731,9,1,969
20545573@N00,915,9,1271470345,1271474798,6,2,4453
20545573@N00,915,19,1271479474,1271479474,1,2,0
20587560@N00,916,3,1136972920,1136973966,3,1,1046
20587560@N00,917,3,1137025214,1137030328,2,1,5114
20587560@N00,918,3,1137142218,1137142218,1,1,0
20587560@N00,919,3,1137408337,1137408337,1,1,0
20587560@N00,920,3,1137656816,1137656816,1,1,0
20587560@N00,921,3,1181954077,1181964301,2,1,10224
20587560@N00,922,15,1182128044,1182128044,1,1,0
20587560@N00,923,3,1182547684,1182551591,3,1,3907
20587560@N00,924,3,1182645904,1182658827,9,3,12923
20587560@N00,924,12,1182647406,1182647406,1,3,0
20587560@N00,924,19,1182634032,1182634032,1,3,0
20618621@N00,925,3,1193023168,1193024812,4,2,1644
20618621@N00,925,16,1193028862,1193028971,4,2,109
20624342@N00,926,1,1289365756,1289365756,1,1,0
20669846@N03,927,9,1256604907,1256604907,1,1,0
20669846@N03,928,10,1259630219,1259630219,1,1,0
20793338@N07,929,29,1207969540,1207969540,1,1,0
20793338@N07,930,29,1281172180,1281180556,10,1,8376
20799701@N00,931,1,1220191200,1220191200,1,12,0
20799701@N00,931,2,1220191200,1220191200,2,12,0
20799701@N00,931,3,1220191200,1220191200,4,12,0
20799701@N00,931,6,1220191200,1220191200,2,12,0
20799701@N00,931,10,1220191200,1220191200,6,12,0
20799701@N00,931,11,1220191200,1220191200,3,12,0
20799701@N00,931,17,1220191200,1220191200,1,12,0
20799701@N00,931,18,1220191200,1220191200,3,12,0
20799701@N00,931,19,1220191200,1220191200,1,12,0
20799701@N00,931,20,1220191200,1220191200,5,12,0
20799701@N00,931,23,1220191200,1220191200,1,12,0
20799701@N00,931,29,1220191200,1220191200,9,12,0
20885015@N05,932,3,1279624533,1279624533,1,1,0
20885015@N05,933,9,1284908639,1284908639,1,2,0
20885015@N05,933,19,1284908714,1284908714,1,2,0
20885015@N05,934,19,1292949189,1292949189,1,1,0
20959235@N06,935,18,1320023410,1320023410,1,1,0
21116747@N02,936,9,1277278630,1277280315,2,1,1685
21116747@N02,937,3,1277378586,1277378982,2,4,396
21116747@N02,937,4,1277346208,1277353319,5,4,7111
21116747@N02,937,28,1277344425,1277344425,1,4,0
21116747@N02,937,29,1277337186,1277342549,7,4,5363
21117297@N00,938,11,1282276967,1282277110,3,1,143
21152524@N00,939,19,1246243465,1246243465,1,2,0
21152524@N00,939,23,1246243194,1246243235,3,2,41
21246173@N00,940,1,1066503029,1066503029,1,2,0
21246173@N00,940,29,1066502908,1066502908,1,2,0
21246173@N00,941,8,1133355600,1133355600,1,1,0
21246173@N00,942,8,1134276623,1134276623,1,1,0
21246173@N00,943,1,1193835600,1193835600,2,1,0
21254955@N04,944,1,1322878377,1322878963,2,3,586
21254955@N04,944,9,1322877015,1322877015,1,3,0
21254955@N04,944,29,1322884672,1322884672,1,3,0
21254955@N04,945,2,1322965139,1322970561,3,3,5422
21254955@N04,945,9,1322965897,1322965904,2,3,7
21254955@N04,945,29,1322961789,1322965514,3,3,3725
21283177@N00,946,1,1272163047,1272163047,1,2,0
21283177@N00,946,29,1272164616,1272164616,1,2,0
21283177@N00,947,4,1272235671,1272235671,1,2,0
21283177@N00,947,11,1272230201,1272230201,1,2,0
21283177@N00,948,2,1375060757,1375061244,3,5,487
21283177@N00,948,10,1375044294,1375044625,2,5,331
21283177@N00,948,16,1375053824,1375053824,1,5,0
21283177@N00,948,23,1375063357,1375063357,1,5,0
21283177@N00,948,29,1375054884,1375054884,1,5,0
21295595@N08,949,3,1281681612,1281683431,5,2,1819
21295595@N08,949,19,1281696589,1281696589,1,2,0
21295595@N08,950,9,1281931847,1281943379,2,1,11532
21336298@N00,951,1,1249048800,1249048800,21,1,0
21337016@N00,952,27,1266135041,1266135041,1,1,0
21337016@N00,953,27,1266826310,1266826310,1,1,0
21342817@N00,954,10,1304330845,1304330845,1,1,0
21416854@N00,955,5,1193522280,1193522280,1,1,0
21492331@N03,956,8,1244699655,1244699655,1,4,0
21492331@N03,956,18,1244699693,1244699693,1,4,0
21492331@N03,956,19,1244699675,1244699675,1,4,0
21492331@N03,956,28,1244699748,1244699763,2,4,15
21492331@N03,957,20,1298678400,1298678400,1,1,0
21492331@N03,958,20,1310532037,1310537483,8,1,5446
21551510@N05,959,12,1339552006,1339553293,2,1,1287
21551510@N05,960,7,1346242939,1346243206,2,1,267
21551510@N05,961,17,1347411310,1347411310,1,1,0
21551510@N05,962,27,1355550996,1355550996,1,1,0
21551510@N05,963,4,1355987252,1355987252,1,1,0
21551510@N05,964,17,1358470116,1358470116,1,1,0
21551510@N05,965,12,1362300674,1362300674,1,1,0
21551510@N05,966,19,1368667395,1368667395,1,1,0
21651923@N07,967,3,1222783200,1222783200,5,2,0
21651923@N07,967,29,1222783200,1222783200,4,2,0
21662121@N00,968,13,1332560045,1332560045,1,1,0
21712240@N00,969,1,1279851657,1279853972,6,7,2315
21712240@N00,969,4,1279843888,1279844050,2,7,162
21712240@N00,969,13,1279848097,1279848130,2,7,33
21712240@N00,969,19,1279843301,1279885564,4,7,42263
21712240@N00,969,24,1279844923,1279844923,1,7,0
21712240@N00,969,28,1279891889,1279893901,4,7,2012
21712240@N00,969,29,1279853299,1279853347,2,7,48
21712240@N00,970,3,1279947629,1279950885,8,6,3256
21712240@N00,970,10,1279944695,1279944695,1,6,0
21712240@N00,970,11,1279943869,1279944329,4,6,460
21712240@N00,970,19,1279942987,1279943477,2,6,490
21712240@N00,970,23,1279942943,1279943347,4,6,404
21712240@N00,970,24,1279943957,1279943957,1,6,0
21712240@N00,971,8,1280015913,1280015913,1,1,0
21769199@N00,972,9,1381956878,1381956878,1,1,0
21769199@N00,973,3,1382043751,1382043751,1,1,0
21795222@N06,974,18,1346472312,1346472312,1,2,0
21795222@N06,974,29,1346474308,1346474308,1,2,0
21818828@N00,975,29,1353715455,1353715455,1,1,0
21818828@N00,976,3,1353798042,1353798042,1,2,0
21818828@N00,976,8,1353772010,1353772010,1,2,0
21818828@N00,977,9,1353858966,1353858966,1,1,0
21837290@N00,978,2,1159286580,1159286580,1,1,0
21886401@N00,979,9,1187771232,1187771232,1,1,0
21916524@N07,980,29,1292642466,1292644438,2,1,1972
21916524@N07,981,2,1292815720,1292818128,3,3,2408
21916524@N07,981,4,1292819897,1292819897,1,3,0
21916524@N07,981,17,1292832835,1292832835,1,3,0
21916524@N07,982,1,1292889982,1292892056,7,1,2074
22086443@N00,983,9,1319942261,1319942261,2,1,0
22087304@N07,984,8,1259586000,1259586000,1,2,0
22087304@N07,984,27,1259586000,1259586000,1,2,0
22087304@N07,985,20,1267362000,1267362000,6,1,0
22087304@N07,986,10,1275314400,1275314400,1,3,0
22087304@N07,986,11,1275314400,1275314400,3,3,0
22087304@N07,986,23,1275314400,1275314400,3,3,0
22087304@N07,987,8,1277906400,1277906400,1,2,0
22087304@N07,987,18,1277906400,1277906400,2,2,0
22087304@N07,988,18,1280545744,1280545744,1,1,0
22087304@N07,989,20,1285855200,1285855200,1,2,0
22087304@N07,989,25,1285855200,1285855200,2,2,0
22087304@N07,990,12,1293800400,1293800400,2,1,0
22087304@N07,991,9,1298898000,1298898000,1,2,0
22087304@N07,991,18,1298898000,1298898000,2,2,0
22087304@N07,992,12,1301576400,1301576400,2,1,0
22087304@N07,993,9,1312120800,1312120800,2,1,0
22087304@N07,994,27,1322658000,1322658000,4,1,0
22087304@N07,995,9,1343743200,1343743200,62,2,0
22087304@N07,995,29,1343743200,1343743200,1,2,0
22087304@N07,996,9,1345344976,1345344976,1,1,0
22087304@N07,997,3,1356958800,1356958800,9,1,0
22087304@N07,998,18,1367330400,1367330400,1,1,0
22087304@N07,999,9,1375279200,1375279200,46,1,0
22144722@N02,1000,1,1298514625,1298514625,1,1,0
22144722@N02,1001,8,1343357344,1343357465,4,1,121
22148797@N00,1002,9,1154142779,1154142890,2,1,111
22154104@N00,1003,29,1287829971,1287829971,1,1,0
22154104@N00,1004,29,1287886562,1287886562,1,1,0
22154104@N00,1005,16,1288485689,1288485689,1,1,0
22214206@N06,1006,4,1337937619,1337937740,2,1,121
22214206@N06,1007,29,1337996570,1337996570,1,1,0
22218727@N02,1008,9,1217744178,1217744178,1,1,0
22218727@N02,1009,15,1229736506,1229736673,5,1,167
22220128@N08,1010,10,1351050396,1351054296,13,1,3900
22236399@N05,1011,3,1312780310,1312782796,2,1,2486
22236399@N05,1012,18,1315618774,1315619121,7,1,347
22325101@N00,1013,1,1275104619,1275127788,27,1,23169
22325101@N00,1014,1,1275174824,1275213415,21,1,38591
22325101@N00,1015,1,1275262821,1275281135,22,2,18314
22325101@N00,1015,4,1275280931,1275280939,2,2,8
22325101@N00,1016,1,1275456736,1275469252,4,2,12516
22325101@N00,1016,9,1275462345,1275462345,1,2,0
22415346@N06,1017,9,1220776315,1220776315,1,4,0
22415346@N06,1017,10,1220749650,1220749650,1,4,0
22415346@N06,1017,11,1220749725,1220750403,19,4,678
22415346@N06,1017,29,1220775946,1220776048,3,4,102
22583729@N06,1018,19,1202476170,1202476176,3,1,6
22583729@N06,1019,9,1202530468,1202530569,3,1,101
22583729@N06,1020,19,1203164120,1203164120,1,1,0
22583729@N06,1021,28,1203684566,1203689232,17,1,4666
22583729@N06,1022,9,1204127048,1204127048,1,3,0
22583729@N06,1022,19,1204126721,1204126953,2,3,232
22583729@N06,1022,28,1204117360,1204120866,7,3,3506
22583729@N06,1023,23,1204383065,1204383553,4,1,488
22583729@N06,1024,28,1204445768,1204445768,1,1,0
22583729@N06,1025,19,1208005352,1208009378,7,1,4026
22596839@N02,1026,8,1354351269,1354351269,1,1,0
22607526@N00,1027,3,1187330771,1187331258,9,4,487
22607526@N00,1027,9,1187333691,1187338315,29,4,4624
22607526@N00,1027,17,1187334765,1187334940,4,4,175
22607526@N00,1027,29,1187325062,1187333321,49,4,8259
22607526@N00,1028,9,1187408076,1187408107,4,2,31
22607526@N00,1028,17,1187405305,1187413295,13,2,7990
22607526@N00,1029,1,1187500387,1187505421,49,3,5034
22607526@N00,1029,3,1187507330,1187507494,3,3,164
22607526@N00,1029,29,1187498230,1187506540,10,3,8310
22607526@N00,1030,8,1187577216,1187580655,55,3,3439
22607526@N00,1030,15,1187576789,1187577014,3,3,225
22607526@N00,1030,18,1187576149,1187576208,2,3,59
22633351@N03,1031,1,1156828594,1156830723,9,1,2129
22633351@N03,1032,1,1156914398,1156923831,22,1,9433
22633351@N03,1033,1,1156989328,1157008731,60,1,19403
22633351@N03,1034,1,1157051280,1157064275,170,1,12995
22633351@N03,1035,1,1158305284,1158313898,126,1,8614
22633351@N03,1036,1,1160810326,1160813947,49,1,3621
22635783@N00,1037,18,1158538181,1158538190,15,1,9
22635783@N00,1038,21,1222922114,1222923155,2,1,1041
22746348@N02,1039,18,1341224623,1341224623,1,1,0
22822808@N00,1040,9,1256435143,1256435143,1,1,0
22885724@N04,1041,4,1122604814,1122604814,1,1,0
22890158@N08,1042,1,1243066426,1243066426,1,4,0
22890158@N08,1042,2,1243060194,1243060194,1,4,0
22890158@N08,1042,4,1243059851,1243060715,2,4,864
22890158@N08,1042,9,1243062791,1243065960,10,4,3169
23036649@N06,1043,6,1357848470,1357848470,1,1,0
23041822@N04,1044,28,1391064946,1391065265,3,1,319
23062920@N00,1045,8,1226036884,1226046857,16,4,9973
23062920@N00,1045,15,1226046833,1226046833,1,4,0
23062920@N00,1045,18,1226032773,1226032773,1,4,0
23062920@N00,1045,22,1226030926,1226031690,9,4,764
23062920@N00,1046,3,1226121988,1226127384,4,5,5396
23062920@N00,1046,8,1226133340,1226133340,1,5,0
23062920@N00,1046,9,1226130507,1226132837,7,5,2330
23062920@N00,1046,13,1226116937,1226117361,6,5,424
23062920@N00,1046,29,1226129511,1226130299,2,5,788
23062920@N00,1047,13,1226196600,1226197389,2,2,789
23062920@N00,1047,19,1226204625,1226214065,4,2,9440
23075466@N08,1048,12,1194699577,1194699577,1,1,0
23090753@N06,1049,29,1384486603,1384486603,1,1,0
23108377@N07,1050,27,1332301811,1332301811,1,1,0
23108377@N07,1051,4,1370512563,1370512734,2,6,171
23108377@N07,1051,8,1370513883,1370521249,4,6,7366
23108377@N07,1051,11,1370484549,1370484549,1,6,0
23108377@N07,1051,15,1370517808,1370517808,1,6,0
23108377@N07,1051,17,1370511737,1370511737,1,6,0
23108377@N07,1051,27,1370499445,1370499679,2,6,234
23108377@N07,1052,5,1370657340,1370657344,2,1,4
23191520@N00,1053,29,1310709729,1310709729,1,1,0
23307493@N07,1054,19,1266838930,1266838930,1,1,0
23351536@N07,1055,3,1241312960,1241313951,4,4,991
23351536@N07,1055,15,1241311243,1241311254,2,4,11
23351536@N07,1055,17,1241314068,1241314101,2,4,33
23351536@N07,1055,28,1241312325,1241312325,1,4,0
23351536@N07,1056,29,1245722942,1245722942,1,1,0
23351536@N07,1057,8,1264384049,1264390496,5,1,6447
23351536@N07,1058,8,1270857941,1270857941,1,1,0
23351536@N07,1059,9,1281154403,1281156934,9,1,2531
23351536@N07,1060,3,1281479156,1281479156,1,1,0
23351536@N07,1061,9,1281590816,1281593975,7,1,3159
23351536@N07,1062,9,1282100810,1282101236,5,1,426
23351536@N07,1063,12,1285371908,1285377690,16,1,5782
23351536@N07,1064,29,1290990065,1290990065,1,1,0
23351536@N07,1065,8,1293763669,1293764136,5,2,467
23351536@N07,1065,19,1293764195,1293764356,2,2,161
23351536@N07,1066,9,1293847246,1293847300,3,2,54
23351536@N07,1066,15,1293847905,1293851728,6,2,3823
23351536@N07,1067,19,1294441034,1294441128,2,1,94
23351536@N07,1068,3,1299014400,1299017751,2,1,3351
23351536@N07,1069,13,1301985059,1301985059,1,1,0
23351536@N07,1070,19,1316067955,1316067955,1,1,0
23351536@N07,1071,15,1316835719,1316835719,1,1,0
23351536@N07,1072,3,1317161755,1317161755,1,1,0
23351536@N07,1073,3,1317762766,1317762766,1,1,0
23351536@N07,1074,8,1326073941,1326073941,1,3,0
23351536@N07,1074,13,1326072312,1326072332,2,3,20
23351536@N07,1074,28,1326072593,1326072677,2,3,84
23351536@N07,1075,3,1332707405,1332724408,4,5,17003
23351536@N07,1075,9,1332725302,1332725476,4,5,174
23351536@N07,1075,13,1332707031,1332707215,3,5,184
23351536@N07,1075,17,1332724961,1332724961,1,5,0
23351536@N07,1075,29,1332725943,1332726443,4,5,500
23351536@N07,1076,8,1351309918,1351309918,1,2,0
23351536@N07,1076,15,1351310441,1351310441,1,2,0
23351536@N07,1077,3,1357005285,1357005285,1,5,0
23351536@N07,1077,9,1357018318,1357018318,1,5,0
23351536@N07,1077,17,1357012737,1357012737,1,5,0
23351536@N07,1077,28,1357013856,1357013947,2,5,91
23351536@N07,1077,29,1357006678,1357006678,1,5,0
23351536@N07,1078,3,1361343719,1361343719,1,1,0
23351536@N07,1079,13,1363123863,1363123979,2,1,116
23351536@N07,1080,3,1364278898,1364279070,2,6,172
23351536@N07,1080,8,1364285023,1364285253,2,6,230
23351536@N07,1080,10,1364281899,1364282906,5,6,1007
23351536@N07,1080,19,1364285143,1364285143,1,6,0
23351536@N07,1080,23,1364282733,1364284451,3,6,1718
23351536@N07,1080,28,1364281348,1364281348,1,6,0
23351536@N07,1081,4,1366938023,1366938893,4,1,870
23351536@N07,1082,13,1375134738,1375134761,2,1,23
23351536@N07,1083,8,1388022473,1388034666,6,6,12193
23351536@N07,1083,10,1388028602,1388028602,1,6,0
23351536@N07,1083,11,1388027965,1388027965,1,6,0
23351536@N07,1083,13,1388020569,1388020751,3,6,182
23351536@N07,1083,16,1388034381,1388034381,1,6,0
23351536@N07,1083,23,1388027903,1388027903,1,6,0
23351536@N07,1084,11,1388396596,1388396677,4,1,81
23351536@N07,1085,9,1388547197,1388547481,2,2,284
23351536@N07,1085,13,1388544924,1388545304,4,2,380
23351536@N07,1086,28,1391058120,1391060506,6,1,2386
23351536@N07,1087,1,1391211957,1391212240,2,3,283
23351536@N07,1087,3,1391212570,1391213243,5,3,673
23351536@N07,1087,17,1391212107,1391212107,1,3,0
23351536@N07,1088,12,1393042839,1393043043,4,1,204
23351536@N07,1089,3,1393471386,1393471386,1,1,0
23351536@N07,1090,9,1394005735,1394005735,1,1,0
23351536@N07,1091,3,1394487800,1394487800,1,1,0
23351536@N07,1092,8,1394609684,1394609684,1,1,0
23351536@N07,1093,3,1395106478,1395106478,1,1,0
23363966@N02,1094,16,1153469321,1153469321,1,3,0
23363966@N02,1094,18,1153468800,1153468800,1,3,0
23363966@N02,1094,29,1153471260,1153471260,1,3,0
23363966@N02,1095,2,1153983106,1153983106,1,3,0
23363966@N02,1095,4,1153982524,1153982524,1,3,0
23363966@N02,1095,15,1153989594,1153989594,1,3,0
23363966@N02,1096,3,1154222422,1154222422,1,2,0
23363966@N02,1096,29,1154222089,1154222089,1,2,0
23363966@N02,1097,2,1185511249,1185511249,1,4,0
23363966@N02,1097,4,1185507130,1185507321,3,4,191
23363966@N02,1097,8,1185523514,1185523514,1,4,0
23363966@N02,1097,29,1185501293,1185501293,1,4,0
23363966@N02,1098,9,1185943661,1185943661,1,2,0
23363966@N02,1098,15,1185939999,1185940392,4,2,393
23377996@N00,1099,3,1270159280,1270159280,1,2,0
23377996@N00,1099,9,1270149983,1270149983,1,2,0
23401669@N00,1100,22,1188611395,1188611569,2,1,174
23477028@N00,1101,8,1217949183,1217949183,1,2,0
23477028@N00,1101,19,1217949259,1217949259,1,2,0
23480782@N05,1102,9,1313468758,1313468758,1,1,0
23480782@N05,1103,1,1313572305,1313572305,1,3,0
23480782@N05,1103,3,1313566365,1313566365,1,3,0
23480782@N05,1103,9,1313552047,1313552047,1,3,0
23480782@N05,1104,3,1313732496,1313732496,1,1,0
23480782@N05,1105,9,1314018622,1314018746,7,1,124
23480782@N05,1106,9,1314183257,1314183288,3,2,31
23480782@N05,1106,17,1314183304,1314183304,1,2,0
23518714@N00,1107,1,1216594505,1216604200,22,7,9695
23518714@N00,1107,8,1216583014,1216588004,5,7,4990
23518714@N00,1107,9,1216585941,1216586133,3,7,192
23518714@N00,1107,15,1216583197,1216589325,3,7,6128
23518714@N00,1107,19,1216582864,1216587833,3,7,4969
23518714@N00,1107,24,1216582337,1216587181,3,7,4844
23518714@N00,1107,29,1216585881,1216593749,4,7,7868
23536504@N07,1108,18,1213690038,1213692017,37,1,1979
23536504@N07,1109,18,1213775767,1213777277,3,1,1510
23539578@N06,1110,1,1251720977,1251720977,1,4,0
23539578@N06,1110,8,1251693386,1251693386,1,4,0
23539578@N06,1110,9,1251691462,1251692904,2,4,1442
23539578@N06,1110,19,1251689879,1251691279,4,4,1400
23539578@N06,1111,1,1251764734,1251768244,13,4,3510
23539578@N06,1111,9,1251763952,1251764482,2,4,530
23539578@N06,1111,15,1251797960,1251797971,2,4,11
23539578@N06,1111,19,1251777089,1251777089,1,4,0
23680473@N08,1112,4,1290658120,1290658585,3,1,465
23680473@N08,1113,8,1305240135,1305240135,1,1,0
23694109@N05,1114,4,1290829029,1290829029,1,1,0
23694109@N05,1115,7,1294305315,1294305315,1,1,0
23694109@N05,1116,13,1316082406,1316082406,1,1,0
23694109@N05,1117,15,1345384237,1345384237,1,1,0
23737563@N00,1118,3,1350352471,1350355983,4,2,3512
23737563@N00,1118,28,1350353126,1350354597,2,2,1471
23829501@N00,1119,13,1193350165,1193350165,1,2,0
23829501@N00,1119,29,1193352207,1193352520,3,2,313
23837403@N03,1120,15,557589601,557589601,1,3,0
23837403@N03,1120,18,557589603,557589606,4,3,3
23837403@N03,1120,19,557589600,557589600,1,3,0
23837403@N03,1121,1,557676000,557676037,45,4,37
23837403@N03,1121,2,557676000,557676011,17,4,11
23837403@N03,1121,11,557676015,557676017,2,4,2
23837403@N03,1121,23,557676022,557676022,1,4,0
23837403@N03,1122,1,557715300,557724000,8,5,8700
23837403@N03,1122,2,557736600,557736600,1,5,0
23837403@N03,1122,10,557732573,557732573,1,5,0
23837403@N03,1122,11,557726100,557730022,4,5,3922
23837403@N03,1122,23,557724600,557724600,1,5,0
23837403@N03,1123,2,1220773688,1220773688,1,1,0
23840819@N03,1124,4,1106984974,1106984974,1,1,0
23840819@N03,1125,15,1107051139,1107051139,1,1,0
23873159@N08,1126,19,1123213211,1123213211,1,1,0
23873159@N08,1127,1,1123325041,1123325998,2,2,957
23873159@N08,1127,9,1123319156,1123319156,1,2,0
23873159@N08,1128,3,1123380584,1123380584,1,4,0
23873159@N08,1128,17,1123380162,1123380162,1,4,0
23873159@N08,1128,19,1123391066,1123392522,5,4,1456
23873159@N08,1128,29,1123386395,1123386395,1,4,0
24007924@N00,1129,19,1066897276,1066899890,2,1,2614
24007924@N00,1130,19,1067155961,1067162664,3,1,6703
24007924@N00,1131,19,1067209722,1067209722,1,1,0
24007924@N00,1132,19,1127654085,1127654085,1,1,0
24049533@N00,1133,10,925480800,925480800,1,2,0
24049533@N00,1133,11,925480800,925480800,2,2,0
24049533@N00,1134,10,954511200,954511200,1,2,0
24049533@N00,1134,11,954511200,954511200,1,2,0
24049533@N00,1135,10,988639200,988639200,3,1,0
24049533@N00,1136,10,1017583200,1017583200,1,1,0
24049533@N00,1137,10,1051711200,1051711200,7,1,0
24049533@N00,1138,11,1177820270,1177822765,2,1,2495
24049533@N00,1139,10,1177923850,1177923850,1,2,0
24049533@N00,1139,11,1177923916,1177939112,67,2,15196
24049533@N00,1140,11,1177973227,1177973227,1,1,0
24049533@N00,1141,29,1193825390,1193825390,1,1,0
24049533@N00,1142,8,1198464719,1198464907,5,1,188
24049533@N00,1143,3,1205973470,1205975955,4,2,2485
24049533@N00,1143,28,1205973852,1205973852,1,2,0
24049533@N00,1144,3,1311892553,1311898518,22,1,5965
24166176@N00,1145,15,1363155921,1363155921,1,1,0
24183489@N00,1146,3,1296263965,1296263965,2,3,0
24183489@N00,1146,10,1296254437,1296254850,4,3,413
24183489@N00,1146,11,1296253452,1296254179,8,3,727
24183489@N00,1147,10,1296376948,1296381074,6,2,4126
24183489@N00,1147,11,1296377594,1296377594,2,2,0
24204505@N00,1148,22,1169538285,1169538285,1,1,0
24204505@N00,1149,22,1169621810,1169621810,1,1,0
24204505@N00,1150,22,1170645229,1170645229,1,1,0
24204505@N00,1151,28,1171098261,1171098261,1,1,0
24204505@N00,1152,22,1173757496,1173757496,1,1,0
24232779@N00,1153,16,1270615768,1270615996,13,2,228
24232779@N00,1153,19,1270604011,1270617932,4,2,13921
24258698@N04,1154,8,1120627266,1120627266,1,1,0
24258698@N04,1155,8,1137668623,1137668623,1,1,0
24258698@N04,1156,8,1385816400,1385816400,3,1,0
24388834@N04,1157,16,1335305926,1335305926,1,1,0
24401095@N00,1158,1,1127707956,1127707956,1,5,0
24401095@N00,1158,9,1127709465,1127709573,2,5,108
24401095@N00,1158,15,1127708498,1127708498,1,5,0
24401095@N00,1158,18,1127708379,1127708379,1,5,0
24401095@N00,1158,29,1127707523,1127709094,3,5,1571
24401095@N00,1159,3,1127872170,1127872170,1,2,0
24401095@N00,1159,13,1127872811,1127872811,1,2,0
24401095@N00,1160,1,1128260173,1128260173,1,4,0
24401095@N00,1160,3,1128258064,1128260166,2,4,2102
24401095@N00,1160,8,1128258011,1128258011,1,4,0
24401095@N00,1160,13,1128258487,1128258487,1,4,0
24401095@N00,1161,1,1128391615,1128391615,1,2,0
24401095@N00,1161,3,1128391608,1128391608,1,2,0
24417565@N05,1162,6,1243040227,1243040227,1,1,0
24426257@N07,1163,3,788878800,788878800,1,1,0
24431382@N03,1164,9,1274233549,1274233549,1,1,0
24431382@N03,1165,9,1275692587,1275692587,1,1,0
24469639@N00,1166,3,1266048649,1266048649,1,1,0
24469639@N00,1167,9,1306554530,1306554530,1,1,0
24484507@N00,1168,24,1060404796,1060411267,6,1,6471
24484507@N00,1169,8,1123904751,1123905372,2,2,621
24484507@N00,1169,15,1123923897,1123923897,1,2,0
24484507@N00,1170,10,1124006376,1124016397,4,2,10021
24484507@N00,1170,11,1124006261,1124007342,3,2,1081
24484507@N00,1171,29,1156575932,1156575932,1,1,0
24535188@N00,1172,19,1336562000,1336562000,1,1,0
24616128@N00,1173,1,1351377302,1351401752,28,5,24450
24616128@N00,1173,9,1351385811,1351403510,5,5,17699
24616128@N00,1173,15,1351376661,1351376913,2,5,252
24616128@N00,1173,19,1351376354,1351386074,2,5,9720
24616128@N00,1173,29,1351377219,1351379208,3,5,1989
24645033@N00,1174,12,1086007366,1086013543,4,1,6177
24645033@N00,1175,10,1086520978,1086529259,7,2,8281
24645033@N00,1175,12,1086502720,1086502720,1,2,0
24645033@N00,1176,3,1126656251,1126656251,1,1,0
24645033@N00,1177,8,1133752573,1133752573,1,2,0
24645033@N00,1177,19,1133751635,1133751635,1,2,0
24645033@N00,1178,8,1136283541,1136283541,2,3,0
24645033@N00,1178,19,1136283515,1136283515,1,3,0
24645033@N00,1178,22,1136283523,1136283523,1,3,0
24645033@N00,1179,10,1141345834,1141345834,1,3,0
24645033@N00,1179,11,1141345830,1141345830,1,3,0
24645033@N00,1179,19,1141345874,1141345874,1,3,0
24645033@N00,1180,8,1141684836,1141684836,1,4,0
24645033@N00,1180,11,1141684863,1141684863,1,4,0
24645033@N00,1180,19,1141684836,1141684836,2,4,0
24645033@N00,1180,23,1141684842,1141684863,6,4,21
24697990@N00,1181,4,1322618820,1322621100,27,4,2280
24697990@N00,1181,9,1322614840,1322617936,4,4,3096
24697990@N00,1181,24,1322620624,1322620624,1,4,0
24697990@N00,1181,29,1322614846,1322616380,7,4,1534
24746634@N00,1182,3,1262137965,1262137965,1,1,0
24746634@N00,1183,22,1262819141,1262819296,2,1,155
24746634@N00,1184,12,1262924053,1262924195,2,1,142
24803078@N00,1185,9,1227346828,1227346867,2,2,39
24803078@N00,1185,19,1227342969,1227342969,1,2,0
24803078@N00,1186,8,1227403521,1227438475,2,6,34954
24803078@N00,1186,9,1227387946,1227439421,10,6,51475
24803078@N00,1186,15,1227404335,1227405719,11,6,1384
24803078@N00,1186,16,1227403486,1227405832,3,6,2346
24803078@N00,1186,19,1227437802,1227438430,4,6,628
24803078@N00,1186,29,1227406310,1227406418,2,6,108
24842486@N07,1187,1,1372600800,1372600800,2,1,0
24856075@N00,1188,8,978267600,978267600,1,1,0
24868194@N04,1189,3,1274567191,1274567982,10,2,791
24868194@N04,1189,29,1274564117,1274564783,4,2,666
24868194@N04,1190,23,1274997756,1274997894,4,1,138
24931020@N02,1191,15,1276443282,1276443282,1,1,0
24931020@N02,1192,10,1276769344,1276770011,4,2,667
24931020@N02,1192,11,1276769667,1276769816,3,2,149
24931020@N02,1193,1,1287633379,1287633379,1,9,0
24931020@N02,1193,4,1287637276,1287637387,5,9,111
24931020@N02,1193,10,1287636470,1287636470,1,9,0
24931020@N02,1193,11,1287635652,1287635652,1,9,0
24931020@N02,1193,16,1287627705,1287627705,1,9,0
24931020@N02,1193,17,1287634946,1287634946,1,9,0
24931020@N02,1193,19,1287635102,1287635152,2,9,50
24931020@N02,1193,23,1287635662,1287636452,2,9,790
24931020@N02,1193,29,1287632609,1287633373,3,9,764
24931020@N02,1194,12,1329187781,1329187781,1,1,0
24963327@N00,1195,1,1383942208,1383948870,5,2,6662
24963327@N00,1195,29,1383940098,1383940228,2,2,130
24963327@N00,1196,2,1384026696,1384026696,1,2,0
24963327@N00,1196,7,1384029148,1384029873,3,2,725
25009109@N06,1197,8,1209166853,1209166853,1,1,0
25009109@N06,1198,11,1220180781,1220183784,7,1,3003
25011467@N05,1199,12,1205662161,1205662161,1,1,0
25034321@N05,1200,19,1389582361,1389582361,1,1,0
25034321@N05,1201,8,1390532745,1390532745,1,4,0
25034321@N05,1201,12,1390524662,1390525027,12,4,365
25034321@N05,1201,15,1390515903,1390522798,12,4,6895
25034321@N05,1201,18,1390512672,1390523553,30,4,10881
25063474@N00,1202,11,1143368792,1143368792,1,1,0
25148740@N03,1203,1,1193409375,1193420035,27,7,10660
25148740@N03,1203,2,1193427777,1193427777,1,7,0
25148740@N03,1203,4,1193427996,1193427996,1,7,0
25148740@N03,1203,9,1193421449,1193421449,1,7,0
25148740@N03,1203,10,1193429195,1193429214,2,7,19
25148740@N03,1203,11,1193429416,1193430286,13,7,870
25148740@N03,1203,29,1193420106,1193420106,1,7,0
25293698@N02,1204,19,1277335974,1277335974,1,1,0
25293698@N02,1205,4,1279254354,1279254354,1,1,0
25293698@N02,1206,4,1292207099,1292207099,1,1,0
25302607@N00,1207,1,1228024756,1228024756,1,1,0
25302607@N00,1208,1,1228098236,1228098269,2,5,33
25302607@N00,1208,8,1228099729,1228099898,2,5,169
25302607@N00,1208,9,1228110618,1228110618,1,5,0
25302607@N00,1208,10,1228091188,1228091188,1,5,0
25302607@N00,1208,11,1228101382,1228102201,4,5,819
25302607@N00,1209,3,1228178154,1228178154,1,1,0
25302607@N00,1210,17,1228213227,1228213227,1,1,0
25302607@N00,1211,11,1228346299,1228358784,2,1,12485
25302607@N00,1212,29,1228428922,1228428922,1,1,0
25302607@N00,1213,11,1306738988,1306739056,2,2,68
25302607@N00,1213,21,1306746163,1306746163,1,2,0
25302607@N00,1214,10,1339574212,1339574416,2,1,204
25334228@N00,1215,8,1325816914,1325816914,1,2,0
25334228@N00,1215,15,1325816971,1325816971,1,2,0
25389244@N00,1216,1,1000049580,1000051740,4,6,2160
25389244@N00,1216,2,1000055564,1000055692,2,6,128
25389244@N00,1216,4,1000064696,1000064696,1,6,0
25389244@N00,1216,9,1000066640,1000066640,1,6,0
25389244@N00,1216,19,1000067905,1000068571,2,6,666
25389244@N00,1216,29,1000065055,1000065055,1,6,0
25393391@N07,1217,10,1364631767,1364631767,1,1,0
25393391@N07,1218,16,1364692996,1364692996,1,1,0
25396215@N00,1219,8,1216860169,1216860169,1,6,0
25396215@N00,1219,9,1216856212,1216857028,6,6,816
25396215@N00,1219,15,1216858156,1216858156,1,6,0
25396215@N00,1219,16,1216857846,1216857846,1,6,0
25396215@N00,1219,18,1216858843,1216858843,1,6,0
25396215@N00,1219,29,1216857242,1216857587,4,6,345
25396215@N00,1220,8,1216934141,1216934156,2,5,15
25396215@N00,1220,13,1216938918,1216943314,6,5,4396
25396215@N00,1220,17,1216935168,1216935187,2,5,19
25396215@N00,1220,19,1216934877,1216934877,1,5,0
25396215@N00,1220,28,1216935398,1216935398,1,5,0
25431147@N08,1221,9,1293931780,1293931780,1,1,0
25543011@N00,1222,3,1074530178,1074530365,4,1,187
25543011@N00,1223,3,1182618555,1182618555,1,1,0
25543011@N00,1224,29,1197734188,1197737877,41,1,3689
25561968@N00,1225,2,1188018190,1188021072,27,2,2882
25561968@N00,1225,23,1188015533,1188015848,4,2,315
25561968@N00,1226,2,1192433227,1192433713,2,3,486
25561968@N00,1226,11,1192434871,1192434871,1,3,0
25561968@N00,1226,23,1192435055,1192435060,2,3,5
25561968@N00,1227,9,1193831241,1193833272,5,1,2031
25561968@N00,1228,2,1194060915,1194062055,9,1,1140
25561968@N00,1229,9,1196812651,1196812651,1,1,0
25561968@N00,1230,3,1209280252,1209280252,1,1,0
25561968@N00,1231,17,1219572467,1219578058,8,1,5591
25561968@N00,1232,8,1228816391,1228817387,3,1,996
25561968@N00,1233,8,1229930859,1229930859,1,1,0
25566924@N00,1234,13,1181872843,1181872897,2,1,54
25566924@N00,1235,13,1182001152,1182001152,1,1,0
25566924@N00,1236,13,1210213565,1210240906,29,1,27341
25566924@N00,1237,13,1210301065,1210319825,8,1,18760
25566924@N00,1238,13,1224132344,1224132344,1,1,0
25566924@N00,1239,13,1224195291,1224204687,2,1,9396
25588248@N00,1240,9,1273794101,1273794336,4,1,235
25636549@N08,1241,23,1218138821,1218138821,1,1,0
25636549@N08,1242,11,1245655319,1245655319,1,1,0
25636549@N08,1243,8,1262068253,1262068253,1,2,0
25636549@N08,1243,10,1262076865,1262076865,1,2,0
25636549@N08,1244,8,1264136391,1264136391,1,2,0
25636549@N08,1244,16,1264126303,1264126679,2,2,376
25636549@N08,1245,9,1268449751,1268451270,5,1,1519
25636549@N08,1246,9,1268561305,1268561305,1,1,0
25636549@N08,1247,9,1269408692,1269408692,1,1,0
25636549@N08,1248,19,1269650840,1269651025,3,2,185
25636549@N08,1248,23,1269651445,1269651445,1,2,0
25636549@N08,1249,10,1271059601,1271059601,1,1,0
25636549@N08,1250,18,1274415222,1274415369,2,1,147
25636549@N08,1251,15,1275718450,1275718450,1,1,0
25636549@N08,1252,4,1276500035,1276500035,1,1,0
25636549@N08,1253,9,1281752867,1281752867,1,2,0
25636549@N08,1253,15,1281759672,1281759672,1,2,0
25636549@N08,1254,9,1281847533,1281853962,7,2,6429
25636549@N08,1254,17,1281846761,1281846777,2,2,16
25636549@N08,1255,9,1282018734,1282023736,3,1,5002
25636549@N08,1256,9,1282627191,1282627349,2,1,158
25636549@N08,1257,8,1297919287,1297919287,1,1,0
25636549@N08,1258,3,1299121753,1299121832,3,1,79
25636549@N08,1259,9,1300239475,1300240310,3,1,835
25636549@N08,1260,1,1314863635,1314863635,1,2,0
25636549@N08,1260,9,1314857587,1314861293,5,2,3706
25828087@N05,1261,8,1385348971,1385349032,2,1,61
25866217@N00,1262,9,1149082183,1149082183,1,3,0
25866217@N00,1262,18,1149079262,1149079262,1,3,0
25866217@N00,1262,24,1149087975,1149087975,1,3,0
25866217@N00,1263,19,1149181731,1149181731,1,1,0
25866217@N00,1264,1,1149759646,1149780677,3,3,21031
25866217@N00,1264,18,1149781401,1149781401,1,3,0
25866217@N00,1264,29,1149761039,1149761039,1,3,0
25868963@N07,1265,10,1072686766,1072686766,1,1,0
25868963@N07,1266,11,1100229655,1100229655,1,1,0
25868963@N07,1267,11,1100925437,1100925437,1,1,0
25868963@N07,1268,10,1230540556,1230540556,1,1,0
25893790@N08,1269,9,1278126180,1278126180,1,1,0
25984556@N07,1270,1,1213083491,1213083491,1,8,0
25984556@N07,1270,8,1213081167,1213081260,3,8,93
25984556@N07,1270,9,1213081798,1213082474,5,8,676
25984556@N07,1270,12,1213083752,1213083927,2,8,175
25984556@N07,1270,15,1213079895,1213080809,16,8,914
25984556@N07,1270,16,1213080305,1213080532,2,8,227
25984556@N07,1270,17,1213081930,1213081930,1,8,0
25984556@N07,1270,29,1213082590,1213083328,7,8,738
25984556@N07,1271,15,1213156583,1213156583,1,3,0
25984556@N07,1271,17,1213164601,1213164710,2,3,109
25984556@N07,1271,29,1213159897,1213162402,10,3,2505
26036520@N00,1272,13,1362724096,1362724096,1,1,0
26052518@N05,1273,9,1348476841,1348484383,4,3,7542
26052518@N05,1273,15,1348478793,1348478793,1,3,0
26052518@N05,1273,29,1348477709,1348477709,1,3,0
26052518@N05,1274,18,1348553298,1348553298,1,1,0
26052518@N05,1275,9,1349579554,1349579554,1,2,0
26052518@N05,1275,29,1349579855,1349579855,1,2,0
26096505@N02,1276,7,1234492932,1234493424,2,1,492
26096505@N02,1277,8,1240636699,1240638193,2,1,1494
26096505@N02,1278,12,1315135560,1315137048,3,1,1488
26197615@N00,1279,15,1276808504,1276808504,1,1,0
26197615@N00,1280,2,1276888810,1276892940,14,1,4130
26226560@N02,1281,9,1313822007,1313824902,5,3,2895
26226560@N02,1281,17,1313824936,1313824936,1,3,0
26226560@N02,1281,29,1313822020,1313823135,2,3,1115
26226560@N02,1282,3,1313896176,1313896176,1,4,0
26226560@N02,1282,9,1313901422,1313901422,1,4,0
26226560@N02,1282,15,1313904797,1313905174,2,4,377
26226560@N02,1282,17,1313902458,1313902458,1,4,0
26226560@N02,1283,9,1313983155,1313985990,5,1,2835
26265986@N00,1284,8,1360888260,1360888260,1,2,0
26265986@N00,1284,15,1360888007,1360888007,1,2,0
26265986@N00,1285,22,1361075406,1361075406,1,1,0
26265986@N00,1286,1,1361160039,1361160039,1,3,0
26265986@N00,1286,3,1361162552,1361162797,3,3,245
26265986@N00,1286,18,1361155604,1361155638,2,3,34
26265986@N00,1287,1,1361328344,1361328351,2,5,7
26265986@N00,1287,16,1361317704,1361317704,1,5,0
26265986@N00,1287,18,1361328691,1361328691,1,5,0
26265986@N00,1287,20,1361335684,1361336366,7,5,682
26265986@N00,1287,27,1361319679,1361321992,5,5,2313
26276803@N05,1288,29,1360554921,1360554921,1,1,0
26276803@N05,1289,29,1360641108,1360641108,1,1,0
26276803@N05,1290,8,1360721440,1360733029,6,6,11589
26276803@N05,1290,9,1360731132,1360731203,3,6,71
26276803@N05,1290,15,1360710929,1360710929,1,6,0
26276803@N05,1290,18,1360710481,1360710508,4,6,27
26276803@N05,1290,19,1360714941,1360715065,3,6,124
26276803@N05,1290,23,1360714907,1360714907,1,6,0
26276803@N05,1291,8,1360830186,1360830186,1,1,0
26295983@N07,1292,19,1213338450,1213339029,8,1,579
26295983@N07,1293,18,1215058885,1215058885,1,1,0
26436271@N00,1294,8,1179710139,1179710728,3,3,589
26436271@N00,1294,15,1179711148,1179712157,3,3,1009
26436271@N00,1294,18,1179714181,1179714301,2,3,120
26503210@N00,1295,19,1298193662,1298193662,1,1,0
26516928@N08,1296,1,1313825878,1313840316,12,1,14438
26516928@N08,1297,1,1313915074,1313915074,1,1,0
26516928@N08,1298,1,1314181102,1314181710,4,1,608
26516928@N08,1299,1,1314267168,1314287386,3,1,20218
26680618@N02,1300,29,1239963385,1239963385,1,1,0
26680618@N02,1301,19,1250762686,1250762686,1,2,0
26680618@N02,1301,28,1250761973,1250761973,1,2,0
26680618@N02,1302,9,1250827293,1250827446,2,4,153
26680618@N02,1302,15,1250827980,1250828217,2,4,237
26680618@N02,1302,16,1250827972,1250827972,1,4,0
26680618@N02,1302,28,1250825896,1250826044,2,4,148
26680618@N02,1303,3,1250858422,1250858466,2,2,44
26680618@N02,1303,28,1250859145,1250860264,4,2,1119
26680618@N02,1304,8,1250925850,1250925850,1,1,0
26680618@N02,1305,28,1251015070,1251015441,4,1,371
26823776@N00,1306,1,1141448769,1141448769,1,1,0
26835091@N04,1307,7,1315356726,1315356726,1,1,0
26835091@N04,1308,13,1348361017,1348361017,1,4,0
26835091@N04,1308,15,1348375872,1348375872,1,4,0
26835091@N04,1308,17,1348368012,1348368247,3,4,235
26835091@N04,1308,28,1348361008,1348361008,1,4,0
26835091@N04,1309,9,1354462199,1354462199,1,1,0
26875202@N05,1310,9,1301003190,1301003190,1,1,0
26875202@N05,1311,29,1301094726,1301094726,1,1,0
26918395@N06,1312,29,1226052227,1226052227,1,1,0
26929313@N02,1313,1,1346404852,1346404852,1,2,0
26929313@N02,1313,9,1346404740,1346404818,2,2,78
27008470@N00,1314,9,1376218422,1376218422,1,1,0
27015067@N00,1315,8,1122525588,1122525704,2,1,116
27015067@N00,1316,15,1149311342,1149311342,1,2,0
27015067@N00,1316,16,1149322003,1149322132,2,2,129
27017895@N02,1317,3,1221872008,1221872008,1,3,0
27017895@N02,1317,17,1221868773,1221868773,1,3,0
27017895@N02,1317,29,1221881185,1221881249,2,3,64
27105072@N00,1318,3,1338952840,1338963064,20,2,10224
27105072@N00,1318,28,1338959233,1338959233,1,2,0
27105072@N00,1319,1,1339040169,1339040868,2,1,699
27105072@N00,1320,3,1339136780,1339138236,2,3,1456
27105072@N00,1320,28,1339137583,1339138199,4,3,616
27105072@N00,1320,29,1339129223,1339129223,1,3,0
27105072@N00,1321,2,1339294112,1339300645,7,1,6533
27195496@N00,1322,11,1364790947,1364790947,1,1,0
27195496@N00,1323,4,1371041355,1371041544,2,3,189
27195496@N00,1323,8,1371039077,1371039241,2,3,164
27195496@N00,1323,9,1371039395,1371039395,1,3,0
27222357@N00,1324,29,1376128874,1376128874,1,1,0
27263012@N00,1325,24,1341032775,1341032775,1,1,0
27293890@N05,1326,8,1102558894,1102561200,2,1,2306
27293890@N05,1327,8,1211165992,1211168120,4,1,2128
27351743@N08,1328,9,1251882203,1251884531,4,1,2328
27384329@N04,1329,13,1212504755,1212506558,7,1,1803
27418987@N03,1330,17,1215245726,1215245726,1,1,0
27418987@N03,1331,17,1215341384,1215341395,2,1,11
27418987@N03,1332,9,1215414239,1215414275,2,1,36
27418987@N03,1333,1,1215566956,1215572556,11,2,5600
27418987@N03,1333,9,1215566514,1215566514,1,2,0
27421581@N00,1334,8,1136265896,1136265896,1,1,0
27421581@N00,1335,6,1146287991,1146287991,1,1,0
27421581@N00,1336,2,1156653822,1156654155,3,1,333
27462949@N00,1337,12,1167252608,1167253245,8,1,637
27462949@N00,1338,4,1211677871,1211677871,1,3,0
27462949@N00,1338,20,1211665121,1211667651,9,3,2530
27462949@N00,1338,22,1211681132,1211681132,1,3,0
27462949@N00,1339,1,1211920188,1211924250,17,5,4062
27462949@N00,1339,3,1211918192,1211919231,6,5,1039
27462949@N00,1339,9,1211925536,1211925757,5,5,221
27462949@N00,1339,10,1211927101,1211930217,8,5,3116
27462949@N00,1339,19,1211925935,1211925935,1,5,0
27462949@N00,1340,8,1212014539,1212017724,5,2,3185
27462949@N00,1340,12,1212033141,1212033272,5,2,131
27466406@N00,1341,29,1143524417,1143524417,1,1,0
27478577@N00,1342,4,1274516235,1274516621,2,1,386
27478577@N00,1343,11,1275810735,1275810735,1,1,0
27539822@N05,1344,1,1299206780,1299206780,1,1,0
27594569@N04,1345,9,1283685191,1283694079,12,4,8888
27594569@N04,1345,17,1283683496,1283694381,6,4,10885
27594569@N04,1345,28,1283683288,1283683347,3,4,59
27594569@N04,1345,29,1283684230,1283693547,3,4,9317
27594569@N04,1346,3,1283768520,1283770595,4,1,2075
27614133@N00,1347,1,1141443963,1141447937,4,2,3974
27614133@N00,1347,11,1141471483,1141472922,2,2,1439
27681741@N06,1348,18,1348217850,1348218269,4,1,419
27681741@N06,1349,3,1348293273,1348295400,18,3,2127
27681741@N06,1349,18,1348291317,1348291746,5,3,429
27681741@N06,1349,19,1348291823,1348298107,5,3,6284
27681741@N06,1350,29,1379668335,1379686581,19,1,18246
27681741@N06,1351,9,1379725326,1379727885,20,4,2559
27681741@N06,1351,10,1379742661,1379742666,2,4,5
27681741@N06,1351,11,1379732492,1379743318,21,4,10826
27681741@N06,1351,23,1379730541,1379731309,5,4,768
27703797@N06,1352,17,1310113560,1310124301,3,1,10741
27703797@N06,1353,28,1310164098,1310164098,1,1,0
27718315@N02,1354,29,524883686,524883686,1,1,0
27718315@N02,1355,12,783608400,783608400,2,1,0
27718315@N02,1356,12,785595607,785595607,1,1,0
27718315@N02,1357,15,1320628568,1320629209,7,1,641
27718315@N02,1358,21,1327101326,1327101431,2,1,105
27718315@N02,1359,21,1328235053,1328235314,5,1,261
27718315@N02,1360,8,1361138206,1361138427,3,2,221
27718315@N02,1360,15,1361138038,1361138055,2,2,17
27718315@N02,1361,21,1373791274,1373791274,1,1,0
27718315@N02,1362,21,1374295940,1374295940,1,1,0
27718315@N02,1363,21,1380188496,1380188812,3,1,316
27718315@N02,1364,21,1383969502,1383969531,2,1,29
27718315@N02,1365,19,1384730567,1384736018,9,1,5451
27718315@N02,1366,21,1384827324,1384827495,3,1,171
27718315@N02,1367,9,1385180121,1385181259,5,3,1138
27718315@N02,1367,19,1385185250,1385186965,4,3,1715
27718315@N02,1367,29,1385176307,1385176599,3,3,292
27718315@N02,1368,19,1388962898,1388962898,1,1,0
27718315@N02,1369,28,1390785832,1390788848,3,1,3016
27718315@N02,1370,28,1390975105,1390975232,4,1,127
27718315@N02,1371,3,1393292177,1393293017,17,2,840
27718315@N02,1371,13,1393292120,1393292120,1,2,0
27718315@N02,1372,16,1397715079,1397715244,3,1,165
27725811@N03,1373,9,1293697261,1293700886,4,2,3625
27725811@N03,1373,10,1293703267,1293703917,2,2,650
27725811@N03,1374,1,1293804481,1293804563,2,1,82
27725811@N03,1375,15,1315135317,1315137714,4,1,2397
27727399@N05,1376,1,1319937315,1319937315,1,1,0
27748658@N06,1377,17,1199327363,1199327363,1,1,0
27748658@N06,1378,8,1216440922,1216440922,1,1,0
27748658@N06,1379,11,1219721646,1219721646,1,2,0
27748658@N06,1379,19,1219721640,1219721640,1,2,0
27748658@N06,1380,19,1227925997,1227925997,1,1,0
27751389@N07,1381,8,1243382935,1243383075,5,1,140
27751389@N07,1382,8,1250640000,1250640000,1,1,0
27758558@N00,1383,8,1324705151,1324725344,3,2,20193
27758558@N00,1383,15,1324700364,1324704902,7,2,4538
27758558@N00,1384,9,1324861564,1324861701,2,2,137
27758558@N00,1384,17,1324861305,1324861305,1,2,0
27758558@N00,1385,1,1324947387,1324966350,12,1,18963
27817416@N02,1386,17,1286496817,1286496817,1,1,0
27817416@N02,1387,19,1286590559,1286590559,1,1,0
27817416@N02,1388,3,1287467005,1287467005,1,1,0
27817416@N02,1389,29,1288130628,1288130628,1,1,0
27817416@N02,1390,3,1288226424,1288227860,3,1,1436
27817416@N02,1391,16,1288312454,1288312454,1,1,0
27817416@N02,1392,9,1292972473,1292972473,1,3,0
27817416@N02,1392,18,1292995711,1292995711,1,3,0
27817416@N02,1392,19,1292981258,1292981258,1,3,0
27817416@N02,1393,15,1293076904,1293077148,2,1,244
27817416@N02,1394,9,1293573431,1293585986,3,3,12555
27817416@N02,1394,15,1293605485,1293605485,1,3,0
27817416@N02,1394,29,1293596433,1293596433,1,3,0
27817416@N02,1395,9,1293657065,1293657065,1,1,0
27817416@N02,1396,3,1293743897,1293743897,1,2,0
27817416@N02,1396,9,1293743615,1293743615,1,2,0
27817416@N02,1397,9,1295559200,1295559200,1,1,0
27817416@N02,1398,12,1296038878,1296038878,1,1,0
27817416@N02,1399,22,1296339132,1296339132,1,1,0
27817416@N02,1400,9,1297891202,1297891202,1,1,0
27817416@N02,1401,9,1297928239,1297928239,1,1,0
27817416@N02,1402,29,1302249649,1302249649,1,1,0
27817416@N02,1403,14,1319522668,1319522668,1,1,0
27817416@N02,1404,1,1322301260,1322301260,1,1,0
27817416@N02,1405,14,1329885576,1329885576,1,1,0
27817416@N02,1406,14,1330479175,1330479175,1,1,0
27817416@N02,1407,22,1331341058,1331341058,1,1,0
27817416@N02,1408,14,1331854224,1331854224,1,1,0
27817416@N02,1409,14,1332482481,1332482481,1,1,0
27817416@N02,1410,12,1332543215,1332543215,1,1,0
27817416@N02,1411,14,1333072921,1333072921,1,1,0
27817416@N02,1412,24,1339906015,1339906015,1,1,0
27817416@N02,1413,14,1340870888,1340870888,1,1,0
27817416@N02,1414,3,1341289920,1341289920,1,1,0
27817416@N02,1415,14,1346137119,1346137119,1,1,0
27817416@N02,1416,20,1348888269,1348903293,3,1,15024
27817416@N02,1417,1,1350992113,1350992113,1,1,0
27817416@N02,1418,13,1351301845,1351301845,1,1,0
27817416@N02,1419,12,1351408453,1351408453,1,2,0
27817416@N02,1419,13,1351389263,1351401786,2,2,12523
27817416@N02,1420,13,1352529487,1352529487,1,1,0
27817416@N02,1421,13,1353814819,1353814819,1,1,0
27817416@N02,1422,13,1355704232,1355712306,2,1,8074
27828336@N00,1423,16,1380163667,1380163667,1,3,0
27828336@N00,1423,18,1380161017,1380167714,3,3,6697
27828336@N00,1423,29,1380166376,1380166376,1,3,0
27917561@N00,1424,10,1311287698,1311287698,1,1,0
27935720@N00,1425,4,1182187749,1182188154,9,1,405
27948364@N00,1426,8,1291099597,1291100864,2,2,1267
27948364@N00,1426,10,1291092260,1291092260,1,2,0
27948364@N00,1427,3,1291185053,1291185053,1,5,0
27948364@N00,1427,9,1291175709,1291175709,1,5,0
27948364@N00,1427,15,1291183562,1291183562,1,5,0
27948364@N00,1427,16,1291183916,1291183916,1,5,0
27948364@N00,1427,29,1291175725,1291184453,2,5,8728
27948364@N00,1428,1,1291262847,1291262847,1,3,0
27948364@N00,1428,3,1291261279,1291261902,3,3,623
27948364@N00,1428,15,1291266481,1291266481,1,3,0
28083126@N05,1429,9,1232165841,1232165841,1,1,0
28083126@N05,1430,28,1284112719,1284119824,11,1,7105
28083126@N05,1431,12,1306893370,1306893438,6,1,68
28103568@N00,1432,8,1348711927,1348711928,2,7,1
28103568@N00,1432,9,1348711924,1348711925,2,7,1
28103568@N00,1432,11,1348711909,1348711915,2,7,6
28103568@N00,1432,16,1348711890,1348711890,1,7,0
28103568@N00,1432,18,1348711896,1348711898,4,7,2
28103568@N00,1432,19,1348711886,1348711922,2,7,36
28103568@N00,1432,23,1348711902,1348711906,2,7,4
28120556@N08,1433,23,1220441249,1220443690,4,1,2441
28120556@N08,1434,11,1245288111,1245288111,1,1,0
28120556@N08,1435,3,1262128196,1262128196,1,2,0
28120556@N08,1435,4,1262144456,1262145166,5,2,710
28120556@N08,1436,29,1262264493,1262264493,1,1,0
28120556@N08,1437,29,1262404603,1262404603,1,1,0
28120556@N08,1438,8,1294195102,1294195102,1,1,0
28120556@N08,1439,13,1356831786,1356831786,1,1,0
28120556@N08,1440,3,1357005479,1357005479,1,2,0
28120556@N08,1440,28,1357004023,1357004023,1,2,0
28120556@N08,1441,8,1357261760,1357261760,1,2,0
28120556@N08,1441,15,1357262076,1357262076,1,2,0
28120556@N08,1442,9,1388452452,1388452452,1,1,0
28120556@N08,1443,9,1388540339,1388540372,2,2,33
28120556@N08,1443,10,1388539106,1388539106,1,2,0
28120556@N08,1444,19,1388625318,1388625318,1,1,0
28145073@N08,1445,10,1251176394,1251176394,1,2,0
28145073@N08,1445,29,1251176157,1251200850,2,2,24693
28211378@N00,1446,1,1270959004,1270959004,1,1,0
28262934@N00,1447,12,1203837063,1203837063,1,1,0
28355390@N03,1448,19,1212553236,1212553236,1,1,0
28355390@N03,1449,8,1213068727,1213068727,1,1,0
28355390@N03,1450,18,1213255702,1213255702,1,1,0
28355390@N03,1451,19,1214205769,1214206470,2,1,701
28355390@N03,1452,9,1214485564,1214485890,2,6,326
28355390@N03,1452,11,1214478312,1214478312,1,6,0
28355390@N03,1452,15,1214483690,1214484106,3,6,416
28355390@N03,1452,16,1214484247,1214484810,2,6,563
28355390@N03,1452,23,1214480040,1214480040,1,6,0
28355390@N03,1452,29,1214485326,1214485326,1,6,0
28355390@N03,1453,8,1214722871,1214722871,1,1,0
28355390@N03,1454,15,1222852853,1222852853,1,1,0
28355390@N03,1455,12,1223136177,1223141742,3,1,5565
28355390@N03,1456,8,1224090487,1224090487,1,1,0
28355390@N03,1457,18,1224424879,1224424879,1,2,0
28355390@N03,1457,19,1224434917,1224434917,1,2,0
28355390@N03,1458,8,1229317959,1229318272,2,1,313
28355390@N03,1459,8,1229420200,1229421263,6,1,1063
28355390@N03,1460,28,1236329857,1236333341,11,1,3484
28355390@N03,1461,19,1239206534,1239206534,1,1,0
28355390@N03,1462,19,1250309453,1250314830,6,1,5377
28355390@N03,1463,9,1250673708,1250674018,2,2,310
28355390@N03,1463,29,1250678998,1250682230,7,2,3232
28355390@N03,1464,13,1251105453,1251105474,2,1,21
28355390@N03,1465,9,1251610984,1251610984,1,2,0
28355390@N03,1465,17,1251610150,1251610150,1,2,0
28355390@N03,1466,10,1252232627,1252234357,12,1,1730
28355390@N03,1467,9,1267786285,1267786285,1,1,0
28355390@N03,1468,19,1271138219,1271138219,1,1,0
28355390@N03,1469,19,1275603918,1275603918,1,1,0
28355390@N03,1470,15,1276049944,1276049944,1,1,0
28370443@N08,1471,2,1188883279,1188889321,8,4,6042
28370443@N08,1471,4,1188882991,1188890226,8,4,7235
28370443@N08,1471,9,1188881555,1188881555,1,4,0
28370443@N08,1471,23,1188881699,1188881699,1,4,0
28404646@N00,1472,28,1210745561,1210745561,1,1,0
28404646@N00,1473,3,1213742556,1213742647,2,4,91
28404646@N00,1473,11,1213762373,1213762373,1,4,0
28404646@N00,1473,19,1213762209,1213762209,1,4,0
28404646@N00,1473,28,1213743016,1213765181,3,4,22165
28404646@N00,1474,17,1213845729,1213845729,1,2,0
28404646@N00,1474,28,1213860632,1213860632,1,2,0
28404646@N00,1475,4,1214016133,1214018983,5,2,2850
28404646@N00,1475,19,1214020770,1214020770,1,2,0
28404646@N00,1476,28,1214368882,1214368882,1,1,0
28404646@N00,1477,19,1214603729,1214603729,1,1,0
28404646@N00,1478,27,1215921222,1215921222,1,1,0
28404646@N00,1479,1,1216202880,1216211686,2,2,8806
28404646@N00,1479,29,1216200735,1216202204,4,2,1469
28404646@N00,1480,19,1216392362,1216392362,1,1,0
28404646@N00,1481,28,1222483768,1222484538,2,1,770
28404646@N00,1482,23,1225185221,1225185221,1,1,0
28404646@N00,1483,4,1226116819,1226116819,1,4,0
28404646@N00,1483,19,1226112373,1226112373,1,4,0
28404646@N00,1483,23,1226116233,1226116233,1,4,0
28404646@N00,1483,24,1226119468,1226119468,1,4,0
28404646@N00,1484,29,1228010557,1228010557,1,1,0
28438944@N00,1485,18,1156670006,1156680910,35,1,10904
28503813@N03,1486,19,1280704727,1280704727,1,2,0
28503813@N03,1486,23,1280726193,1280726193,1,2,0
28536568@N00,1487,1,1249867360,1249871408,6,4,4048
28536568@N00,1487,9,1249863176,1249874546,2,4,11370
28536568@N00,1487,19,1249862584,1249880858,2,4,18274
28536568@N00,1487,29,1249863354,1249873650,2,4,10296
28536568@N00,1488,15,1250029870,1250029870,1,2,0
28536568@N00,1488,18,1250028890,1250029172,2,2,282
28536568@N00,1489,29,1250081478,1250081908,2,1,430
28536568@N00,1490,2,1250132708,1250132708,1,3,0
28536568@N00,1490,4,1250131058,1250131666,3,3,608
28536568@N00,1490,19,1250134934,1250134934,1,3,0
28538076@N00,1491,23,1056422501,1056422501,1,1,0
28543475@N08,1492,3,1218284745,1218286714,40,2,1969
28543475@N08,1492,28,1218308024,1218308566,6,2,542
28543475@N08,1493,9,1218419823,1218419823,1,1,0
28543475@N08,1494,8,1218449304,1218449304,1,1,0
28543475@N08,1495,3,1218617557,1218617975,5,3,418
28543475@N08,1495,17,1218629734,1218645666,46,3,15932
28543475@N08,1495,28,1218649648,1218649811,9,3,163
28543475@N08,1496,9,1218679425,1218718803,12,2,39378
28543475@N08,1496,28,1218695949,1218698321,10,2,2372
28543475@N08,1497,1,1218765659,1218765659,1,2,0
28543475@N08,1497,15,1218772104,1218772222,2,2,118
28543475@N08,1498,28,1218812337,1218812424,3,1,87
28543475@N08,1499,17,1218896565,1218896565,1,2,0
28543475@N08,1499,28,1218887787,1218900005,16,2,12218
28543475@N08,1500,15,1218947379,1218947379,1,1,0
28543475@N08,1501,28,1218983722,1218984016,13,1,294
28543475@N08,1502,28,1219079791,1219079999,6,1,208
28543475@N08,1503,9,1219246086,1219247163,30,2,1077
28543475@N08,1503,28,1219230651,1219231960,2,2,1309
28543475@N08,1504,17,1219406887,1219408462,12,1,1575
28543475@N08,1505,28,1219555478,1219555528,5,1,50
28543475@N08,1506,13,1219595373,1219596065,7,2,692
28543475@N08,1506,28,1219594454,1219594526,3,2,72
28543475@N08,1507,12,1219657788,1219659365,2,3,1577
28543475@N08,1507,13,1219661533,1219663962,12,3,2429
28543475@N08,1507,29,1219657305,1219657426,2,3,121
28638538@N00,1508,1,1194553208,1194556058,4,4,2850
28638538@N00,1508,8,1194550271,1194550271,1,4,0
28638538@N00,1508,9,1194551197,1194551508,4,4,311
28638538@N00,1508,29,1194559624,1194559624,1,4,0
28638538@N00,1509,8,1194646381,1194646381,1,1,0
28638538@N00,1510,3,1194726781,1194726781,1,2,0
28638538@N00,1510,18,1194722950,1194722950,1,2,0
28638538@N00,1511,8,1217117080,1217117192,3,1,112
28638538@N00,1512,8,1217186286,1217186286,1,1,0
28638538@N00,1513,8,1217565152,1217565152,1,1,0
28675485@N05,1514,1,1279108316,1279115104,6,1,6788
28675485@N05,1515,9,1279271878,1279271878,1,1,0
28683534@N00,1516,29,1315014704,1315014704,1,1,0
28891030@N00,1517,13,1154828686,1154828686,1,1,0
28891030@N00,1518,13,1155109719,1155109719,1,1,0
28953876@N04,1519,18,1310369936,1310369936,1,1,0
29019476@N00,1520,27,1306214833,1306220315,2,1,5482
29032147@N03,1521,2,1376032844,1376032844,1,1,0
29057345@N04,1522,3,1382499384,1382499384,1,3,0
29057345@N04,1522,9,1382498546,1382502537,3,3,3991
29057345@N04,1522,22,1382504356,1382507177,2,3,2821
29057345@N04,1523,8,1382592846,1382592846,1,2,0
29057345@N04,1523,10,1382578708,1382578708,1,2,0
29066848@N04,1524,8,1239776333,1239794290,2,1,17957
29066848@N04,1525,18,1304730051,1304730090,2,1,39
29172291@N00,1526,1,1392425619,1392425680,2,9,61
29172291@N00,1526,2,1392432788,1392433137,2,9,349
29172291@N00,1526,3,1392426680,1392427048,8,9,368
29172291@N00,1526,4,1392433176,1392433213,2,9,37
29172291@N00,1526,8,1392438411,1392438411,1,9,0
29172291@N00,1526,9,1392427742,1392427742,1,9,0
29172291@N00,1526,10,1392434962,1392434962,1,9,0
29172291@N00,1526,11,1392434308,1392434818,8,9,510
29172291@N00,1526,29,1392420740,1392425861,12,9,5121
29175795@N00,1527,3,1286673014,1286673014,1,1,0
29263563@N04,1528,29,1282647199,1282648416,48,1,1217
29365083@N06,1529,3,1360207104,1360211467,3,3,4363
29365083@N06,1529,9,1360206532,1360206532,1,3,0
29365083@N06,1529,10,1360202366,1360203441,7,3,1075
29365083@N06,1530,29,1372574016,1372574016,1,1,0
29365083@N06,1531,8,1386401820,1386401820,1,1,0
29559659@N03,1532,1,1313805056,1313805056,1,1,0
29624180@N04,1533,1,1312864273,1312864273,1,4,0
29624180@N04,1533,8,1312879658,1312880301,3,4,643
29624180@N04,1533,9,1312875585,1312877805,3,4,2220
29624180@N04,1533,29,1312874871,1312874871,1,4,0
29624180@N04,1534,3,1313117033,1313121486,7,1,4453
29624180@N04,1535,4,1313205797,1313221835,4,3,16038
29624180@N04,1535,8,1313201426,1313226313,3,3,24887
29624180@N04,1535,24,1313208965,1313208965,1,3,0
29797746@N08,1536,1,1364520597,1364531758,49,12,11161
29797746@N08,1536,2,1364533863,1364535022,15,12,1159
29797746@N08,1536,4,1364535064,1364535444,4,12,380
29797746@N08,1536,8,1364519683,1364547021,11,12,27338
29797746@N08,1536,9,1364519627,1364540094,11,12,20467
29797746@N08,1536,10,1364538186,1364538219,2,12,33
29797746@N08,1536,11,1364533139,1364537991,16,12,4852
29797746@N08,1536,15,1364541611,1364541663,4,12,52
29797746@N08,1536,16,1364519940,1364519940,1,12,0
29797746@N08,1536,19,1364519122,1364539279,6,12,20157
29797746@N08,1536,23,1364536148,1364538943,24,12,2795
29797746@N08,1536,29,1364519675,1364540087,26,12,20412
29812295@N07,1537,1,1224213584,1224217032,24,4,3448
29812295@N07,1537,3,1224218456,1224218456,1,4,0
29812295@N07,1537,17,1224218277,1224218341,2,4,64
29812295@N07,1537,29,1224217818,1224217959,3,4,141
29812295@N07,1538,3,1224385216,1224385216,1,4,0
29812295@N07,1538,9,1224376738,1224376860,2,4,122
29812295@N07,1538,11,1224374120,1224375219,4,4,1099
29812295@N07,1538,23,1224373600,1224375651,2,4,2051
29836657@N07,1539,1,1309829131,1309837481,14,2,8350
29836657@N07,1539,3,1309853851,1309853965,2,2,114
29913312@N04,1540,17,1278152812,1278152812,1,1,0
29978367@N00,1541,3,1260251837,1260251837,1,1,0
29978367@N00,1542,1,1260360422,1260360422,1,5,0
29978367@N00,1542,2,1260329896,1260330534,3,5,638
29978367@N00,1542,3,1260318459,1260342033,2,5,23574
29978367@N00,1542,17,1260318805,1260318805,1,5,0
29978367@N00,1542,29,1260360745,1260360776,2,5,31
29978367@N00,1543,1,1260416081,1260416081,1,2,0
29978367@N00,1543,3,1260406010,1260418151,10,2,12141
29978367@N00,1544,1,1260491717,1260493751,8,1,2034
30007308@N00,1545,1,1321668002,1321668002,1,1,0
30012043@N00,1546,28,1248924769,1248924769,1,1,0
30012043@N00,1547,13,1249353913,1249353913,1,2,0
30012043@N00,1547,28,1249375793,1249375793,1,2,0
30012043@N00,1548,17,1250133563,1250133638,2,2,75
30012043@N00,1548,28,1250142010,1250142010,1,2,0
30012043@N00,1549,13,1251868921,1251868921,1,1,0
30024546@N04,1550,12,1293505861,1293505861,1,2,0
30024546@N04,1550,18,1293494498,1293494498,1,2,0
30024546@N04,1551,29,1293923116,1293925821,4,1,2705
30036325@N00,1552,19,1122545858,1122545858,1,1,0
30079696@N00,1553,3,1240650209,1240650209,1,1,0
30079696@N00,1554,4,1240693510,1240698563,10,2,5053
30079696@N00,1554,24,1240693888,1240695726,3,2,1838
30099537@N02,1555,1,1303187240,1303187240,1,3,0
30099537@N02,1555,8,1303188366,1303188366,1,3,0
30099537@N02,1555,29,1303187029,1303187029,1,3,0
30129139@N04,1556,1,1223699199,1223701267,7,2,2068
30129139@N04,1556,16,1223709751,1223709889,2,2,138
30129139@N04,1557,18,1226716686,1226716686,1,1,0
30129139@N04,1558,8,1228634563,1228635186,2,2,623
30129139@N04,1558,19,1228635396,1228635396,1,2,0
30129139@N04,1559,28,1229140229,1229140288,2,1,59
30129139@N04,1560,3,1356321900,1356321900,1,4,0
30129139@N04,1560,11,1356324597,1356330866,12,4,6269
30129139@N04,1560,23,1356329806,1356329806,1,4,0
30129139@N04,1560,28,1356321211,1356321224,2,4,13
30265340@N00,1561,10,1030802400,1030802400,2,2,0
30265340@N00,1561,15,1030802400,1030802400,1,2,0
30278273@N05,1562,8,1355544303,1355544303,1,1,0
30388231@N03,1563,17,1344414359,1344414359,1,2,0
30388231@N03,1563,29,1344413110,1344413110,1,2,0
30388231@N03,1564,1,1366676319,1366677046,2,1,727
30388231@N03,1565,15,1381642990,1381642990,1,1,0
30409117@N07,1566,12,1295864732,1295865469,3,1,737
30409117@N07,1567,3,1295906865,1295906957,2,3,92
30409117@N07,1567,19,1295934903,1295934903,1,3,0
30409117@N07,1567,28,1295908067,1295932947,17,3,24880
30420228@N05,1568,1,1248744703,1248744703,1,3,0
30420228@N05,1568,3,1248741204,1248744496,24,3,3292
30420228@N05,1568,9,1248740115,1248740584,2,3,469
30420228@N05,1569,1,1250031755,1250031755,1,2,0
30420228@N05,1569,9,1250031527,1250031527,1,2,0
30420228@N05,1570,11,1272440880,1272441873,6,1,993
30441609@N00,1571,14,1183632419,1183640749,4,1,8330
30475040@N06,1572,1,1365216413,1365216413,1,1,0
30511496@N00,1573,1,1343953923,1343953923,1,1,0
30511496@N00,1574,8,1344018327,1344018327,1,2,0
30511496@N00,1574,17,1343998418,1343998418,1,2,0
30671962@N05,1575,9,1250320615,1250321159,3,3,544
30671962@N05,1575,17,1250321654,1250321654,1,3,0
30671962@N05,1575,20,1250337159,1250339070,3,3,1911
30713600@N00,1576,8,1277207975,1277208626,9,2,651
30713600@N00,1576,9,1277205512,1277205526,2,2,14
30713600@N00,1577,1,1277257528,1277265343,6,4,7815
30713600@N00,1577,3,1277280924,1277292683,15,4,11759
30713600@N00,1577,15,1277292806,1277292806,1,4,0
30713600@N00,1577,16,1277292903,1277292903,1,4,0
30721393@N08,1578,1,1020372963,1020373426,2,1,463
30721393@N08,1579,1,1225411876,1225411876,1,1,0
30736255@N03,1580,9,1236074189,1236084951,6,1,10762
30736255@N03,1581,29,1267531325,1267533335,5,1,2010
30789195@N07,1582,9,1257482629,1257492182,5,1,9553
30794408@N00,1583,29,1124361476,1124361476,1,1,0
30794408@N00,1584,7,1134342127,1134342127,1,2,0
30794408@N00,1584,9,1134346974,1134346974,1,2,0
30794408@N00,1585,7,1145018328,1145018328,1,1,0
30794408@N00,1586,7,1156164121,1156164121,1,1,0
30801875@N07,1587,1,1278850864,1278850864,1,2,0
30801875@N07,1587,9,1278855290,1278855290,1,2,0
30801875@N07,1588,3,1278909838,1278909838,1,1,0
30927905@N05,1589,19,1327020233,1327024971,40,1,4738
30963564@N00,1590,28,1322793638,1322793640,2,1,2
30963564@N00,1591,8,1323916835,1323916835,1,2,0
30963564@N00,1591,15,1323916723,1323916723,1,2,0
30963564@N00,1592,15,1326433595,1326433595,1,1,0
30963564@N00,1593,10,1327284817,1327284817,1,2,0
30963564@N00,1593,11,1327284677,1327284677,1,2,0
30963564@N00,1594,7,1329619753,1329619753,1,2,0
30963564@N00,1594,8,1329614745,1329614745,1,2,0
30963564@N00,1595,18,1332976039,1332976039,1,1,0
30963564@N00,1596,8,1335068110,1335069247,3,1,1137
30963564@N00,1597,19,1338437396,1338437396,1,1,0
30963564@N00,1598,24,1338522003,1338522003,1,1,0
30963564@N00,1599,24,1340520456,1340520456,1,1,0
30963564@N00,1600,19,1341546601,1341546601,1,1,0
30963564@N00,1601,9,1343966425,1343966425,1,2,0
30963564@N00,1601,15,1343967279,1343967279,1,2,0
30963564@N00,1602,19,1344087946,1344087946,1,1,0
30963564@N00,1603,18,1344740511,1344740511,1,1,0
30963564@N00,1604,18,1345181172,1345181172,1,1,0
30963564@N00,1605,18,1346557567,1346557567,1,1,0
30963564@N00,1606,23,1348284496,1348284496,1,1,0
30963564@N00,1607,2,1349573571,1349573595,2,3,24
30963564@N00,1607,10,1349589812,1349589812,1,3,0
30963564@N00,1607,16,1349581303,1349581303,1,3,0
30963564@N00,1608,8,1350439222,1350439222,1,1,0
30963564@N00,1609,18,1350775183,1350775183,1,1,0
30963564@N00,1610,11,1350810058,1350810058,1,1,0
30963564@N00,1611,29,1352276658,1352277827,3,1,1169
30963564@N00,1612,19,1354429422,1354429422,1,1,0
30963564@N00,1613,23,1354844871,1354844871,1,1,0
30963564@N00,1614,15,1355626971,1355626971,1,1,0
30963564@N00,1615,10,1357786183,1357786329,2,1,146
30963564@N00,1616,10,1360549051,1360549051,1,1,0
30963564@N00,1617,10,1362967534,1362967534,1,2,0
30963564@N00,1617,11,1362967782,1362967782,1,2,0
30963564@N00,1618,18,1364689425,1364689425,1,1,0
30963564@N00,1619,7,1367866696,1367868496,3,2,1800
30963564@N00,1619,28,1367873865,1367873865,1,2,0
30963564@N00,1620,10,1370830310,1370830310,1,2,0
30963564@N00,1620,11,1370830753,1370830954,2,2,201
30963564@N00,1621,24,1375245249,1375245249,1,1,0
30963564@N00,1622,11,1377479568,1377479568,1,1,0
30969398@N05,1623,9,1250504784,1250504784,1,1,0
30985799@N00,1624,27,946645283,946645283,1,1,0
30985799@N00,1625,9,1013747694,1013747694,1,1,0
30985799@N00,1626,1,1247545017,1247547344,15,5,2327
30985799@N00,1626,3,1247551449,1247556465,3,5,5016
30985799@N00,1626,16,1247544357,1247544453,2,5,96
30985799@N00,1626,17,1247559407,1247559407,1,5,0
30985799@N00,1626,29,1247544852,1247550183,5,5,5331
30985799@N00,1627,4,1283737437,1283737708,2,3,271
30985799@N00,1627,8,1283751430,1283751430,1,3,0
30985799@N00,1627,24,1283738461,1283738585,3,3,124
31044991@N04,1628,29,1354082098,1354082098,1,1,0
31084530@N04,1629,29,1280752500,1280752500,1,1,0
31138122@N00,1630,23,1041348611,1041348611,1,1,0
31172012@N04,1631,4,1284257748,1284257748,1,1,0
31191687@N06,1632,8,1225329155,1225329155,1,1,0
31191687@N06,1633,9,1238480071,1238480071,1,1,0
31191687@N06,1634,8,1243581043,1243581267,2,1,224
31191687@N06,1635,8,1296175404,1296175404,1,1,0
31191687@N06,1636,23,1297386055,1297386055,1,1,0
31191687@N06,1637,15,1298330004,1298330004,1,1,0
31191687@N06,1638,23,1298596251,1298596251,1,1,0
31191687@N06,1639,8,1307679058,1307679058,1,3,0
31191687@N06,1639,15,1307664985,1307665038,3,3,53
31191687@N06,1639,19,1307678952,1307678952,1,3,0
31191687@N06,1640,3,1312945117,1312956986,8,2,11869
31191687@N06,1640,29,1312957272,1312957272,1,2,0
31191687@N06,1641,9,1322189723,1322189723,1,1,0
31191687@N06,1642,1,1323395998,1323395998,1,1,0
31191687@N06,1643,23,1360199153,1360199153,1,1,0
31287422@N04,1644,16,1251099099,1251099099,1,1,0
31337109@N03,1645,8,1241303743,1241304080,2,2,337
31337109@N03,1645,15,1241302499,1241302499,1,2,0
31343315@N07,1646,18,1236454463,1236454490,2,1,27
31354286@N00,1647,8,1154722222,1154750559,7,1,28337
31354286@N00,1648,8,1154813657,1154830338,133,1,16681
31363435@N07,1649,29,1048211557,1048219563,2,1,8006
31363435@N07,1650,9,1048299335,1048299632,2,1,297
31363435@N07,1651,3,1252497031,1252497272,2,6,241
31363435@N07,1651,9,1252466707,1252498071,10,6,31364
31363435@N07,1651,17,1252486870,1252486870,1,6,0
31363435@N07,1651,18,1252480210,1252480210,1,6,0
31363435@N07,1651,19,1252487607,1252490497,3,6,2890
31363435@N07,1651,29,1252481734,1252485877,3,6,4143
31363435@N07,1652,3,1252551186,1252552595,4,8,1409
31363435@N07,1652,9,1252541713,1252568526,22,8,26813
31363435@N07,1652,10,1252573549,1252575020,2,8,1471
31363435@N07,1652,11,1252573849,1252575707,7,8,1858
31363435@N07,1652,17,1252544662,1252565692,4,8,21030
31363435@N07,1652,19,1252540941,1252541305,2,8,364
31363435@N07,1652,23,1252540041,1252572369,7,8,32328
31363435@N07,1652,29,1252545943,1252566731,10,8,20788
31363435@N07,1653,2,1252628275,1252628275,1,2,0
31363435@N07,1653,4,1252627670,1252628004,4,2,334
31363435@N07,1654,24,1368941787,1368941787,1,1,0
31364620@N06,1655,8,1279349721,1279349721,1,1,0
31397036@N00,1656,1,1238470803,1238474812,11,3,4009
31397036@N00,1656,17,1238467828,1238467828,1,3,0
31397036@N00,1656,29,1238470077,1238470102,2,3,25
31404528@N02,1657,29,1350999679,1350999679,1,1,0
31404528@N02,1658,8,1358278965,1358287544,5,1,8579
31404528@N02,1659,8,1358334103,1358334251,2,2,148
31404528@N02,1659,29,1358334353,1358334353,1,2,0
31404528@N02,1660,8,1358391017,1358418905,2,1,27888
31404528@N02,1661,13,1358677395,1358677395,1,1,0
31428014@N00,1662,19,1269597755,1269597755,1,1,0
31438571@N07,1663,29,1339557519,1339576324,18,1,18805
31438571@N07,1664,29,1339673564,1339673568,3,1,4
31438571@N07,1665,28,1341995482,1341998308,3,1,2826
31438571@N07,1666,12,1344317274,1344317381,6,2,107
31438571@N07,1666,29,1344321803,1344322731,12,2,928
31438571@N07,1667,13,1377228611,1377250065,3,1,21454
31438571@N07,1668,4,1390894616,1390900782,2,1,6166
31450835@N05,1669,3,1313641362,1313647493,24,7,6131
31450835@N05,1669,8,1313628842,1313649078,5,7,20236
31450835@N05,1669,9,1313631656,1313648995,45,7,17339
31450835@N05,1669,16,1313629382,1313629720,3,7,338
31450835@N05,1669,17,1313632268,1313640588,9,7,8320
31450835@N05,1669,28,1313644449,1313644671,2,7,222
31450835@N05,1669,29,1313629904,1313631210,17,7,1306
31484134@N00,1670,11,1199150773,1199150773,1,1,0
31484134@N00,1671,3,1314621421,1314621507,2,1,86
31484134@N00,1672,18,1317447907,1317447907,1,1,0
31484134@N00,1673,12,1317615008,1317615008,1,1,0
31484134@N00,1674,18,1318729137,1318729137,1,1,0
31484134@N00,1675,8,1319023105,1319023105,1,1,0
31484134@N00,1676,9,1319845917,1319845917,1,1,0
31484134@N00,1677,15,1319946963,1319946963,1,1,0
31484134@N00,1678,1,1322382625,1322382978,2,2,353
31484134@N00,1678,29,1322365101,1322365101,1,2,0
31484134@N00,1679,13,1383542237,1383542237,1,1,0
31612046@N04,1680,1,1313298144,1313299006,2,4,862
31612046@N04,1680,4,1313293316,1313314336,2,4,21020
31612046@N04,1680,9,1313297071,1313297071,1,4,0
31612046@N04,1680,17,1313316057,1313316057,1,4,0
31779925@N00,1681,19,1334759568,1334759790,5,1,222
31803571@N02,1682,1,1375506713,1375511564,6,2,4851
31803571@N02,1682,29,1375491275,1375495379,2,2,4104
31803571@N02,1683,2,1375581627,1375585726,11,3,4099
31803571@N02,1683,23,1375579169,1375579273,2,3,104
31803571@N02,1683,29,1375601651,1375606656,11,3,5005
31902638@N06,1684,1,1374295239,1374301032,6,1,5793
31948924@N03,1685,8,1251527322,1251527604,2,2,282
31948924@N03,1685,18,1251527785,1251527785,1,2,0
31975014@N03,1686,9,1190744713,1190747138,3,1,2425
32052968@N00,1687,8,1158489129,1158489129,1,2,0
32052968@N00,1687,29,1158488445,1158488445,1,2,0
32052968@N00,1688,11,1158551981,1158551981,1,2,0
32052968@N00,1688,14,1158543169,1158547012,2,2,3843
32054787@N00,1689,2,1010057093,1010062182,24,1,5089
32054787@N00,1690,9,1010148498,1010148498,1,1,0
32054787@N00,1691,2,1233386060,1233386060,1,1,0
32054787@N00,1692,4,1302940619,1302940766,3,3,147
32054787@N00,1692,9,1302939385,1302939910,4,3,525
32054787@N00,1692,17,1302938878,1302939298,6,3,420
32054787@N00,1693,9,1303031801,1303031801,1,1,0
32054787@N00,1694,3,1307427727,1307427727,1,1,0
32054787@N00,1695,3,1308283294,1308283350,3,1,56
32054787@N00,1696,3,1308457914,1308461622,14,1,3708
32054787@N00,1697,3,1312676703,1312685168,108,1,8465
32054787@N00,1698,3,1325127850,1325130720,35,1,2870
32054787@N00,1699,3,1325636246,1325638083,24,1,1837
32054787@N00,1700,2,1352506220,1352516974,19,3,10754
32054787@N00,1700,9,1352522129,1352522141,3,3,12
32054787@N00,1700,17,1352531914,1352531914,1,3,0
32054787@N00,1701,2,1353211569,1353211569,1,1,0
32109534@N02,1702,9,1256699779,1256699779,1,2,0
32109534@N02,1702,29,1256699574,1256699580,2,2,6
32111003@N00,1703,8,1230447043,1230449736,8,4,2693
32111003@N00,1703,15,1230450030,1230450030,1,4,0
32111003@N00,1703,16,1230450552,1230450632,2,4,80
32111003@N00,1703,29,1230445924,1230446294,4,4,370
32111003@N00,1704,8,1230620582,1230621653,8,1,1071
32111003@N00,1705,18,1240109919,1240110148,2,1,229
32111003@N00,1706,4,1241242714,1241242714,1,2,0
32111003@N00,1706,12,1241232186,1241232186,1,2,0
32111003@N00,1707,9,1250406087,1250427545,9,2,21458
32111003@N00,1707,17,1250405882,1250405882,1,2,0
32136271@N08,1708,1,1371014988,1371014988,1,1,0
32218949@N06,1709,1,1192413731,1192420434,2,1,6703
32218949@N06,1710,1,1192511761,1192511761,1,1,0
32218949@N06,1711,1,1228476759,1228476759,1,1,0
32218949@N06,1712,1,1229735148,1229756186,2,1,21038
32263295@N00,1713,13,1188194095,1188194095,1,1,0
32263295@N00,1714,15,1188284825,1188284825,1,3,0
32263295@N00,1714,19,1188285074,1188288285,3,3,3211
32263295@N00,1714,28,1188290176,1188290221,2,3,45
32263295@N00,1715,28,1219653021,1219681314,6,1,28293
32263295@N00,1716,12,1251366966,1251366983,3,1,17
32263295@N00,1717,8,1251537880,1251537926,2,4,46
32263295@N00,1717,13,1251513474,1251513474,1,4,0
32263295@N00,1717,15,1251537662,1251537675,2,4,13
32263295@N00,1717,28,1251539704,1251539719,2,4,15
32275661@N00,1718,9,1156384619,1156403141,28,1,18522
32275661@N00,1719,9,1156563032,1156577149,4,1,14117
32280754@N05,1720,8,1253145294,1253145294,1,1,0
32280754@N05,1721,11,1291198239,1291198239,1,1,0
32280754@N05,1722,20,1303003297,1303003297,1,1,0
32280754@N05,1723,8,1303609111,1303609111,1,1,0
32280754@N05,1724,27,1312105437,1312105437,1,1,0
32280754@N05,1725,3,1312703732,1312703732,1,1,0
32280754@N05,1726,3,1313312229,1313312229,1,1,0
32280754@N05,1727,11,1314409085,1314409085,1,1,0
32280754@N05,1728,4,1317450225,1317450225,1,2,0
32280754@N05,1728,19,1317446929,1317446929,1,2,0
32280754@N05,1729,20,1320555143,1320555143,1,1,0
32280754@N05,1730,20,1330849288,1330849288,1,1,0
32280754@N05,1731,12,1336440894,1336448076,4,2,7182
32280754@N05,1731,17,1336448551,1336448551,1,2,0
32280754@N05,1732,8,1337501760,1337501760,1,1,0
32280754@N05,1733,20,1337592329,1337592329,1,1,0
32280754@N05,1734,29,1339624207,1339624207,1,1,0
32280754@N05,1735,16,1341033575,1341033575,1,2,0
32280754@N05,1735,29,1341033504,1341033504,1,2,0
32280754@N05,1736,29,1344595435,1344595435,1,1,0
32280754@N05,1737,29,1345939743,1345939743,1,1,0
32280754@N05,1738,11,1351496569,1351496569,1,1,0
32280754@N05,1739,20,1351916832,1351916947,2,1,115
32280754@N05,1740,8,1351988838,1351988838,1,1,0
32280754@N05,1741,16,1361672523,1361672523,1,2,0
32280754@N05,1741,18,1361670927,1361670927,1,2,0
32280754@N05,1742,14,1367813643,1367813643,1,1,0
32280754@N05,1743,17,1372221782,1372221782,1,1,0
32280754@N05,1744,8,1385886998,1385887262,2,1,264
32280754@N05,1745,11,1388499026,1388499026,1,1,0
32280754@N05,1746,8,1388831378,1388831378,1,1,0
32329639@N00,1747,4,1187056486,1187057536,4,6,1050
32329639@N00,1747,8,1187034056,1187034832,3,6,776
32329639@N00,1747,9,1187050568,1187050568,1,6,0
32329639@N00,1747,15,1187036071,1187036071,1,6,0
32329639@N00,1747,18,1187037156,1187037156,1,6,0
32329639@N00,1747,29,1187041406,1187050287,4,6,8881
32368927@N02,1748,15,1247733149,1247733149,1,1,0
32397300@N04,1749,28,1288656234,1288679750,25,1,23516
32397300@N04,1750,28,1288920734,1288920734,1,1,0
32397300@N04,1751,14,1395104901,1395106048,4,1,1147
32399776@N00,1752,9,1187453256,1187453256,1,1,0
32399776@N00,1753,9,1282356896,1282358477,3,2,1581
32399776@N00,1753,17,1282355678,1282355678,1,2,0
32399776@N00,1754,16,1360466807,1360467148,2,1,341
32399776@N00,1755,16,1360582627,1360582627,1,1,0
32401601@N00,1756,29,1187949523,1187955015,34,1,5492
32401601@N00,1757,16,1220181079,1220183173,16,1,2094
32401601@N00,1758,27,1277610873,1277611403,2,1,530
32401601@N00,1759,9,1281666876,1281666876,1,1,0
32401601@N00,1760,3,1281759843,1281759843,1,2,0
32401601@N00,1760,9,1281757485,1281759071,7,2,1586
32481757@N04,1761,1,1344910397,1344912642,4,7,2245
32481757@N04,1761,2,1344926991,1344927960,4,7,969
32481757@N04,1761,4,1344925125,1344928546,4,7,3421
32481757@N04,1761,9,1344905487,1344905497,2,7,10
32481757@N04,1761,17,1344904503,1344904503,1,7,0
32481757@N04,1761,23,1344903804,1344904154,2,7,350
32481757@N04,1761,29,1344905674,1344918800,2,7,13126
32481757@N04,1762,29,1345010055,1345010191,2,1,136
32481757@N04,1763,2,1345966415,1345966415,1,1,0
32662153@N00,1764,8,1074304300,1074304300,1,1,0
32693718@N07,1765,3,833896822,833896822,1,3,0
32693718@N07,1765,18,833896806,833896806,1,3,0
32693718@N07,1765,19,833896817,833896824,5,3,7
32693718@N07,1766,19,833983205,833983205,1,1,0
32697239@N04,1767,1,1380439842,1380439842,1,1,0
32714545@N05,1768,15,1339904560,1339904560,1,1,0
32714545@N05,1769,3,1340500628,1340500628,1,1,0
32738308@N02,1770,27,1294399999,1294399999,1,1,0
32738308@N02,1771,9,1295920876,1295921598,6,1,722
32738308@N02,1772,14,1300520552,1300520552,1,1,0
32744787@N08,1773,29,1351475430,1351475430,1,1,0
32812410@N06,1774,1,1280452901,1280456982,38,7,4081
32812410@N06,1774,3,1280477533,1280480923,2,7,3390
32812410@N06,1774,9,1280461124,1280461144,3,7,20
32812410@N06,1774,15,1280487320,1280488539,7,7,1219
32812410@N06,1774,18,1280488820,1280489074,2,7,254
32812410@N06,1774,19,1280462386,1280462391,2,7,5
32812410@N06,1774,29,1280458632,1280460949,22,7,2317
32812410@N06,1775,18,1280545584,1280551099,2,2,5515
32812410@N06,1775,19,1280558713,1280560341,30,2,1628
32934461@N00,1776,1,1338935820,1338953582,58,2,17762
32934461@N00,1776,29,1338954098,1338954098,1,2,0
32974871@N00,1777,9,1221365791,1221369527,2,1,3736
32974871@N00,1778,9,1231639830,1231639830,1,1,0
32974871@N00,1779,28,1284195900,1284195900,1,1,0
33064737@N06,1780,29,1254098904,1254098904,1,1,0
33131636@N00,1781,9,1351375429,1351375429,1,1,0
33148051@N00,1782,12,1163882183,1163882183,1,1,0
33189575@N05,1783,15,1156729013,1156729013,1,1,0
33237963@N00,1784,1,1186832975,1186841248,160,1,8273
33241781@N00,1785,19,1291279853,1291279853,1,1,0
33241781@N00,1786,1,1302678500,1302678500,1,1,0
33241781@N00,1787,2,1302926355,1302926355,1,1,0
33241781@N00,1788,4,1308446402,1308446402,1,1,0
33241781@N00,1789,10,1325335452,1325335452,1,1,0
33241781@N00,1790,21,1358122176,1358122176,2,1,0
33241781@N00,1791,21,1358205875,1358205875,1,2,0
33241781@N00,1791,23,1358203100,1358203196,2,2,96
33241781@N00,1792,21,1358306281,1358306281,1,1,0
33241781@N00,1793,11,1358379776,1358379776,1,2,0
33241781@N00,1793,19,1358380383,1358380383,1,2,0
33241781@N00,1794,24,1358913785,1358913930,3,1,145
33278177@N00,1795,1,1228207512,1228207512,1,1,0
33278177@N00,1796,1,1228991882,1228991882,1,1,0
33278177@N00,1797,8,1243145333,1243146147,2,1,814
33278177@N00,1798,10,1243223476,1243226665,2,1,3189
33278177@N00,1799,1,1243318751,1243318751,1,3,0
33278177@N00,1799,4,1243292262,1243311028,5,3,18766
33278177@N00,1799,18,1243315093,1243315093,1,3,0
33278177@N00,1800,20,1243384826,1243386195,3,1,1369
33278177@N00,1801,8,1243947461,1243947461,1,1,0
33278177@N00,1802,8,1278334017,1278334017,1,1,0
33317626@N07,1803,29,1212318732,1212318732,1,1,0
33333470@N00,1804,29,1218884938,1218892434,74,1,7496
33506067@N00,1805,10,1180265284,1180265284,1,1,0
33563858@N00,1806,3,1218859748,1218859748,1,1,0
33565152@N00,1807,12,1251429151,1251429151,1,2,0
33565152@N00,1807,18,1251438569,1251440430,8,2,1861
33565152@N00,1808,3,1251512640,1251512640,1,1,0
33565152@N00,1809,3,1251546040,1251546040,1,1,0
33598632@N00,1810,29,1148778055,1148782884,9,1,4829
33613749@N00,1811,1,1215904908,1215918719,13,4,13811
33613749@N00,1811,9,1215905906,1215936715,11,4,30809
33613749@N00,1811,15,1215937714,1215939290,22,4,1576
33613749@N00,1811,29,1215915801,1215917036,3,4,1235
33633351@N00,1812,9,1252749310,1252749310,1,1,0
33705286@N08,1813,9,1266344308,1266345377,5,1,1069
33705286@N08,1814,9,1271330710,1271334740,6,1,4030
33705286@N08,1815,9,1271475244,1271475630,2,1,386
33705286@N08,1816,9,1271855403,1271855403,1,1,0
33739230@N02,1817,18,1154924902,1154924902,1,1,0
33747292@N08,1818,3,1267077510,1267077510,1,1,0
33747292@N08,1819,8,1267247236,1267247236,1,1,0
33925347@N05,1820,15,1192657210,1192657210,1,1,0
33925347@N05,1821,9,1233535414,1233535414,1,4,0
33925347@N05,1821,12,1233534321,1233534321,1,4,0
33925347@N05,1821,15,1233534047,1233534047,1,4,0
33925347@N05,1821,19,1233535345,1233535345,1,4,0
34093087@N03,1822,28,1306108344,1306108344,1,1,0
34427470616@N01,1823,3,1093067869,1093068496,5,1,627
34427470616@N01,1824,3,1109994160,1110003896,2,2,9736
34427470616@N01,1824,12,1110027897,1110028527,3,2,630
34427470616@N01,1825,9,1110083775,1110083775,1,1,0
34427470616@N01,1826,9,1111099434,1111099434,1,1,0
34427470616@N01,1827,12,1111850184,1111850200,2,1,16
34427470616@N01,1828,3,1117062612,1117063072,15,1,460
34427470616@N01,1829,9,1119068670,1119068670,1,1,0
34427470616@N01,1830,20,1119767098,1119767241,3,1,143
34427470616@N01,1831,15,1120283778,1120283778,1,2,0
34427470616@N01,1831,18,1120283923,1120283923,1,2,0
34427470616@N01,1832,11,1122107037,1122107037,1,2,0
34427470616@N01,1832,23,1122107248,1122107248,1,2,0
34427470616@N01,1833,24,1128690867,1128693281,10,1,2414
34427470616@N01,1834,15,1134889655,1134889655,1,1,0
34427470616@N01,1835,9,1138588039,1138588103,2,2,64
34427470616@N01,1835,29,1138587840,1138587904,2,2,64
34427470616@N01,1836,3,1150602858,1150602858,1,1,0
34427470616@N01,1837,19,1156563090,1156563090,1,1,0
34427470616@N01,1838,12,1165636510,1165636510,1,1,0
34427470616@N01,1839,3,1166484485,1166484638,4,4,153
34427470616@N01,1839,9,1166486401,1166486401,1,4,0
34427470616@N01,1839,12,1166502804,1166502804,1,4,0
34427470616@N01,1839,29,1166486305,1166486336,3,4,31
34427470616@N01,1840,19,1168052608,1168052608,1,1,0
34427470616@N01,1841,13,1171681872,1171681872,1,1,0
34427470616@N01,1842,20,1171771776,1171772386,11,1,610
34427470616@N01,1843,9,1172367146,1172367146,1,1,0
34427470616@N01,1844,13,1177757863,1177757863,1,1,0
34427470616@N01,1845,3,1177806052,1177806052,1,2,0
34427470616@N01,1845,29,1177806665,1177806665,1,2,0
34427470616@N01,1846,19,1178347069,1178347077,2,1,8
34427470616@N01,1847,8,1180740570,1180740570,1,2,0
34427470616@N01,1847,29,1180748375,1180748375,1,2,0
34427470616@N01,1848,9,1181805234,1181805234,1,1,0
34427470616@N01,1849,29,1182085886,1182085899,2,1,13
34427470616@N01,1850,9,1183150418,1183150571,2,4,153
34427470616@N01,1850,12,1183165168,1183165168,1,4,0
34427470616@N01,1850,13,1183161523,1183161523,1,4,0
34427470616@N01,1850,20,1183172440,1183208164,45,4,35724
34427470616@N01,1851,3,1183263545,1183263545,1,1,0
34427470616@N01,1852,18,1185611325,1185611325,1,1,0
34427470616@N01,1853,3,1187425360,1187425360,1,1,0
34427470616@N01,1854,13,1189207717,1189207717,1,2,0
34427470616@N01,1854,15,1189233993,1189233993,1,2,0
34427470616@N01,1855,19,1189301181,1189301181,1,1,0
34427470616@N01,1856,20,1189393327,1189393327,1,1,0
34427470616@N01,1857,19,1191317638,1191317654,3,1,16
34427470616@N01,1858,3,1192147788,1192147788,1,1,0
34427470616@N01,1859,23,1226721021,1226721021,1,1,0
34427470616@N01,1860,18,1233965469,1233965469,1,1,0
34427470616@N01,1861,22,1235181452,1235181452,1,2,0
34427470616@N01,1861,29,1235184666,1235184720,2,2,54
34427470616@N01,1862,3,1356318462,1356318462,1,4,0
34427470616@N01,1862,9,1356317550,1356319918,2,4,2368
34427470616@N01,1862,28,1356317878,1356317965,2,4,87
34427470616@N01,1862,29,1356319374,1356319374,1,4,0
34645594@N07,1863,29,1085274018,1085274018,1,1,0
34645594@N07,1864,9,1085765043,1085765170,2,1,127
34645594@N07,1865,3,1085794260,1085794260,1,1,0
34645594@N07,1866,9,1232881973,1232883549,2,1,1576
34666709@N00,1867,8,1322571138,1322571138,1,1,0
34666709@N00,1868,1,1322708026,1322724633,4,2,16607
34666709@N00,1868,8,1322707866,1322707866,1,2,0
34666709@N00,1869,1,1327048744,1327048744,1,1,0
34666709@N00,1870,29,1347702042,1347702042,1,1,0
34666709@N00,1871,9,1347754304,1347754304,1,1,0
34666709@N00,1872,29,1373966356,1373968012,3,1,1656
34791752@N08,1873,23,1247553643,1247553643,1,1,0
34792843@N04,1874,1,1385679569,1385686741,5,3,7172
34792843@N04,1874,15,1385703198,1385705386,2,3,2188
34792843@N04,1874,18,1385676357,1385676533,2,3,176
34792843@N04,1875,9,1385787314,1385787314,1,4,0
34792843@N04,1875,17,1385776411,1385776411,1,4,0
34792843@N04,1875,18,1385785435,1385785435,1,4,0
34792843@N04,1875,29,1385789329,1385789329,1,4,0
34961066@N00,1876,4,1124010082,1124010082,1,3,0
34961066@N00,1876,9,1124010826,1124010826,1,3,0
34961066@N00,1876,29,1124010082,1124010082,1,3,0
35034346050@N01,1877,16,1291962581,1291962581,1,1,0
35034349172@N01,1878,18,1289532378,1289532378,1,1,0
35034349972@N01,1879,19,1121182925,1121183056,3,1,131
35034349972@N01,1880,28,1218143190,1218143190,1,1,0
35034351963@N01,1881,8,1302125340,1302125340,1,1,0
35034357529@N01,1882,29,1268274848,1268275107,2,1,259
35034357529@N01,1883,15,1281418119,1281418119,1,1,0
35034357529@N01,1884,9,1282710816,1282717209,6,3,6393
35034357529@N01,1884,15,1282711799,1282711857,3,3,58
35034357529@N01,1884,16,1282711544,1282711544,1,3,0
35034357529@N01,1885,8,1292398768,1292399029,4,2,261
35034357529@N01,1885,15,1292398538,1292398676,3,2,138
35034357529@N01,1886,15,1292815063,1292815063,1,1,0
35034357529@N01,1887,3,1315965540,1315965970,2,1,430
35034357529@N01,1888,1,1338794480,1338794482,6,1,2
35034358497@N01,1889,1,1351729445,1351729445,1,1,0
35034358497@N01,1890,15,1351856067,1351856067,1,1,0
35034363039@N01,1891,1,1351914064,1351914763,6,1,699
35093899@N00,1892,7,1303203011,1303204430,5,1,1419
35142635@N05,1893,20,1349750350,1349756609,38,1,6259
35144577@N00,1894,9,1248998900,1249023431,6,1,24531
35144577@N00,1895,9,1249089456,1249099104,3,1,9648
35153835@N04,1896,13,1234768534,1234771469,14,1,2935
35243814@N00,1897,8,1132202816,1132202816,1,1,0
35243814@N00,1898,14,1146278234,1146278794,6,1,560
35243814@N00,1899,14,1147291610,1147291652,2,1,42
35243814@N00,1900,14,1147380482,1147380482,3,1,0
35243814@N00,1901,14,1159406450,1159425705,4,1,19255
35346694@N07,1902,12,1312167088,1312167088,1,2,0
35346694@N07,1902,29,1312183534,1312183534,1,2,0
35346694@N07,1903,1,1312273469,1312273469,1,1,0
35346694@N07,1904,12,1312446400,1312446400,1,1,0
35468139015@N01,1905,29,1121008560,1121009320,14,1,760
35468139015@N01,1906,29,1121103079,1121103079,1,1,0
35468140287@N01,1907,12,1092924010,1092924868,6,1,858
35468140287@N01,1908,21,1093249601,1093249619,5,1,18
35468140287@N01,1909,21,1093414154,1093414197,2,1,43
35468140287@N01,1910,21,1101833814,1101833814,1,1,0
35468140287@N01,1911,21,1102005901,1102005901,1,1,0
35468140287@N01,1912,12,1103775672,1103775704,29,1,32
35468140287@N01,1913,3,1187089246,1187097242,5,1,7996
35468140287@N01,1914,12,1260315879,1260315879,1,1,0
35468140287@N01,1915,12,1262771312,1262771312,1,1,0
35468140287@N01,1916,12,1284602078,1284602238,2,1,160
35468140287@N01,1917,12,1285915970,1285915979,2,1,9
35468147630@N01,1918,17,1382528195,1382528195,1,1,0
35468147630@N01,1919,12,1382735915,1382735915,1,1,0
35468158824@N01,1920,13,1187362532,1187363363,2,1,831
35468158824@N01,1921,28,1187438308,1187438308,1,1,0
35468158824@N01,1922,9,1187573140,1187573140,1,1,0
35468158824@N01,1923,17,1250993217,1250993217,1,1,0
35468158824@N01,1924,9,1251351137,1251352459,8,2,1322
35468158824@N01,1924,29,1251352747,1251352929,2,2,182
35468158824@N01,1925,29,1345278652,1345278652,1,1,0
35468158824@N01,1926,3,1345521787,1345521787,1,2,0
35468158824@N01,1926,13,1345532463,1345532463,1,2,0
35468158824@N01,1927,4,1345779623,1345780639,2,2,1016
35468158824@N01,1927,13,1345791237,1345802931,2,2,11694
35468158824@N01,1928,17,1375505947,1375505947,1,2,0
35468158824@N01,1928,19,1375504364,1375504364,1,2,0
35468158824@N01,1929,9,1375786287,1375786287,1,2,0
35468158824@N01,1929,13,1375793191,1375793191,1,2,0
35468158824@N01,1930,29,1375841132,1375846281,8,1,5149
35468159247@N01,1931,3,1187940617,1187940861,2,1,244
35468159247@N01,1932,8,1188108633,1188109144,3,2,511
35468159247@N01,1932,15,1188109711,1188112299,3,2,2588
35475341@N00,1933,8,1355010451,1355010451,1,1,0
35475341@N00,1934,7,1359175960,1359175960,1,1,0
35516567@N04,1935,3,1360037169,1360040166,2,2,2997
35516567@N04,1935,12,1360026521,1360026521,1,2,0
35516567@N04,1936,16,1360114274,1360114274,1,2,0
35516567@N04,1936,29,1360123371,1360123371,1,2,0
35558720@N03,1937,29,1313451080,1313451193,2,1,113
35558720@N03,1938,29,1314277910,1314278307,3,1,397
35583056@N00,1939,1,1245217818,1245217818,1,1,0
35583056@N00,1940,8,1245264426,1245264426,1,1,0
35583056@N00,1941,1,1245355265,1245359506,2,1,4241
35583056@N00,1942,1,1245597406,1245597406,1,1,0
35583056@N00,1943,27,1245888434,1245888434,1,1,0
35583056@N00,1944,18,1246068159,1246068159,1,1,0
35583056@N00,1945,18,1246230306,1246230306,1,1,0
35583056@N00,1946,24,1246300496,1246300496,1,1,0
35584803@N00,1947,3,1341999858,1342000220,6,2,362
35584803@N00,1947,28,1342000345,1342000345,1,2,0
35584803@N00,1948,8,1342099596,1342099596,1,1,0
35584803@N00,1949,9,1342159909,1342160060,5,1,151
35584803@N00,1950,1,1342246782,1342246792,2,2,10
35584803@N00,1950,29,1342248358,1342248358,1,2,0
35610348@N02,1951,11,1202518717,1202519635,3,1,918
35610348@N02,1952,1,1202578512,1202588180,9,2,9668
35610348@N02,1952,4,1202598055,1202598055,1,2,0
35703376@N00,1953,1,620575200,620575200,1,3,0
35703376@N00,1953,2,620575200,620575200,1,3,0
35703376@N00,1953,29,620575200,620575200,1,3,0
35808964@N06,1954,9,1246710621,1246710621,1,1,0
35854555@N04,1955,1,1249951582,1249951582,1,1,0
35854555@N04,1956,1,1249995410,1249995410,1,1,0
35884190@N00,1957,28,1219297913,1219297913,1,1,0
35884190@N00,1958,2,1345447076,1345447165,2,2,89
35884190@N00,1958,10,1345446552,1345446552,1,2,0
35884190@N00,1959,1,1345535961,1345535961,1,1,0
35884190@N00,1960,27,1376373364,1376373681,2,1,317
35903765@N03,1961,28,1204704113,1204712345,11,1,8232
36037277@N07,1962,18,1250494695,1250494695,1,1,0
36037277@N07,1963,1,1306390378,1306392741,2,1,2363
36037277@N07,1964,11,1376616588,1376616588,1,1,0
36101699310@N01,1965,8,1262323901,1262323901,1,5,0
36101699310@N01,1965,9,1262324978,1262324978,1,5,0
36101699310@N01,1965,10,1262315966,1262315966,1,5,0
36101699310@N01,1965,15,1262303902,1262303902,1,5,0
36101699310@N01,1965,19,1262314703,1262314703,1,5,0
36101699310@N01,1966,4,1262394383,1262394383,1,4,0
36101699310@N01,1966,8,1262403848,1262403848,1,4,0
36101699310@N01,1966,24,1262395333,1262395333,1,4,0
36101699310@N01,1966,29,1262391724,1262391724,1,4,0
36101699310@N01,1967,10,1262474020,1262474282,2,2,262
36101699310@N01,1967,18,1262469629,1262469824,2,2,195
36378366@N00,1968,9,1280798019,1280798876,13,1,857
36378366@N00,1969,9,1280878431,1280878465,3,2,34
36378366@N00,1969,27,1280883744,1280888571,12,2,4827
36424619@N00,1970,3,1139711349,1139723399,6,4,12050
36424619@N00,1970,4,1139708178,1139709565,3,4,1387
36424619@N00,1970,7,1139704104,1139707248,18,4,3144
36424619@N00,1970,23,1139710522,1139710873,4,4,351
36521964974@N01,1971,14,1139231281,1139231429,10,1,148
36521964974@N01,1972,14,1140319041,1140319056,2,1,15
36521964974@N01,1973,1,1141551026,1141551026,1,2,0
36521964974@N01,1973,14,1141550875,1141550923,4,2,48
36521964974@N01,1974,14,1144067288,1144067288,1,1,0
36521964974@N01,1975,8,1152496769,1152496769,1,1,0
36521966221@N01,1976,11,1215742738,1215742752,4,1,14
36521966221@N01,1977,9,1251499766,1251508008,4,1,8242
36521982700@N01,1978,18,1344006347,1344006347,1,1,0
36521982700@N01,1979,17,1344280805,1344280805,1,1,0
36521982700@N01,1980,17,1344902768,1344902768,1,1,0
36539950@N00,1981,29,1255219924,1255219951,4,1,27
36539950@N00,1982,19,1258690848,1258690848,1,1,0
36539950@N00,1983,9,1291451748,1291451748,1,1,0
36539950@N00,1984,9,1291514445,1291514460,2,1,15
36539950@N00,1985,8,1302506322,1302506417,4,1,95
36539950@N00,1986,19,1313217523,1313217523,1,1,0
36539950@N00,1987,28,1321689373,1321689373,1,2,0
36539950@N00,1987,29,1321708687,1321708687,1,2,0
36539950@N00,1988,3,1384644282,1384657630,17,2,13348
36539950@N00,1988,28,1384653936,1384656465,2,2,2529
36539950@N00,1989,10,1384729886,1384729886,1,3,0
36539950@N00,1989,12,1384754495,1384754495,1,3,0
36539950@N00,1989,23,1384729581,1384729581,1,3,0
36567853@N00,1990,3,1250485067,1250485160,3,1,93
36692429@N00,1991,1,1280892978,1280892978,1,1,0
36708561@N02,1992,29,1257052812,1257052812,1,1,0
36749913@N00,1993,29,1161526795,1161526795,1,1,0
36749913@N00,1994,13,1193656628,1193656984,2,2,356
36749913@N00,1994,28,1193656778,1193656778,1,2,0
36749913@N00,1995,3,1205979800,1205979800,1,2,0
36749913@N00,1995,13,1205980248,1205986826,3,2,6578
36749913@N00,1996,12,1206150543,1206150543,1,3,0
36749913@N00,1996,15,1206158593,1206158593,1,3,0
36749913@N00,1996,18,1206157670,1206158034,4,3,364
36749913@N00,1997,3,1206536877,1206536877,1,1,0
36749913@N00,1998,13,1206683036,1206683792,4,2,756
36749913@N00,1998,23,1206678340,1206678340,1,2,0
36749913@N00,1999,12,1206750728,1206753678,3,2,2950
36749913@N00,1999,28,1206762462,1206769086,12,2,6624
36749913@N00,2000,13,1206812682,1206812682,1,1,0
36749913@N00,2001,3,1206859351,1206886252,2,2,26901
36749913@N00,2001,29,1206859985,1206886141,8,2,26156
36749913@N00,2002,14,1206963767,1206963767,1,1,0
36749913@N00,2003,1,1207457197,1207457197,1,4,0
36749913@N00,2003,3,1207465553,1207465553,1,4,0
36749913@N00,2003,12,1207456690,1207456690,1,4,0
36749913@N00,2003,29,1207458298,1207458298,1,4,0
36749913@N00,2004,3,1207655215,1207655241,2,1,26
36749913@N00,2005,28,1207723430,1207723430,1,1,0
36749913@N00,2006,1,1207810864,1207810864,1,2,0
36749913@N00,2006,29,1207810676,1207810676,1,2,0
36749913@N00,2007,10,1207891389,1207891676,2,3,287
36749913@N00,2007,11,1207890441,1207892659,7,3,2218
36749913@N00,2007,23,1207884253,1207891248,6,3,6995
36749913@N00,2008,1,1207966218,1207972737,13,2,6519
36749913@N00,2008,28,1207978308,1207979541,4,2,1233
36749913@N00,2009,8,1208062113,1208062532,7,2,419
36749913@N00,2009,17,1208065143,1208065143,1,2,0
36749913@N00,2010,28,1208237420,1208238182,6,1,762
36749913@N00,2011,9,1211171738,1211172569,7,2,831
36749913@N00,2011,18,1211173735,1211174141,4,2,406
36749913@N00,2012,18,1211204104,1211204650,2,1,546
36749913@N00,2013,3,1211768293,1211768647,3,1,354
36749913@N00,2014,14,1211884810,1211895855,2,1,11045
36749913@N00,2015,13,1214201216,1214201216,1,1,0
36749913@N00,2016,3,1214549249,1214549249,1,2,0
36749913@N00,2016,17,1214522878,1214522878,1,2,0
36749913@N00,2017,9,1214868188,1214868188,1,1,0
36749913@N00,2018,9,1214985101,1214985253,3,1,152
36749913@N00,2019,9,1215069905,1215069905,1,1,0
36749913@N00,2020,29,1219305113,1219305113,1,1,0
36749913@N00,2021,9,1219631721,1219631782,2,1,61
36749913@N00,2022,9,1219661402,1219661573,3,2,171
36749913@N00,2022,28,1219661800,1219661800,1,2,0
36749913@N00,2023,3,1219908638,1219908638,1,1,0
36749913@N00,2024,17,1219988894,1219988894,1,1,0
36749913@N00,2025,12,1220180184,1220183314,13,1,3130
36749913@N00,2026,12,1250242502,1250248243,18,1,5741
36749913@N00,2027,17,1264978216,1264985370,54,1,7154
36749913@N00,2028,17,1265105855,1265105855,1,1,0
36749913@N00,2029,18,1266044914,1266044914,1,1,0
36749913@N00,2030,17,1267172080,1267181778,29,1,9698
36749913@N00,2031,17,1268283761,1268283810,2,1,49
36749913@N00,2032,15,1270261222,1270264345,17,1,3123
36749913@N00,2033,23,1271127527,1271127628,2,1,101
36749913@N00,2034,12,1274432967,1274444073,43,1,11106
36749913@N00,2035,12,1275710207,1275711588,6,1,1381
36749913@N00,2036,12,1277351853,1277354994,5,1,3141
36749913@N00,2037,12,1277439475,1277451930,15,1,12455
36749913@N00,2038,13,1277634823,1277641477,30,1,6654
36749913@N00,2039,12,1278845659,1278845659,1,1,0
36749913@N00,2040,12,1280544707,1280545256,3,1,549
36829918@N00,2041,19,1378540233,1378540233,1,1,0
36860264@N05,2042,24,1249620644,1249621815,7,1,1171
36888996@N03,2043,1,1208489289,1208497461,34,1,8172
36888996@N03,2044,1,1245649709,1245649725,3,1,16
36888996@N03,2045,1,1257632272,1257632272,1,1,0
36888996@N03,2046,1,1258168276,1258170681,10,1,2405
36888996@N03,2047,1,1259366665,1259366665,1,1,0
36888996@N03,2048,1,1259471073,1259476557,9,1,5484
36905967@N04,2049,13,1237932105,1237932105,1,1,0
36928267@N06,2050,15,1375603724,1375613211,4,1,9487
36964870@N00,2051,20,1315705952,1315712867,15,1,6915
36967808@N00,2052,1,1315546703,1315546703,1,6,0
36967808@N00,2052,8,1315543088,1315558732,2,6,15644
36967808@N00,2052,16,1315542982,1315543332,5,6,350
36967808@N00,2052,18,1315546971,1315564250,6,6,17279
36967808@N00,2052,28,1315546031,1315546031,1,6,0
36967808@N00,2052,29,1315529749,1315535537,24,6,5788
36967808@N00,2053,19,1315613618,1315613618,1,1,0
37029314@N00,2054,1,1302586289,1302586303,2,9,14
37029314@N00,2054,2,1302572758,1302572990,5,9,232
37029314@N00,2054,4,1302572627,1302580239,3,9,7612
37029314@N00,2054,9,1302585056,1302588334,5,9,3278
37029314@N00,2054,12,1302586486,1302586653,3,9,167
37029314@N00,2054,15,1302588001,1302588007,2,9,6
37029314@N00,2054,16,1302588030,1302588030,1,9,0
37029314@N00,2054,18,1302587039,1302587559,7,9,520
37029314@N00,2054,29,1302585698,1302588114,4,9,2416
37029314@N00,2055,1,1302634093,1302635755,6,5,1662
37029314@N00,2055,10,1302653872,1302654095,2,5,223
37029314@N00,2055,11,1302654134,1302654142,2,5,8
37029314@N00,2055,17,1302663043,1302663043,1,5,0
37029314@N00,2055,23,1302653176,1302653932,21,5,756
37138982@N08,2056,28,1239199207,1239199208,2,1,1
37185577@N00,2057,19,1388907216,1388907741,2,1,525
37185577@N00,2058,9,1388998236,1388999237,2,2,1001
37185577@N00,2058,17,1389004174,1389004174,1,2,0
37185577@N00,2059,28,1389093288,1389099781,4,1,6493
37185577@N00,2060,1,1389151159,1389154706,11,4,3547
37185577@N00,2060,9,1389158430,1389161618,5,4,3188
37185577@N00,2060,18,1389151720,1389151720,1,4,0
37185577@N00,2060,29,1389140455,1389149833,5,4,9378
37185577@N00,2061,9,1389247143,1389247143,1,1,0
37493306@N00,2062,9,1250059043,1250059067,2,2,24
37493306@N00,2062,29,1250057665,1250057665,1,2,0
37493306@N00,2063,1,1250123437,1250142129,7,2,18692
37493306@N00,2063,29,1250144415,1250144415,1,2,0
37493306@N00,2064,2,1250458210,1250458210,1,1,0
37493306@N00,2065,3,1313642686,1313647394,13,7,4708
37493306@N00,2065,8,1313629048,1313649053,2,7,20005
37493306@N00,2065,9,1313631720,1313648927,18,7,17207
37493306@N00,2065,16,1313629613,1313629703,3,7,90
37493306@N00,2065,17,1313632229,1313633800,2,7,1571
37493306@N00,2065,28,1313644509,1313644554,2,7,45
37493306@N00,2065,29,1313629884,1313631532,6,7,1648
37533940@N05,2066,19,1367919677,1367919677,1,1,0
37546787@N05,2067,8,1241250773,1241250773,1,2,0
37546787@N05,2067,29,1241262794,1241262794,1,2,0
37546787@N05,2068,1,1241322361,1241324930,12,2,2569
37546787@N05,2068,3,1241326600,1241327159,5,2,559
37569287@N00,2069,24,1178515229,1178515229,1,1,0
37574483@N07,2070,13,1335591094,1335591094,1,1,0
37574483@N07,2071,29,1335757841,1335757841,1,1,0
37574483@N07,2072,3,1335942481,1335942881,3,3,400
37574483@N07,2072,18,1335937521,1335937604,3,3,83
37574483@N07,2072,19,1335940042,1335940042,1,3,0
37581812@N00,2073,9,1373361551,1373362723,4,1,1172
37581812@N00,2074,2,1373420050,1373425606,10,2,5556
37581812@N00,2074,4,1373418540,1373426107,2,2,7567
37664973@N07,2075,15,1186967380,1186967380,1,1,0
37703201@N00,2076,29,1289711318,1289711332,2,1,14
37804979@N00,2077,8,1271225027,1271225417,4,2,390
37804979@N00,2077,19,1271224536,1271224536,1,2,0
37804979@N00,2078,8,1271299634,1271320018,2,3,20384
37804979@N00,2078,19,1271285885,1271314994,3,3,29109
37804979@N00,2078,29,1271287664,1271314315,4,3,26651
37804979@N00,2079,3,1271373383,1271377497,27,2,4114
37804979@N00,2079,29,1271379053,1271380189,4,2,1136
37804979@N00,2080,19,1271413588,1271413588,1,1,0
37928783@N00,2081,12,1180355121,1180355121,1,1,0
37928783@N00,2082,22,1199103208,1199103208,1,1,0
37928783@N00,2083,19,1247318668,1247318668,1,1,0
37928783@N00,2084,18,1251876054,1251877409,6,1,1355
37928783@N00,2085,15,1292302525,1292304487,4,2,1962
37928783@N00,2085,29,1292302081,1292302156,3,2,75
37928783@N00,2086,15,1336530623,1336530623,1,2,0
37928783@N00,2086,18,1336530865,1336531166,3,2,301
37996590595@N01,2087,29,1251551640,1251551640,1,1,0
37996590595@N01,2088,18,1251631767,1251631767,1,1,0
37996590595@N01,2089,1,1296308917,1296309465,2,2,548
37996590595@N01,2089,3,1296309337,1296309337,1,2,0
37996595541@N01,2090,13,1276870585,1276870871,5,1,286
37996646802@N01,2091,1,1383540856,1383540856,1,3,0
37996646802@N01,2091,7,1383545065,1383545291,3,3,226
37996646802@N01,2091,9,1383536539,1383536539,1,3,0
37996646802@N01,2092,8,1383610534,1383614308,4,3,3774
37996646802@N01,2092,15,1383612790,1383612790,1,3,0
37996646802@N01,2092,16,1383614096,1383614096,1,3,0
38115734@N00,2093,1,1126731836,1126745446,18,3,13610
38115734@N00,2093,4,1126751661,1126751854,3,3,193
38115734@N00,2093,24,1126752290,1126752290,1,3,0
38115734@N00,2094,10,1127083877,1127083877,1,2,0
38115734@N00,2094,11,1127083685,1127083721,2,2,36
38115734@N00,2095,7,1127434892,1127434892,1,3,0
38115734@N00,2095,15,1127424313,1127424313,1,3,0
38115734@N00,2095,18,1127423598,1127423598,1,3,0
38115734@N00,2096,4,1127512453,1127516905,9,2,4452
38115734@N00,2096,23,1127521182,1127522020,2,2,838
38115734@N00,2097,28,1127554622,1127554622,1,1,0
38115734@N00,2098,20,1128815582,1128815582,1,1,0
38115734@N00,2099,27,1128894549,1128902484,3,1,7935
38273190@N00,2100,29,1302483826,1302483826,1,1,0
38273190@N00,2101,3,1302659367,1302659367,1,1,0
38323841@N00,2102,17,1186825477,1186825477,1,1,0
38323841@N00,2103,9,1186876975,1186879609,15,1,2634
38425817@N00,2104,19,1139489056,1139489056,1,1,0
38476864@N06,2105,14,1368228336,1368228336,1,1,0
38716757@N00,2106,8,1304512373,1304512373,1,2,0
38716757@N00,2106,19,1304509915,1304511867,2,2,1952
38743188@N08,2107,19,1264830112,1264830112,1,1,0
38783516@N00,2108,3,1167473862,1167473862,1,3,0
38783516@N00,2108,8,1167476033,1167476239,2,3,206
38783516@N00,2108,9,1167474683,1167474703,2,3,20
38943965@N05,2109,1,1253385845,1253389700,8,5,3855
38943965@N05,2109,8,1253384521,1253384908,2,5,387
38943965@N05,2109,9,1253390846,1253390846,1,5,0
38943965@N05,2109,22,1253385585,1253385585,1,5,0
38943965@N05,2109,29,1253386448,1253386448,1,5,0
39041248@N03,2110,9,1380383320,1380391789,23,1,8469
39041248@N03,2111,9,1380424184,1380427684,18,1,3500
39101927@N07,2112,1,1284691665,1284691665,1,1,0
39197175@N08,2113,23,1261630132,1261630132,1,1,0
39387762@N00,2114,3,1178685730,1178685730,1,1,0
39412817@N00,2115,18,1124435325,1124435325,1,1,0
39412817@N00,2116,17,1219367752,1219367752,1,2,0
39412817@N00,2116,29,1219367449,1219367476,3,2,27
39484446@N08,2117,15,1242428728,1242428728,1,1,0
39484446@N08,2118,29,1265943585,1265943585,1,1,0
39552752@N00,2119,16,1124602812,1124602812,1,1,0
39643094@N03,2120,28,1141551031,1141551031,1,1,0
39643094@N03,2121,28,1141795162,1141796217,3,1,1055
39643094@N03,2122,17,1170422347,1170426689,5,1,4342
39643094@N03,2123,9,1248494209,1248494209,1,2,0
39643094@N03,2123,29,1248491669,1248492098,2,2,429
39643094@N03,2124,8,1260589318,1260589318,1,1,0
39643094@N03,2125,14,1261458528,1261458528,1,1,0
39643094@N03,2126,14,1261545250,1261545250,1,1,0
39643094@N03,2127,24,1261712719,1261712744,3,1,25
39643094@N03,2128,19,1261975378,1261978480,3,1,3102
39643094@N03,2129,28,1310788338,1310824881,28,1,36543
39643094@N03,2130,28,1310875707,1310914382,51,1,38675
39643094@N03,2131,28,1312201238,1312218188,7,1,16950
39643094@N03,2132,28,1312261615,1312267706,9,1,6091
39643094@N03,2133,28,1312299281,1312299332,22,1,51
39643094@N03,2134,29,1353897282,1353902603,22,1,5321
39643094@N03,2135,29,1357265024,1357265024,1,1,0
39727414@N00,2136,29,1253346696,1253348063,6,1,1367
39745335@N06,2137,9,1340153051,1340153051,2,4,0
39745335@N06,2137,18,1340150997,1340151391,2,4,394
39745335@N06,2137,23,1340153901,1340153901,1,4,0
39745335@N06,2137,29,1340152721,1340152721,2,4,0
39927207@N00,2138,1,1200341654,1200341923,12,4,269
39927207@N00,2138,9,1200340682,1200340967,8,4,285
39927207@N00,2138,17,1200344482,1200344482,1,4,0
39927207@N00,2138,19,1200345130,1200365812,3,4,20682
39927207@N00,2139,18,1200420869,1200420879,2,2,10
39927207@N00,2139,19,1200419721,1200419937,3,2,216
40045573@N03,2140,9,1308792762,1308792762,1,2,0
40045573@N03,2140,29,1308806757,1308806959,4,2,202
40046855@N00,2141,2,741880800,741880800,1,1,0
40055757@N00,2142,1,1113908929,1113908929,1,1,0
40055757@N00,2143,9,1129674775,1129675506,2,2,731
40055757@N00,2143,29,1129674520,1129675414,2,2,894
40055757@N00,2144,4,1185865823,1185865823,1,3,0
40055757@N00,2144,8,1185859119,1185860150,2,3,1031
40055757@N00,2144,19,1185863313,1185863313,1,3,0
40055757@N00,2145,9,1186044104,1186044128,2,1,24
40055757@N00,2146,9,1186116064,1186119862,3,1,3798
40077210@N00,2147,20,1330729351,1330729351,1,1,0
40102764@N03,2148,1,1281150574,1281182459,35,1,31885
40139809@N00,2149,10,866885484,866885515,2,1,31
40139809@N00,2150,1,1165921845,1165921942,4,1,97
40139809@N00,2151,2,1167612665,1167612718,2,4,53
40139809@N00,2151,9,1167612708,1167612708,1,4,0
40139809@N00,2151,23,1167612620,1167612620,1,4,0
40139809@N00,2151,29,1167612646,1167612646,1,4,0
40139809@N00,2152,17,1281872506,1281872506,1,1,0
40139809@N00,2153,9,1281953372,1281953372,1,1,0
40139809@N00,2154,16,1282291795,1282291795,1,1,0
40139809@N00,2155,9,1282723230,1282723230,1,1,0
40139809@N00,2156,17,1283240200,1283240200,1,1,0
40139809@N00,2157,15,1284196291,1284196291,1,1,0
40139809@N00,2158,3,1313055126,1313055126,1,1,0
40139809@N00,2159,3,1313136074,1313136074,1,1,0
40139809@N00,2160,9,1313226255,1313226255,1,1,0
40139809@N00,2161,9,1313485322,1313485322,1,1,0
40139809@N00,2162,3,1313824303,1313824303,1,1,0
40139809@N00,2163,17,1313912335,1313912335,1,1,0
40139809@N00,2164,18,1313983207,1313983207,1,1,0
40139809@N00,2165,9,1316422246,1316422246,1,1,0
40139809@N00,2166,8,1320649802,1320649802,1,1,0
40139809@N00,2167,27,1321859312,1321859312,1,1,0
40139809@N00,2168,18,1372056981,1372056981,1,1,0
40139809@N00,2169,20,1372319895,1372319895,1,1,0
40139809@N00,2170,20,1372660969,1372660969,1,1,0
40139809@N00,2171,18,1373871132,1373871132,1,1,0
40139809@N00,2172,20,1374823268,1374823268,1,1,0
40139809@N00,2173,20,1380868351,1380868351,1,1,0
40139809@N00,2174,17,1398064260,1398064260,1,1,0
40230716@N03,2175,1,1306653509,1306655928,3,3,2419
40230716@N03,2175,8,1306652459,1306654241,5,3,1782
40230716@N03,2175,9,1306642623,1306644523,3,3,1900
40230716@N03,2176,1,1306731002,1306731002,1,1,0
40230716@N03,2177,19,1306759928,1306759928,1,1,0
40284210@N00,2178,1,1327538386,1327544696,45,2,6310
40284210@N00,2178,18,1327554970,1327554970,1,2,0
40284210@N00,2179,1,1327735640,1327735644,3,1,4
40369429@N00,2180,23,1282446648,1282446648,1,1,0
40467171@N00,2181,2,1145661431,1145661431,1,1,0
40469367@N03,2182,3,1299432582,1299432582,1,1,0
40492361@N06,2183,2,1288740735,1288746730,18,1,5995
40492361@N06,2184,3,1332413229,1332420528,29,1,7299
40725466@N03,2185,1,1282712302,1282717708,4,5,5406
40725466@N03,2185,8,1282727164,1282730358,2,5,3194
40725466@N03,2185,15,1282722750,1282729969,4,5,7219
40725466@N03,2185,19,1282726535,1282726560,2,5,25
40725466@N03,2185,29,1282710181,1282720356,2,5,10175
40732565852@N01,2186,16,1366027535,1366030209,2,1,2674
40741565@N00,2187,17,1269401513,1269401513,1,1,0
40752609@N00,2188,9,1182138005,1182138005,1,1,0
40813689@N00,2189,3,1318896179,1318896179,1,1,0
40835857@N00,2190,15,1382135798,1382135798,1,1,0
40835857@N00,2191,8,1382226164,1382226164,1,2,0
40835857@N00,2191,29,1382232351,1382232351,1,2,0
40864317@N08,2192,9,1345433209,1345433209,1,1,0
40864317@N08,2193,7,1345602534,1345603461,2,1,927
40938353@N03,2194,11,1286773626,1286773626,1,1,0
40942390@N00,2195,29,1124855443,1124855443,1,1,0
40942390@N00,2196,29,1164111065,1164111065,1,1,0
41052325@N00,2197,13,1315467811,1315470591,3,1,2780
41077204@N04,2198,28,1249809194,1249809194,1,1,0
41133601@N03,2199,8,1380432111,1380432111,1,1,0
41317617@N05,2200,24,1352866524,1352866524,1,1,0
41346951@N05,2201,19,1305512268,1305512268,1,1,0
41362612@N00,2202,11,1131187941,1131188202,2,1,261
41362612@N00,2203,15,1134126001,1134126001,1,1,0
41362612@N00,2204,2,1143970815,1143970815,1,1,0
41362612@N00,2205,3,1150955576,1150955576,1,1,0
41604911@N08,2206,1,1270604415,1270604415,1,1,0
41610421@N05,2207,1,953341200,953342819,3,1,1619
41610421@N05,2208,1,1296925323,1296925323,1,1,0
41692261@N00,2209,1,1347327702,1347327702,1,3,0
41692261@N00,2209,9,1347325231,1347326817,16,3,1586
41692261@N00,2209,29,1347327030,1347327335,6,3,305
41692261@N00,2210,19,1347452310,1347452310,1,1,0
41715395@N00,2211,13,1334122038,1334122038,1,1,0
41715395@N00,2212,13,1340746184,1340746184,1,1,0
41725486@N08,2213,10,820414800,820414800,1,1,0
41725486@N08,2214,10,1136034000,1136034000,2,2,0
41725486@N08,2214,11,1136034000,1136034000,1,2,0
41796225@N00,2215,2,1117343558,1117343572,4,1,14
41885329@N00,2216,29,1189229348,1189229348,1,1,0
41894148532@N01,2217,3,1120279534,1120279534,1,4,0
41894148532@N01,2217,15,1120280100,1120280281,2,4,181
41894148532@N01,2217,16,1120280211,1120280211,1,4,0
41894148532@N01,2217,29,1120280051,1120280051,1,4,0
41894148532@N01,2218,9,1299150579,1299150579,1,1,0
41894148532@N01,2219,3,1299196516,1299200916,6,2,4400
41894148532@N01,2219,28,1299196044,1299196044,1,2,0
41894148532@N01,2220,29,1299369872,1299369872,1,1,0
41894148532@N01,2221,8,1299471950,1299473244,3,1,1294
41894163743@N01,2222,1,1310946673,1310946673,1,1,0
41894163743@N01,2223,29,1311468309,1311468309,1,1,0
41894163743@N01,2224,17,1311551898,1311551898,1,1,0
41984492@N00,2225,15,1341743555,1341743705,2,1,150
41984492@N00,2226,17,1341907129,1341907129,1,1,0
41984492@N00,2227,18,1342016208,1342016216,2,1,8
41984492@N00,2228,19,1342231108,1342231108,1,1,0
42027916@N00,2229,19,1309806108,1309819613,6,1,13505
42027916@N00,2230,15,1309884952,1309893815,13,3,8863
42027916@N00,2230,19,1309884551,1309894506,3,3,9955
42027916@N00,2230,22,1309896369,1309896369,1,3,0
42027916@N00,2231,1,1309980194,1309984964,41,3,4770
42027916@N00,2231,18,1309986381,1309987271,4,3,890
42027916@N00,2231,29,1309979133,1309985059,5,3,5926
42027916@N00,2232,4,1310071054,1310071608,15,2,554
42027916@N00,2232,28,1310077265,1310079095,4,2,1830
42027916@N00,2233,15,1310158652,1310158652,1,3,0
42027916@N00,2233,28,1310163845,1310177898,2,3,14053
42027916@N00,2233,29,1310156204,1310156587,2,3,383
42027916@N00,2234,3,1310240109,1310244398,31,1,4289
42034487@N04,2235,9,1286687966,1286688159,2,1,193
42071590@N03,2236,10,1243300186,1243300186,1,1,0
42072165@N08,2237,1,1327815886,1327815886,1,3,0
42072165@N08,2237,9,1327814581,1327815330,2,3,749
42072165@N08,2237,29,1327821475,1327821475,1,3,0
42072165@N08,2238,23,1332661161,1332661638,2,1,477
42072165@N08,2239,1,1346582898,1346583820,2,1,922
42076226@N04,2240,19,1253424267,1253424267,1,1,0
42083039@N00,2241,18,1288053960,1288053960,1,1,0
42135512@N02,2242,9,1209700823,1209700823,1,1,0
42135512@N02,2243,28,1212834918,1212834918,1,1,0
42135512@N02,2244,27,1277176522,1277176522,1,1,0
42164301@N00,2245,1,1308790041,1308790041,1,1,0
42348675@N00,2246,3,1120266093,1120266095,2,5,2
42348675@N00,2246,9,1120266091,1120266091,1,5,0
42348675@N00,2246,15,1120266049,1120266049,1,5,0
42348675@N00,2246,18,1120266084,1120266086,2,5,2
42348675@N00,2246,29,1120266088,1120266088,1,5,0
42348675@N00,2247,4,1148296771,1148296771,1,2,0
42348675@N00,2247,24,1148286116,1148287810,2,2,1694
42348675@N00,2248,1,1148459284,1148460543,3,2,1259
42348675@N00,2248,19,1148471900,1148471983,2,2,83
42348675@N00,2249,9,1150848310,1150848310,1,4,0
42348675@N00,2249,15,1150847754,1150847754,1,4,0
42348675@N00,2249,17,1150858784,1150858784,1,4,0
42348675@N00,2249,27,1150852031,1150852407,2,4,376
42348675@N00,2250,3,1155983055,1155989483,3,1,6428
42348675@N00,2251,10,1157283678,1157283971,5,1,293
42348675@N00,2252,13,1175744843,1175744843,1,1,0
42348675@N00,2253,22,1203335111,1203335111,1,1,0
42348675@N00,2254,10,1203413028,1203413028,1,3,0
42348675@N00,2254,11,1203414200,1203415525,3,3,1325
42348675@N00,2254,28,1203422010,1203422010,1,3,0
42348675@N00,2255,21,1231906246,1231906246,1,1,0
42369145@N02,2256,18,1264560734,1264560734,1,1,0
42369145@N02,2257,3,1267404702,1267404702,1,1,0
42421092@N02,2258,19,1371132711,1371132913,2,2,202
42421092@N02,2258,28,1371131812,1371131969,2,2,157
42433387@N07,2259,13,1295599134,1295603975,26,1,4841
42438338@N00,2260,8,1382838828,1382838828,1,2,0
42438338@N00,2260,18,1382837476,1382837476,2,2,0
42479008@N02,2261,2,1370566674,1370566769,2,5,95
42479008@N02,2261,4,1370567029,1370567029,1,5,0
42479008@N02,2261,10,1370568779,1370569362,5,5,583
42479008@N02,2261,11,1370567417,1370570661,6,5,3244
42479008@N02,2261,23,1370567481,1370570826,2,5,3345
42509361@N05,2262,1,1275437018,1275443582,13,4,6564
42509361@N05,2262,15,1275435659,1275454214,2,4,18555
42509361@N05,2262,19,1275447135,1275447135,1,4,0
42509361@N05,2262,29,1275435835,1275435835,1,4,0
42548354@N04,2263,19,1271441499,1271441499,1,1,0
42557040@N07,2264,23,1326524258,1326524258,1,1,0
42583704@N00,2265,9,1249290642,1249290642,1,1,0
42583704@N00,2266,2,1249348668,1249359239,3,7,10571
42583704@N00,2266,3,1249361903,1249369820,8,7,7917
42583704@N00,2266,4,1249348340,1249359410,4,7,11070
42583704@N00,2266,7,1249353406,1249355747,9,7,2341
42583704@N00,2266,17,1249367953,1249367953,1,7,0
42583704@N00,2266,19,1249342124,1249345218,18,7,3094
42583704@N00,2266,24,1249349992,1249358926,4,7,8934
42583704@N00,2267,1,1249426591,1249441722,50,5,15131
42583704@N00,2267,8,1249449919,1249449937,2,5,18
42583704@N00,2267,16,1249443041,1249443068,2,5,27
42583704@N00,2267,18,1249429918,1249443898,2,5,13980
42583704@N00,2267,29,1249425818,1249442513,5,5,16695
42583704@N00,2268,1,1249532696,1249563442,15,4,30746
42583704@N00,2268,8,1249535246,1249535584,4,4,338
42583704@N00,2268,15,1249534237,1249534237,1,4,0
42583704@N00,2268,19,1249536702,1249536702,1,4,0
42583704@N00,2269,1,1249701114,1249709745,10,1,8631
42629370@N00,2270,8,1155481192,1155498020,6,4,16828
42629370@N00,2270,9,1155488545,1155488930,2,4,385
42629370@N00,2270,19,1155481731,1155481928,2,4,197
42629370@N00,2270,29,1155491454,1155492174,4,4,720
42629370@N00,2271,1,1155547462,1155551897,5,3,4435
42629370@N00,2271,3,1155560896,1155560896,1,3,0
42629370@N00,2271,29,1155541180,1155541974,2,3,794
42629370@N00,2272,2,1155643125,1155656684,20,5,13559
42629370@N00,2272,4,1155642046,1155642046,1,5,0
42629370@N00,2272,10,1155635442,1155635442,1,5,0
42629370@N00,2272,11,1155635675,1155637608,8,5,1933
42629370@N00,2272,23,1155635282,1155635585,3,5,303
42629370@N00,2273,3,1155721188,1155721260,2,3,72
42629370@N00,2273,9,1155740687,1155740687,1,3,0
42629370@N00,2273,29,1155723910,1155748206,10,3,24296
42677686@N04,2274,1,1218181678,1218181678,1,1,0
42730864@N05,2275,3,1321522840,1321522840,1,2,0
42730864@N05,2275,7,1321522953,1321522953,1,2,0
42730864@N05,2276,7,1329892383,1329892383,1,1,0
42747912@N00,2277,19,1383193485,1383193812,2,1,327
42747912@N00,2278,4,1385866065,1385866065,1,1,0
42795041@N00,2279,10,1396997658,1396998562,6,2,904
42795041@N00,2279,23,1396999382,1397000740,8,2,1358
42907325@N00,2280,3,1270181198,1270181198,1,3,0
42907325@N00,2280,9,1270182960,1270182960,1,3,0
42907325@N00,2280,23,1270189888,1270189888,1,3,0
42907325@N00,2281,9,1270258418,1270258418,1,1,0
43002463@N00,2282,20,1085722647,1085722647,1,1,0
43002463@N00,2283,9,1091271498,1091271498,1,1,0
43002463@N00,2284,4,1102730963,1102730963,1,2,0
43002463@N00,2284,12,1102755133,1102755133,1,2,0
43002463@N00,2285,12,1135940785,1135940785,1,1,0
43002463@N00,2286,3,1185495159,1185495159,1,3,0
43002463@N00,2286,8,1185489459,1185491585,10,3,2126
43002463@N00,2286,19,1185487413,1185487441,2,3,28
43002463@N00,2287,23,1189271522,1189271522,1,1,0
43002463@N00,2288,9,1210925158,1210925158,1,2,0
43002463@N00,2288,23,1210924626,1210924626,1,2,0
43002463@N00,2289,27,1211081458,1211081492,3,1,34
43002463@N00,2290,20,1222488753,1222490285,8,1,1532
43002463@N00,2291,9,1242263053,1242263053,1,1,0
43002463@N00,2292,9,1243833331,1243833331,1,1,0
43002463@N00,2293,28,1245389250,1245389250,1,1,0
43002463@N00,2294,19,1259406694,1259406705,2,1,11
43002463@N00,2295,18,1261193138,1261193138,1,1,0
43002463@N00,2296,20,1268539345,1268542485,13,1,3140
43002463@N00,2297,9,1272968365,1272968400,3,1,35
43002463@N00,2298,24,1284268758,1284268758,1,1,0
43002463@N00,2299,18,1304139567,1304143370,2,1,3803
43002463@N00,2300,3,1312177574,1312177574,1,1,0
43002463@N00,2301,3,1314509980,1314509980,1,1,0
43002463@N00,2302,17,1335587399,1335587399,1,2,0
43002463@N00,2302,24,1335588615,1335590021,4,2,1406
43002463@N00,2303,11,1342314796,1342316248,4,1,1452
43002463@N00,2304,1,1344050352,1344050352,1,1,0
43002463@N00,2305,29,1358310003,1358315129,3,1,5126
43002463@N00,2306,3,1364600937,1364607259,6,1,6322
43126182@N00,2307,3,1210326202,1210326202,1,3,0
43126182@N00,2307,9,1210320505,1210320505,1,3,0
43126182@N00,2307,19,1210332528,1210332547,2,3,19
43126182@N00,2308,1,1210377986,1210383698,13,2,5712
43126182@N00,2308,29,1210385887,1210414661,9,2,28774
43126182@N00,2309,19,1338108886,1338108886,1,2,0
43126182@N00,2309,29,1338070881,1338108014,5,2,37133
43153309@N00,2310,29,1084059825,1084059825,1,1,0
43185259@N08,2311,18,1293525274,1293525274,1,1,0
43222683@N00,2312,4,1194051868,1194052338,2,4,470
43222683@N00,2312,9,1194053124,1194053679,3,4,555
43222683@N00,2312,18,1194056699,1194057280,2,4,581
43222683@N00,2312,29,1194055106,1194055106,1,4,0
43405950@N07,2313,19,1332565782,1332565782,1,1,0
43405950@N07,2314,20,1333845323,1333845825,2,1,502
43405950@N07,2315,3,1336881868,1336885383,2,1,3515
43405950@N07,2316,20,1337904553,1337904553,1,1,0
43405950@N07,2317,9,1345337332,1345337332,1,1,0
43405950@N07,2318,3,1348375485,1348376024,2,3,539
43405950@N07,2318,9,1348367383,1348374246,2,3,6863
43405950@N07,2318,29,1348370177,1348370177,1,3,0
43405950@N07,2319,3,1355107294,1355107294,1,6,0
43405950@N07,2319,8,1355117120,1355117447,2,6,327
43405950@N07,2319,12,1355098193,1355098193,1,6,0
43405950@N07,2319,16,1355100825,1355116598,3,6,15773
43405950@N07,2319,18,1355099491,1355113007,3,6,13516
43405950@N07,2319,29,1355100920,1355100920,1,6,0
43405950@N07,2320,3,1363831804,1363831804,1,3,0
43405950@N07,2320,19,1363817755,1363817755,1,3,0
43405950@N07,2320,23,1363821529,1363822326,4,3,797
43405950@N07,2321,23,1364369773,1364369828,2,1,55
43405950@N07,2322,18,1368935417,1368935417,1,1,0
43405950@N07,2323,20,1370740826,1370742218,5,1,1392
43405950@N07,2324,20,1373171537,1373171537,1,1,0
43405950@N07,2325,3,1380094116,1380094385,2,1,269
43405950@N07,2326,1,1383172426,1383172426,1,2,0
43405950@N07,2326,29,1383176847,1383176847,1,2,0
43405950@N07,2327,9,1385870115,1385870115,1,1,0
43405950@N07,2328,8,1386048110,1386048110,1,1,0
43405950@N07,2329,1,1388636423,1388636839,2,2,416
43405950@N07,2329,29,1388639849,1388639849,1,2,0
43405950@N07,2330,29,1389493102,1389493102,1,1,0
43405950@N07,2331,20,1395545895,1395545895,1,1,0
43498286@N00,2332,28,1363841527,1363846680,3,1,5153
43498286@N00,2333,1,1363885859,1363907621,7,4,21762
43498286@N00,2333,9,1363896114,1363896114,1,4,0
43498286@N00,2333,28,1363899829,1363914617,2,4,14788
43498286@N00,2333,29,1363885569,1363895094,6,4,9525
43498286@N00,2334,8,1364066656,1364075238,3,3,8582
43498286@N00,2334,15,1364066520,1364066520,1,3,0
43498286@N00,2334,19,1364067848,1364070115,2,3,2267
43619118@N04,2335,1,1261290278,1261290278,1,3,0
43619118@N04,2335,8,1261293879,1261295809,3,3,1930
43619118@N04,2335,15,1261292914,1261292914,1,3,0
43619118@N04,2336,9,1281245051,1281245147,2,2,96
43619118@N04,2336,29,1281241781,1281241781,1,2,0
43619118@N04,2337,1,1285387637,1285387637,1,2,0
43619118@N04,2337,9,1285386008,1285386008,1,2,0
43619118@N04,2338,9,1318133476,1318133476,1,1,0
43619118@N04,2339,1,1324191109,1324191275,2,5,166
43619118@N04,2339,8,1324195595,1324196072,3,5,477
43619118@N04,2339,9,1324194317,1324194839,3,5,522
43619118@N04,2339,16,1324184804,1324188911,2,5,4107
43619118@N04,2339,29,1324185929,1324194151,6,5,8222
43661283@N00,2340,17,1314477104,1314522036,62,1,44932
43661283@N00,2341,17,1314596912,1314603872,8,1,6960
43661283@N00,2342,17,1314648964,1314692812,126,1,43848
43661283@N00,2343,17,1314729398,1314766578,39,1,37180
43667248@N00,2344,1,1377052443,1377053263,2,1,820
43667248@N00,2345,11,1377085180,1377085205,2,1,25
43707957@N02,2346,29,1313406205,1313410566,2,1,4361
44036847@N05,2347,9,1287906433,1287906433,1,2,0
44036847@N05,2347,19,1287905708,1287905721,2,2,13
44036847@N05,2348,8,1287966905,1287966905,1,4,0
44036847@N05,2348,9,1287968829,1287968829,1,4,0
44036847@N05,2348,16,1287991274,1287991386,2,4,112
44036847@N05,2348,29,1287968858,1287991137,38,4,22279
44036847@N05,2349,1,1288146418,1288153995,13,2,7577
44036847@N05,2349,29,1288155310,1288157952,5,2,2642
44043718@N00,2350,1,1212812809,1212812809,1,2,0
44043718@N00,2350,4,1212815932,1212815945,2,2,13
44124341325@N01,2351,15,1228025165,1228025165,1,1,0
44124341325@N01,2352,17,1341105773,1341105773,1,1,0
44124341325@N01,2353,4,1343454218,1343454218,1,1,0
44124341325@N01,2354,3,1345030064,1345030064,1,1,0
44124341325@N01,2355,29,1345208831,1345208831,1,1,0
44124341325@N01,2356,3,1345277395,1345277395,1,1,0
44124341325@N01,2357,9,1345613876,1345613876,1,1,0
44124341325@N01,2358,8,1346585307,1346585307,1,1,0
44124341325@N01,2359,9,1350133517,1350133517,1,1,0
44124341325@N01,2360,17,1350807241,1350807241,1,1,0
44124341325@N01,2361,9,1351158322,1351160958,2,1,2636
44124341325@N01,2362,12,1354872063,1354872063,1,1,0
44124341325@N01,2363,15,1355260432,1355260432,1,1,0
44124341325@N01,2364,9,1361614194,1361614194,1,1,0
44124341325@N01,2365,12,1362793551,1362793551,1,1,0
44124341325@N01,2366,13,1375519165,1375519165,1,1,0
44124341325@N01,2367,15,1375584109,1375584109,1,1,0
44124341325@N01,2368,13,1376744001,1376744001,1,1,0
44124372821@N01,2369,20,1370648394,1370650382,2,1,1988
44124372821@N01,2370,9,1395626947,1395626947,1,3,0
44124372821@N01,2370,15,1395617867,1395617867,1,3,0
44124372821@N01,2370,23,1395629707,1395629707,1,3,0
44124372821@N01,2371,1,1395697084,1395697084,1,3,0
44124372821@N01,2371,3,1395714319,1395714319,1,3,0
44124372821@N01,2371,9,1395713909,1395713909,1,3,0
44124372821@N01,2372,15,1395970349,1395990139,2,1,19790
44124372821@N01,2373,11,1396212784,1396212784,1,2,0
44124372821@N01,2373,16,1396211411,1396211411,1,2,0
44124398982@N01,2374,1,1390892212,1390892212,1,1,0
44124406151@N01,2375,17,1158113889,1158113889,1,1,0
44124410573@N01,2376,14,1310269689,1310269689,1,1,0
44124410573@N01,2377,14,1310434929,1310434929,1,1,0
44124410573@N01,2378,14,1310514146,1310514146,1,1,0
44124427374@N01,2379,4,1138450578,1138450877,9,6,299
44124427374@N01,2379,9,1138449189,1138449393,3,6,204
44124427374@N01,2379,15,1138429083,1138434022,2,6,4939
44124427374@N01,2379,18,1138430442,1138448744,4,6,18302
44124427374@N01,2379,22,1138430968,1138431557,5,6,589
44124427374@N01,2379,29,1138448861,1138449137,3,6,276
44124427374@N01,2380,2,1138512235,1138512235,1,4,0
44124427374@N01,2380,4,1138512408,1138512549,3,4,141
44124427374@N01,2380,9,1138513715,1138513715,1,4,0
44124427374@N01,2380,15,1138514234,1138514413,2,4,179
44124431847@N01,2381,9,1334286641,1334286641,1,2,0
44124431847@N01,2381,10,1334286702,1334288656,2,2,1954
44124431847@N01,2382,18,1334397323,1334397323,1,1,0
44124433993@N01,2383,1,1334444976,1334444976,1,1,0
44124447497@N01,2384,1,1379140499,1379140499,1,1,0
44232237@N03,2385,29,1388403337,1388403337,1,1,0
44232237@N03,2386,16,1388456436,1388456436,1,1,0
44232237@N03,2387,9,1388549524,1388549524,1,1,0
44232237@N03,2388,8,1388619265,1388619808,2,5,543
44232237@N03,2388,9,1388620641,1388620679,2,5,38
44232237@N03,2388,15,1388626184,1388628511,4,5,2327
44232237@N03,2388,16,1388627518,1388627518,1,5,0
44232237@N03,2388,17,1388622956,1388622956,1,5,0
44378953@N00,2389,17,1091903448,1091903448,1,1,0
44378953@N00,2390,15,1148199239,1148199239,1,2,0
44378953@N00,2390,23,1148193378,1148193378,1,2,0
44378953@N00,2391,3,1148361552,1148361552,2,1,0
44423341@N00,2392,9,1221889319,1221891370,5,1,2051
44423341@N00,2393,18,1221967394,1221967931,3,2,537
44423341@N00,2393,19,1221968760,1221968760,1,2,0
44474558@N00,2394,29,1342517121,1342517121,1,1,0
44491765@N06,2395,9,1243613266,1243636359,16,1,23093
44491765@N06,2396,9,1243878106,1243890498,14,2,12392
44491765@N06,2396,29,1243890983,1243894597,8,2,3614
44633703@N00,2397,3,1383301237,1383301447,2,1,210
44633703@N00,2398,3,1383361511,1383361511,1,1,0
44639173@N05,2399,23,1325225884,1325235998,10,1,10114
44681630@N02,2400,24,1398480647,1398480647,1,1,0
44756385@N00,2401,3,1346029248,1346029248,1,5,0
44756385@N00,2401,4,1346028150,1346029242,8,5,1092
44756385@N00,2401,8,1346039164,1346040536,14,5,1372
44756385@N00,2401,9,1346025190,1346034457,23,5,9267
44756385@N00,2401,29,1346025626,1346058258,15,5,32632
44756385@N00,2402,3,1346109928,1346110692,15,4,764
44756385@N00,2402,9,1346111278,1346112385,7,4,1107
44756385@N00,2402,17,1346110758,1346110781,3,4,23
44756385@N00,2402,28,1346110946,1346111275,9,4,329
44757190@N06,2403,1,1312977925,1312977925,1,1,0
44925192@N00,2404,8,1290740101,1290744246,24,4,4145
44925192@N00,2404,9,1290742474,1290742474,1,4,0
44925192@N00,2404,15,1290737339,1290739198,8,4,1859
44925192@N00,2404,16,1290740509,1290740509,1,4,0
44925192@N00,2405,2,1290833432,1290833674,2,3,242
44925192@N00,2405,4,1290833166,1290833327,3,3,161
44925192@N00,2405,9,1290831791,1290831791,1,3,0
44954763@N08,2406,29,1369977709,1369977709,1,1,0
44981166@N08,2407,19,1291592443,1291592443,1,1,0
45021357@N06,2408,9,1187164576,1187164576,1,1,0
45116567@N00,2409,1,1133303214,1133303214,1,1,0
45116567@N00,2410,1,1133355600,1133355600,1,1,0
45116567@N00,2411,1,1198764996,1198764996,1,1,0
45130758@N04,2412,29,1190076670,1190079315,2,1,2645
45254765@N00,2413,8,1184236912,1184236912,1,2,0
45254765@N00,2413,19,1184237370,1184238136,3,2,766
45269026@N00,2414,9,1313897485,1313897485,1,2,0
45269026@N00,2414,28,1313898603,1313898603,1,2,0
45298044@N06,2415,18,1283685086,1283686383,3,1,1297
45298044@N06,2416,27,1284274678,1284274678,1,1,0
45298044@N06,2417,10,1323036815,1323039366,2,2,2551
45298044@N06,2417,11,1323037797,1323037797,1,2,0
45359871@N00,2418,29,1212628743,1212628743,1,1,0
45359871@N00,2419,12,1241153792,1241153792,1,2,0
45359871@N00,2419,29,1241146338,1241146338,1,2,0
45457437@N00,2420,3,1327113877,1327114846,9,2,969
45457437@N00,2420,4,1327106558,1327112680,5,2,6122
45457437@N00,2421,8,1327194175,1327194873,4,3,698
45457437@N00,2421,9,1327194304,1327194317,2,3,13
45457437@N00,2421,11,1327202207,1327202291,5,3,84
45770203@N05,2422,10,1280359345,1280359345,1,1,0
45941278@N00,2423,29,1190435968,1190436154,4,1,186
45941278@N00,2424,9,1230624195,1230624693,3,2,498
45941278@N00,2424,29,1230623753,1230623753,1,2,0
45941278@N00,2425,29,1282991179,1282991179,1,1,0
45941278@N00,2426,20,1299294773,1299296707,2,1,1934
45972156@N04,2427,1,1348591936,1348614420,17,5,22484
45972156@N04,2427,3,1348604232,1348612579,7,5,8347
45972156@N04,2427,9,1348601181,1348603527,3,5,2346
45972156@N04,2427,15,1348603109,1348603145,2,5,36
45972156@N04,2427,29,1348602727,1348603303,3,5,576
45972156@N04,2428,4,1348676735,1348676735,1,6,0
45972156@N04,2428,7,1348683127,1348685413,9,6,2286
45972156@N04,2428,8,1348690943,1348690975,2,6,32
45972156@N04,2428,11,1348676943,1348678400,2,6,1457
45972156@N04,2428,18,1348695499,1348697765,3,6,2266
45972156@N04,2428,24,1348689384,1348689384,1,6,0
45972156@N04,2429,9,1348954291,1348961101,3,3,6810
45972156@N04,2429,19,1348952664,1348961369,2,3,8705
45972156@N04,2429,29,1348954476,1348960119,13,3,5643
45972156@N04,2430,7,1350218642,1350220113,4,1,1471
45972156@N04,2431,1,1350274886,1350274886,1,1,0
46001741@N07,2432,8,1293758520,1293758707,5,2,187
46001741@N07,2432,15,1293758786,1293758853,5,2,67
46001741@N07,2433,3,1293787951,1293792066,59,1,4115
46001741@N07,2434,3,1293845463,1293845463,1,2,0
46001741@N07,2434,15,1293837237,1293846875,109,2,9638
46042146@N00,2435,8,1152916549,1152916549,1,1,0
46237053@N00,2436,10,1211527085,1211527085,1,3,0
46237053@N00,2436,19,1211522325,1211522325,1,3,0
46237053@N00,2436,29,1211519389,1211519389,1,3,0
46237053@N00,2437,10,1275643245,1275643245,1,1,0
46258685@N00,2438,18,1281677521,1281677521,1,2,0
46258685@N00,2438,19,1281676136,1281676136,1,2,0
46258685@N00,2439,9,1281761886,1281761886,1,1,0
46258685@N00,2440,3,1281847655,1281847655,1,2,0
46258685@N00,2440,9,1281829610,1281847660,11,2,18050
46336651@N00,2441,1,1249805440,1249805440,1,1,0
46336651@N00,2442,9,1250072342,1250072342,1,1,0
46336651@N00,2443,17,1250352455,1250352455,1,1,0
46336651@N00,2444,3,1250392595,1250392595,1,2,0
46336651@N00,2444,13,1250392530,1250392530,1,2,0
46336651@N00,2445,12,1250425360,1250425360,1,2,0
46336651@N00,2445,29,1250440707,1250441748,5,2,1041
46369309@N00,2446,13,1185841330,1185841330,1,1,0
46369309@N00,2447,16,1359860486,1359860486,2,1,0
46378751@N02,2448,29,1235611127,1235611127,1,1,0
46407455@N04,2449,15,1338638957,1338638957,1,2,0
46407455@N04,2449,29,1338645277,1338645277,1,2,0
46407455@N04,2450,19,1338706494,1338706494,1,1,0
46564901@N00,2451,1,1232851440,1232856096,2,1,4656
46865651@N00,2452,1,1365761275,1365764217,17,1,2942
46865651@N00,2453,1,1365822636,1365845106,29,1,22470
46865651@N00,2454,1,1365908709,1365939798,56,1,31089
46882566@N00,2455,18,1184289912,1184289912,1,2,0
46882566@N00,2455,29,1184297468,1184297468,1,2,0
46915646@N06,2456,8,1380448340,1380448340,1,1,0
46915646@N06,2457,15,1381542406,1381542406,1,1,0
46952961@N00,2458,15,1242459958,1242461136,7,1,1178
46952961@N00,2459,3,1242529103,1242529393,3,1,290
46952961@N00,2460,3,1242809933,1242809933,1,1,0
46952961@N00,2461,8,1242864043,1242864043,1,5,0
46952961@N00,2461,10,1242859755,1242859755,1,5,0
46952961@N00,2461,11,1242858930,1242859357,2,5,427
46952961@N00,2461,19,1242862515,1242862901,2,5,386
46952961@N00,2461,23,1242858868,1242860387,3,5,1519
46980778@N07,2462,3,1356142283,1356147321,2,1,5038
46980778@N07,2463,1,1356232992,1356240290,6,3,7298
46980778@N07,2463,8,1356228684,1356228786,2,3,102
46980778@N07,2463,29,1356230138,1356241891,5,3,11753
47072099@N04,2464,12,1342729871,1342729871,1,1,0
47072099@N04,2465,29,1376053599,1376054007,3,1,408
47134971@N00,2466,28,1246358159,1246358159,1,1,0
47136569@N07,2467,8,1263014852,1263014852,1,1,0
47136569@N07,2468,8,1265261641,1265261819,4,1,178
47183913@N00,2469,18,1175738263,1175746545,6,1,8282
47183913@N00,2470,8,1183865036,1183865318,2,2,282
47183913@N00,2470,15,1183863830,1183864985,3,2,1155
47183913@N00,2471,18,1188731278,1188733781,12,1,2503
47183913@N00,2472,18,1205815127,1205815127,1,1,0
47183913@N00,2473,8,1302311074,1302319341,7,2,8267
47183913@N00,2473,15,1302319013,1302326518,15,2,7505
47183913@N00,2474,15,1313301997,1313302437,2,1,440
47183913@N00,2475,15,1314060979,1314073904,11,1,12925
47183913@N00,2476,8,1322801838,1322806070,3,2,4232
47183913@N00,2476,15,1322806843,1322819229,14,2,12386
47183913@N00,2477,15,1332982554,1332996744,2,1,14190
47183913@N00,2478,1,1339563766,1339579807,25,1,16041
47183913@N00,2479,1,1339805097,1339823829,4,1,18732
47183913@N00,2480,9,1345001235,1345006347,38,1,5112
47183913@N00,2481,18,1353222711,1353223081,6,1,370
47183913@N00,2482,8,1354519820,1354520222,4,1,402
47183913@N00,2483,9,1360019427,1360019427,1,1,0
47229442@N06,2484,24,1346034010,1346034021,6,1,11
47259981@N00,2485,19,1136552202,1136552202,1,1,0
47339040@N00,2486,8,1167702152,1167723375,4,2,21223
47339040@N00,2486,15,1167702016,1167702016,1,2,0
47379538@N00,2487,19,1312711637,1312711938,2,1,301
47393687@N08,2488,8,1302703993,1302703993,1,1,0
47393687@N08,2489,1,1302927050,1302927050,1,1,0
47393687@N08,2490,28,1305019207,1305019207,1,1,0
47495910@N05,2491,8,1346668252,1346668252,1,5,0
47495910@N05,2491,9,1346665220,1346667113,4,5,1893
47495910@N05,2491,16,1346673515,1346673515,1,5,0
47495910@N05,2491,17,1346669309,1346669309,1,5,0
47495910@N05,2491,29,1346672836,1346673104,2,5,268
47495910@N05,2492,1,1346767934,1346768130,2,3,196
47495910@N05,2492,9,1346768654,1346769177,2,3,523
47495910@N05,2492,29,1346768444,1346768444,1,3,0
47495910@N05,2493,1,1346819852,1346819945,2,9,93
47495910@N05,2493,3,1346817362,1346817362,1,9,0
47495910@N05,2493,9,1346814951,1346816297,2,9,1346
47495910@N05,2493,10,1346833519,1346833519,1,9,0
47495910@N05,2493,11,1346833849,1346834399,2,9,550
47495910@N05,2493,12,1346819681,1346819681,1,9,0
47495910@N05,2493,17,1346816970,1346826719,2,9,9749
47495910@N05,2493,18,1346820681,1346820681,1,9,0
47495910@N05,2493,28,1346825456,1346825456,1,9,0
47610090@N07,2494,28,1310009056,1310009056,1,1,0
47616704@N00,2495,8,1274087730,1274087742,2,6,12
47616704@N00,2495,9,1274085070,1274095129,12,6,10059
47616704@N00,2495,15,1274087451,1274087485,2,6,34
47616704@N00,2495,16,1274087519,1274087519,1,6,0
47616704@N00,2495,18,1274086205,1274086765,8,6,560
47616704@N00,2495,29,1274095348,1274095348,1,6,0
47616704@N00,2496,1,1274143738,1274143810,3,3,72
47616704@N00,2496,9,1274141519,1274141531,2,3,12
47616704@N00,2496,29,1274143515,1274143515,1,3,0
47841492@N00,2497,15,1290903865,1290903865,1,1,0
47905916@N00,2498,1,1125989532,1125993197,16,7,3665
47905916@N00,2498,2,1125988005,1125988005,1,7,0
47905916@N00,2498,9,1125973172,1125973172,1,7,0
47905916@N00,2498,10,1125969903,1125969903,1,7,0
47905916@N00,2498,17,1125975219,1125975297,2,7,78
47905916@N00,2498,23,1125969476,1125970297,6,7,821
47905916@N00,2498,29,1125972687,1125977316,6,7,4629
47908666@N02,2499,8,1380354538,1380354538,1,1,0
48112523@N00,2500,18,1295155692,1295155692,1,1,0
48112523@N00,2501,2,1295578332,1295578332,1,2,0
48112523@N00,2501,4,1295578944,1295578944,1,2,0
48122140@N00,2502,2,1370936118,1370936118,1,2,0
48122140@N00,2502,19,1370919934,1370919934,1,2,0
48122140@N00,2503,1,1371071805,1371080235,39,8,8430
48122140@N00,2503,3,1371062568,1371064022,12,8,1454
48122140@N00,2503,8,1371059668,1371059668,1,8,0
48122140@N00,2503,9,1371058890,1371064173,5,8,5283
48122140@N00,2503,10,1371057252,1371057544,2,8,292
48122140@N00,2503,17,1371064033,1371064097,2,8,64
48122140@N00,2503,19,1371040257,1371057339,3,8,17082
48122140@N00,2503,29,1371059578,1371064874,8,8,5296
48122140@N00,2504,19,1371138082,1371138082,1,1,0
48122140@N00,2505,19,1371255439,1371255439,1,1,0
48235122@N02,2506,8,1302361837,1302361837,1,1,0
48264958@N00,2507,1,1084607974,1084607974,1,1,0
48277923@N00,2508,1,1281320366,1281345976,8,4,25610
48277923@N00,2508,3,1281332605,1281332605,1,4,0
48277923@N00,2508,9,1281329103,1281344017,5,4,14914
48277923@N00,2508,29,1281319213,1281319213,1,4,0
48320486@N05,2509,3,1367272809,1367272887,2,1,78
48320486@N05,2510,28,1369093044,1369093044,1,1,0
48320486@N05,2511,29,1370477277,1370477384,3,1,107
48320486@N05,2512,28,1380342430,1380342430,1,1,0
48320486@N05,2513,3,1381639272,1381639272,1,1,0
48321512@N06,2514,8,1368836709,1368836776,3,5,67
48321512@N06,2514,15,1368837185,1368839767,16,5,2582
48321512@N06,2514,18,1368838899,1368838908,2,5,9
48321512@N06,2514,19,1368836323,1368836507,4,5,184
48321512@N06,2514,22,1368839237,1368839247,2,5,10
48355243@N00,2515,9,1369548853,1369548853,1,3,0
48355243@N00,2515,15,1369545839,1369545839,1,3,0
48355243@N00,2515,16,1369547767,1369547767,1,3,0
48355243@N00,2516,1,1369800092,1369800217,3,3,125
48355243@N00,2516,3,1369807392,1369807697,5,3,305
48355243@N00,2516,9,1369790141,1369790141,1,3,0
48392589@N02,2517,1,1259970212,1259971503,2,2,1291
48392589@N02,2517,10,1259987765,1259989506,16,2,1741
48401493@N00,2518,1,1365390158,1365390158,1,1,0
48533902@N00,2519,28,1314414735,1314418292,5,1,3557
48628773@N07,2520,1,1319857200,1319859000,2,1,1800
48644834@N08,2521,29,1290678369,1290678369,1,1,0
48644834@N08,2522,9,1296449801,1296449801,1,1,0
48644834@N08,2523,9,1298417289,1298417313,2,1,24
48644834@N08,2524,18,1298619832,1298619832,1,1,0
48644834@N08,2525,8,1298957835,1298957870,2,1,35
48747795@N07,2526,1,1247719783,1247734994,4,1,15211
48762356@N00,2527,13,1227881467,1227881622,3,1,155
48762356@N00,2528,8,1228907620,1228907620,1,3,0
48762356@N00,2528,9,1228907261,1228907418,2,3,157
48762356@N00,2528,29,1228906736,1228906906,5,3,170
48762356@N00,2529,10,1230526901,1230528111,15,1,1210
48778414@N04,2530,29,1322354233,1322354233,1,1,0
48820725@N08,2531,22,1347066681,1347066681,1,2,0
48820725@N08,2531,29,1347091501,1347091501,1,2,0
48820725@N08,2532,29,1347158181,1347158181,1,1,0
48876132@N03,2533,1,1277618916,1277631501,6,1,12585
48876132@N03,2534,1,1277690762,1277690762,1,1,0
48881044@N00,2535,21,1367718839,1367718839,1,1,0
48881044@N00,2536,8,1367803529,1367803529,1,2,0
48881044@N00,2536,11,1367816041,1367822521,8,2,6480
48881044@N00,2537,11,1367890831,1367891228,3,1,397
48889036627@N01,2538,15,1148591255,1148591255,1,2,0
48889036627@N01,2538,18,1148590797,1148590797,1,2,0
48889119704@N01,2539,9,1150940503,1150940503,1,1,0
48889119704@N01,2540,19,1307068770,1307068770,1,1,0
48902193@N00,2541,1,1271840830,1271840830,1,1,0
48902193@N00,2542,1,1271898647,1271914874,41,1,16227
49007814@N03,2543,29,1377490492,1377490497,2,1,5
49009785@N00,2544,11,1146288347,1146288364,2,1,17
49021451@N00,2545,8,1218438059,1218438059,1,1,0
49033510@N00,2546,9,1139941429,1139941672,3,1,243
49128492@N06,2547,11,1334887155,1334887155,1,2,0
49128492@N06,2547,23,1334887239,1334887239,1,2,0
49202859@N04,2548,4,1308040370,1308040410,2,1,40
49256227@N00,2549,9,1382047192,1382047192,1,2,0
49256227@N00,2549,13,1382062159,1382062423,3,2,264
49281423@N02,2550,29,1344153481,1344153481,1,1,0
49281423@N02,2551,12,1344648943,1344648943,1,2,0
49281423@N02,2551,15,1344646404,1344646404,1,2,0
49429730@N08,2552,1,1345936896,1345936896,1,1,0
49447584@N02,2553,23,1318900283,1318900283,1,1,0
49479234@N00,2554,29,1369793016,1369793016,1,1,0
49502992414@N01,2555,13,1102760356,1102761461,7,1,1105
49502992414@N01,2556,11,1104493912,1104501153,4,2,7241
49502992414@N01,2556,13,1104498975,1104499029,2,2,54
49502992414@N01,2557,13,1119684885,1119693706,24,1,8821
49502992414@N01,2558,13,1155826371,1155826606,11,1,235
49503048808@N01,2559,9,1124630421,1124630421,1,1,0
49503048808@N01,2560,9,1124706485,1124706527,6,1,42
49503048808@N01,2561,17,1146756602,1146759572,3,1,2970
49503048808@N01,2562,9,1148694913,1148708127,7,1,13214
49503048808@N01,2563,9,1151176977,1151176977,3,1,0
49503048808@N01,2564,17,1161709608,1161711680,3,1,2072
49503048808@N01,2565,9,1172615740,1172615740,1,1,0
49503048808@N01,2566,9,1174926242,1174926242,1,1,0
49503076502@N01,2567,17,1300250002,1300250002,1,1,0
49503106060@N01,2568,8,1120467282,1120467282,1,2,0
49503106060@N01,2568,15,1120461604,1120461604,1,2,0
49503106060@N01,2569,4,1156897824,1156897824,1,1,0
49503126065@N01,2570,3,1375603108,1375603108,1,1,0
49503126065@N01,2571,27,1393719462,1393719462,1,1,0
49503132817@N01,2572,9,1309092484,1309092484,1,3,0
49503132817@N01,2572,28,1309080278,1309080278,1,3,0
49503132817@N01,2572,29,1309091859,1309091932,2,3,73
49503152615@N01,2573,16,1319274975,1319274975,1,1,0
49522551@N00,2574,28,1308824485,1308824485,1,2,0
49522551@N00,2574,29,1308808057,1308814059,2,2,6002
49522551@N00,2575,9,1308909337,1308909337,1,1,0
49705428@N05,2576,2,1339925837,1339925876,2,2,39
49705428@N05,2576,8,1339925918,1339925918,1,2,0
49707497@N06,2577,23,1273842777,1273842786,3,1,9
49998283@N00,2578,1,1209520350,1209531419,14,3,11069
49998283@N00,2578,9,1209528895,1209535173,4,3,6278
49998283@N00,2578,19,1209546358,1209546358,1,3,0
49998283@N00,2579,9,1209607148,1209607148,1,1,0
50008854@N02,2580,29,1288863051,1288863051,1,1,0
50075316@N00,2581,7,1282369343,1282370206,5,2,863
50075316@N00,2581,24,1282367345,1282367345,1,2,0
50075316@N00,2582,18,1282535402,1282535402,1,1,0
50195515@N00,2583,1,1243556089,1243557020,3,7,931
50195515@N00,2583,8,1243584200,1243584314,2,7,114
50195515@N00,2583,9,1243571224,1243571224,1,7,0
50195515@N00,2583,11,1243580333,1243580333,1,7,0
50195515@N00,2583,15,1243554575,1243554575,1,7,0
50195515@N00,2583,16,1243566053,1243566150,3,7,97
50195515@N00,2583,29,1243555130,1243565458,3,7,10328
50228469@N03,2584,28,1368344874,1368344874,1,1,0
50228469@N03,2585,7,1368448884,1368451208,3,1,2324
50234824@N07,2586,28,1253078812,1253078812,1,1,0
50234824@N07,2587,1,1253947158,1253947158,1,4,0
50234824@N07,2587,9,1253944112,1253944246,2,4,134
50234824@N07,2587,18,1253946480,1253946480,1,4,0
50234824@N07,2587,29,1253944915,1253945135,3,4,220
50234824@N07,2588,19,1261212608,1261212608,1,1,0
50234824@N07,2589,16,1292055304,1292055304,1,1,0
50249220@N00,2590,1,959781600,959781600,4,1,0
50249220@N00,2591,16,1250563127,1250563127,1,1,0
50249220@N00,2592,7,1250761680,1250761680,1,2,0
50249220@N00,2592,8,1250740576,1250740576,1,2,0
50249220@N00,2593,8,1250834853,1250834853,1,1,0
50336060@N02,2594,3,1328293506,1328293506,1,1,0
50336060@N02,2595,13,1328564745,1328568922,2,2,4177
50336060@N02,2595,28,1328570020,1328570020,1,2,0
50336060@N02,2596,8,1328611560,1328611560,1,1,0
50336060@N02,2597,19,1328691188,1328691188,1,1,0
50336060@N02,2598,8,1328784799,1328784799,1,1,0
50505243@N00,2599,9,1100071135,1100071292,3,1,157
50509003@N00,2600,1,1251860707,1251860707,1,4,0
50509003@N00,2600,8,1251876260,1251877823,3,4,1563
50509003@N00,2600,9,1251854976,1251854976,1,4,0
50509003@N00,2600,18,1251874648,1251875209,2,4,561
50509003@N00,2601,9,1252073427,1252073427,1,1,0
50509003@N00,2602,1,1253587299,1253587313,3,6,14
50509003@N00,2602,8,1253587357,1253587374,4,6,17
50509003@N00,2602,9,1253587289,1253587388,2,6,99
50509003@N00,2602,15,1253587320,1253587325,2,6,5
50509003@N00,2602,18,1253587335,1253587345,2,6,10
50509003@N00,2602,29,1253587316,1253587316,1,6,0
50542255@N00,2603,29,1134896442,1134898038,14,1,1596
50542255@N00,2604,19,1140855422,1140855422,1,2,0
50542255@N00,2604,29,1140855059,1140855059,2,2,0
50542255@N00,2605,8,1165488577,1165488577,1,3,0
50542255@N00,2605,12,1165493352,1165493783,2,3,431
50542255@N00,2605,15,1165491035,1165491245,2,3,210
50542255@N00,2606,24,1167860786,1167861741,2,1,955
50551683@N00,2607,8,1293768347,1293768371,2,1,24
50551683@N00,2608,1,1293854489,1293854489,1,4,0
50551683@N00,2608,3,1293864492,1293864492,1,4,0
50551683@N00,2608,9,1293866131,1293866131,1,4,0
50551683@N00,2608,15,1293866122,1293866122,1,4,0
50551683@N00,2609,22,1293931918,1293931918,1,1,0
50576141@N03,2610,9,1350222901,1350222901,1,2,0
50576141@N03,2610,19,1350206810,1350226074,3,2,19264
50576141@N03,2611,9,1350308768,1350308768,1,2,0
50576141@N03,2611,15,1350297775,1350297849,3,2,74
50576141@N03,2612,29,1381834022,1381834022,1,1,0
50576141@N03,2613,18,1382082447,1382082447,1,1,0
50631360@N00,2614,10,1282210847,1282210847,1,1,0
50706998@N00,2615,9,1251444227,1251444227,1,1,0
50794252@N04,2616,29,1390448115,1390448115,1,1,0
50794252@N04,2617,1,1390535509,1390535509,1,3,0
50794252@N04,2617,15,1390535861,1390535861,1,3,0
50794252@N04,2617,29,1390561332,1390563715,2,3,2383
50802125@N00,2618,1,1131939462,1131941571,6,3,2109
50802125@N00,2618,9,1131941801,1131941801,1,3,0
50802125@N00,2618,15,1131943410,1131943410,1,3,0
50804506@N00,2619,2,1375770350,1375770350,1,1,0
50833784@N00,2620,29,1344848009,1344848009,1,1,0
50833784@N00,2621,2,1346804232,1346804232,1,1,0
50833784@N00,2622,4,1349311175,1349311182,2,1,7
50833784@N00,2623,9,1353726978,1353726978,1,1,0
50833784@N00,2624,12,1354335027,1354335027,1,1,0
50833784@N00,2625,1,1370669730,1370670586,6,10,856
50833784@N00,2625,2,1370672252,1370672252,1,10,0
50833784@N00,2625,3,1370670023,1370671039,3,10,1016
50833784@N00,2625,4,1370671689,1370672076,4,10,387
50833784@N00,2625,8,1370669181,1370669181,1,10,0
50833784@N00,2625,18,1370669668,1370669668,1,10,0
50833784@N00,2625,19,1370672348,1370672398,3,10,50
50833784@N00,2625,23,1370671255,1370671255,1,10,0
50833784@N00,2625,24,1370671813,1370671899,4,10,86
50833784@N00,2625,29,1370670633,1370670693,3,10,60
50833784@N00,2626,21,1371437680,1371437680,1,1,0
50833784@N00,2627,21,1371628681,1371628681,1,1,0
50833784@N00,2628,10,1373617654,1373633219,5,1,15565
50947024@N05,2629,9,1368242104,1368242104,1,2,0
50947024@N05,2629,29,1368241970,1368241970,1,2,0
51035571386@N01,2630,16,1117259065,1117259065,1,1,0
51035594294@N01,2631,25,1125713902,1125713902,1,1,0
51035594294@N01,2632,23,1125872491,1125872491,1,1,0
51035639266@N01,2633,1,1145957523,1145966400,3,4,8877
51035639266@N01,2633,12,1145955074,1145966561,2,4,11487
51035639266@N01,2633,15,1145953570,1145953570,1,4,0
51035639266@N01,2633,19,1145953395,1145953395,1,4,0
51035711196@N01,2634,3,1250066174,1250066174,1,1,0
51035711196@N01,2635,18,1250141309,1250141322,2,2,13
51035711196@N01,2635,29,1250156239,1250156239,1,2,0
51035711196@N01,2636,17,1250315380,1250315380,1,1,0
51035733706@N01,2637,29,1177790840,1177790840,1,1,0
51035737977@N01,2638,29,1289012520,1289013380,2,1,860
51035737977@N01,2639,4,1289086502,1289086502,1,3,0
51035737977@N01,2639,9,1289105516,1289105516,1,3,0
51035737977@N01,2639,29,1289110960,1289110960,1,3,0
51035747100@N01,2640,16,1334044599,1334044599,1,2,0
51035747100@N01,2640,18,1334055718,1334055718,1,2,0
51035804249@N01,2641,12,1159323848,1159323936,14,1,88
51035813914@N01,2642,19,1345713590,1345713590,1,1,0
51036193@N00,2643,4,1217299705,1217299705,1,1,0
51036193@N00,2644,15,1227661256,1227661681,4,1,425
51272891@N00,2645,3,1184732732,1184732732,1,5,0
51272891@N00,2645,9,1184724968,1184724968,1,5,0
51272891@N00,2645,19,1184737954,1184737954,1,5,0
51272891@N00,2645,23,1184727786,1184727786,1,5,0
51272891@N00,2645,29,1184722427,1184724448,4,5,2021
51350151@N06,2646,19,1357945891,1357965883,5,1,19992
51367743@N00,2647,2,1185955693,1185955693,1,7,0
51367743@N00,2647,4,1185954552,1185954969,3,7,417
51367743@N00,2647,9,1185948005,1185949668,3,7,1663
51367743@N00,2647,10,1185958513,1185958877,4,7,364
51367743@N00,2647,11,1185958998,1185958998,1,7,0
51367743@N00,2647,15,1185945101,1185945151,2,7,50
51367743@N00,2647,17,1185950839,1185951013,2,7,174
51367743@N00,2648,1,1186018319,1186027201,4,3,8882
51367743@N00,2648,16,1186040532,1186040532,1,3,0
51367743@N00,2648,29,1186016449,1186030959,2,3,14510
51367743@N00,2649,2,1186111668,1186111702,2,2,34
51367743@N00,2649,12,1186104313,1186104313,1,2,0
51367743@N00,2650,8,1186292667,1186296415,3,2,3748
51367743@N00,2650,18,1186277319,1186277747,2,2,428
51367743@N00,2651,1,1186381302,1186381302,1,5,0
51367743@N00,2651,2,1186398063,1186398063,1,5,0
51367743@N00,2651,8,1186380129,1186380129,1,5,0
51367743@N00,2651,11,1186378099,1186379832,3,5,1733
51367743@N00,2651,16,1186398914,1186398914,1,5,0
51367743@N00,2652,17,1186895137,1186895137,1,1,0
51367743@N00,2653,1,1187006687,1187006780,4,1,93
51367743@N00,2654,4,1187502886,1187502886,1,1,0
51416543@N08,2655,19,1311583126,1311583126,1,1,0
51416543@N08,2656,9,1312005070,1312005070,1,1,0
51464530@N00,2657,20,1235261636,1235263837,12,1,2201
51518769@N04,2658,9,1312265486,1312265486,1,1,0
51518769@N04,2659,3,1313480310,1313480310,1,1,0
51557140@N00,2660,9,1195529623,1195529733,2,2,110
51557140@N00,2660,29,1195533711,1195533711,1,2,0
51578845@N04,2661,29,1311575535,1311575555,2,1,20
51578845@N04,2662,18,1311904456,1311904456,1,2,0
51578845@N04,2662,29,1311912203,1311912481,2,2,278
51643564@N00,2663,15,1313659929,1313659929,1,1,0
51643564@N00,2664,13,1313731749,1313731753,4,2,4
51643564@N00,2664,17,1313742886,1313742886,1,2,0
51643564@N00,2665,29,1313833975,1313833975,1,1,0
51686984@N05,2666,4,1308007516,1308007516,1,1,0
51857345@N00,2667,24,1262925516,1262925516,1,1,0
51857345@N00,2668,27,1278209220,1278209220,1,1,0
51867225@N08,2669,3,1312838188,1312838188,1,1,0
51867225@N08,2670,2,1317783819,1317783819,1,1,0
51894000@N00,2671,13,1236930709,1236930709,1,1,0
51894000@N00,2672,13,1238751925,1238751925,1,1,0
52015062@N00,2673,1,1299197213,1299197357,3,6,144
52015062@N00,2673,8,1299197435,1299197963,5,6,528
52015062@N00,2673,9,1299187738,1299219869,58,6,32131
52015062@N00,2673,15,1299197974,1299198169,5,6,195
52015062@N00,2673,19,1299196785,1299204471,2,6,7686
52015062@N00,2673,29,1299196336,1299197654,17,6,1318
52015062@N00,2674,2,1299256461,1299256642,4,4,181
52015062@N00,2674,4,1299255006,1299255314,4,4,308
52015062@N00,2674,9,1299271185,1299299941,22,4,28756
52015062@N00,2674,19,1299283882,1299284002,2,4,120
52015062@N00,2675,29,1299356585,1299356585,1,1,0
52289088@N00,2676,3,1155406890,1155408026,2,1,1136
52289088@N00,2677,3,1155915553,1155916408,2,1,855
52289088@N00,2678,3,1155960281,1155988193,2,1,27912
52289088@N00,2679,3,1156052607,1156052607,1,1,0
52289088@N00,2680,3,1156089114,1156089114,1,1,0
52323908@N00,2681,3,1150844882,1150845745,2,1,863
52323908@N00,2682,17,1151211423,1151215049,2,1,3626
52439376@N00,2683,4,1284526738,1284527041,2,5,303
52439376@N00,2683,8,1284515862,1284516740,11,5,878
52439376@N00,2683,17,1284523651,1284525444,3,5,1793
52439376@N00,2683,19,1284528250,1284528277,2,5,27
52439376@N00,2683,29,1284524160,1284529209,4,5,5049
52683275@N00,2684,1,1216859144,1216859144,1,3,0
52683275@N00,2684,3,1216859168,1216859196,2,3,28
52683275@N00,2684,9,1216859178,1216859178,1,3,0
52686644@N04,2685,12,1320462202,1320465310,23,1,3108
52686644@N04,2686,12,1336200152,1336200152,1,1,0
52706710@N03,2687,14,1283327712,1283327944,3,1,232
52706710@N03,2688,1,1303450349,1303456890,4,4,6541
52706710@N03,2688,3,1303447655,1303447655,1,4,0
52706710@N03,2688,8,1303448578,1303448578,1,4,0
52706710@N03,2688,15,1303448963,1303448963,1,4,0
52706710@N03,2689,1,1303608440,1303608440,1,1,0
52706710@N03,2690,3,1304056401,1304056521,2,1,120
52706710@N03,2691,3,1305963578,1305963578,1,1,0
52706710@N03,2692,3,1310275791,1310275791,1,1,0
52706710@N03,2693,3,1312003808,1312005859,3,1,2051
52706710@N03,2694,17,1312445353,1312445378,2,1,25
52706710@N03,2695,12,1312597140,1312597797,3,1,657
52706710@N03,2696,22,1313921895,1313921895,1,1,0
52706710@N03,2697,8,1314590585,1314590746,4,2,161
52706710@N03,2697,20,1314592967,1314593702,13,2,735
52706710@N03,2698,8,1314841589,1314842192,7,2,603
52706710@N03,2698,19,1314840929,1314841226,6,2,297
52706710@N03,2699,15,1340876944,1340876944,1,1,0
52728482@N05,2700,18,396332363,396332363,1,1,0
52783780@N03,2701,19,1376645077,1376645077,1,1,0
52984273@N00,2702,17,1302166487,1302166487,1,2,0
52984273@N00,2702,29,1302166584,1302166584,1,2,0
52984273@N00,2703,12,1302251878,1302251878,1,2,0
52984273@N00,2703,29,1302249314,1302249314,1,2,0
52984273@N00,2704,29,1302314847,1302315801,2,1,954
53198608@N07,2705,22,1319967736,1319967736,1,1,0
53246655@N00,2706,3,1182256225,1182256225,1,1,0
53254590@N05,2707,29,1338779185,1338784412,18,1,5227
53260610@N04,2708,8,1347937493,1347937493,1,1,0
53260610@N04,2709,8,1348019486,1348019486,1,2,0
53260610@N04,2709,17,1348028373,1348028496,2,2,123
53327729@N00,2710,1,1109324499,1109324499,1,1,0
53327729@N00,2711,1,1153355548,1153355548,1,1,0
53352905@N05,2712,14,1355793088,1355793088,1,1,0
53568188@N02,2713,19,1370418051,1370418051,1,1,0
53628269@N06,2714,9,1315325708,1315325708,1,1,0
53725815@N00,2715,5,1264140403,1264140403,1,1,0
53806217@N00,2716,4,1207367560,1207367560,1,2,0
53806217@N00,2716,15,1207360320,1207360320,1,2,0
53834128@N06,2717,19,1333392344,1333425803,57,1,33459
53836246@N00,2718,2,1388028777,1388031435,2,4,2658
53836246@N00,2718,4,1388031446,1388031754,2,4,308
53836246@N00,2718,8,1388035899,1388035899,1,4,0
53836246@N00,2718,10,1388031481,1388031481,1,4,0
53836246@N00,2719,1,1388113781,1388139593,4,2,25812
53836246@N00,2719,9,1388143939,1388143939,1,2,0
53836246@N00,2720,1,1388192554,1388192554,1,4,0
53836246@N00,2720,3,1388194389,1388194708,2,4,319
53836246@N00,2720,9,1388189609,1388191181,4,4,1572
53836246@N00,2720,29,1388192331,1388192331,1,4,0
53836246@N00,2721,9,1388390234,1388393898,2,5,3664
53836246@N00,2721,10,1388396234,1388396234,1,5,0
53836246@N00,2721,11,1388395740,1388395740,1,5,0
53836246@N00,2721,16,1388394170,1388394170,1,5,0
53836246@N00,2721,19,1388394770,1388397353,2,5,2583
53836246@N00,2722,2,1388467538,1388467538,1,4,0
53836246@N00,2722,4,1388467750,1388467750,1,4,0
53836246@N00,2722,10,1388493040,1388495044,4,4,2004
53836246@N00,2722,11,1388482150,1388482150,1,4,0
53921762@N00,2723,9,1218950358,1218951242,3,3,884
53921762@N00,2723,15,1218956950,1218956950,1,3,0
53921762@N00,2723,18,1218956875,1218956875,1,3,0
53921762@N00,2724,9,1219472947,1219472947,1,1,0
53921762@N00,2725,4,1251514948,1251514948,1,1,0
53921762@N00,2726,3,1268613675,1268614045,3,2,370
53921762@N00,2726,17,1268614055,1268614055,1,2,0
53921762@N00,2727,8,1374974640,1374974640,1,3,0
53921762@N00,2727,19,1374977550,1374977550,1,3,0
53921762@N00,2727,29,1374979048,1374982327,3,3,3279
53921762@N00,2728,28,1375430906,1375430906,1,1,0
53998877@N00,2729,13,1282136354,1282136607,3,1,253
53998877@N00,2730,13,1282211020,1282211650,5,1,630
53998877@N00,2731,13,1282304352,1282304442,2,1,90
53998877@N00,2732,13,1282368321,1282368644,2,1,323
54022106@N00,2733,3,1199360032,1199360032,1,1,0
54022106@N00,2734,3,1216865377,1216865377,1,1,0
54022106@N00,2735,9,1219553407,1219553790,3,2,383
54022106@N00,2735,17,1219554093,1219554093,1,2,0
54022106@N00,2736,3,1228874731,1228874974,2,2,243
54022106@N00,2736,9,1228872715,1228872715,1,2,0
54022106@N00,2737,9,1230524810,1230524810,1,1,0
54022106@N00,2738,28,1230870541,1230870541,1,1,0
54022106@N00,2739,20,1234668562,1234671873,2,1,3311
54022106@N00,2740,9,1235101883,1235101883,1,2,0
54022106@N00,2740,16,1235103375,1235103832,2,2,457
54022106@N00,2741,20,1235267419,1235267419,1,1,0
54022106@N00,2742,3,1238144942,1238146384,3,2,1442
54022106@N00,2742,12,1238146655,1238148674,2,2,2019
54022106@N00,2743,13,1238903523,1238903523,1,1,0
54022106@N00,2744,16,1246151009,1246151009,1,1,0
54022106@N00,2745,13,1249789208,1249789208,1,1,0
54022106@N00,2746,1,1250251665,1250251665,1,2,0
54022106@N00,2746,29,1250249561,1250250545,3,2,984
54022106@N00,2747,20,1250567600,1250567600,1,1,0
54022106@N00,2748,28,1254028266,1254028266,1,1,0
54022106@N00,2749,4,1255740727,1255749040,3,3,8313
54022106@N00,2749,24,1255746768,1255748809,3,3,2041
54022106@N00,2749,28,1255745067,1255745067,1,3,0
54022106@N00,2750,3,1256170214,1256173007,3,1,2793
54022106@N00,2751,27,1257042878,1257047505,3,1,4627
54022106@N00,2752,3,1262775445,1262778543,6,3,3098
54022106@N00,2752,8,1262775445,1262775445,1,3,0
54022106@N00,2752,29,1262775445,1262775445,3,3,0
54022106@N00,2753,20,1264911342,1264911342,1,1,0
54022106@N00,2754,27,1266722741,1266722741,1,1,0
54022106@N00,2755,9,1281500673,1281504718,5,1,4045
54022106@N00,2756,3,1281682450,1281682450,1,2,0
54022106@N00,2756,9,1281681559,1281681559,1,2,0
54022106@N00,2757,3,1281766772,1281766772,1,3,0
54022106@N00,2757,17,1281761286,1281761286,1,3,0
54022106@N00,2757,19,1281768223,1281768223,1,3,0
54022106@N00,2758,12,1282389065,1282389065,1,1,0
54022106@N00,2759,16,1294397576,1294397576,1,1,0
54022106@N00,2760,27,1303269541,1303269541,1,1,0
54022106@N00,2761,27,1310708381,1310708429,2,1,48
54022106@N00,2762,3,1311388722,1311388722,1,1,0
54022106@N00,2763,3,1315716579,1315716579,1,1,0
54022106@N00,2764,3,1318309185,1318309194,2,1,9
54022106@N00,2765,1,1325994578,1325994578,1,1,0
54022106@N00,2766,20,1329022545,1329022545,1,1,0
54022106@N00,2767,20,1329176982,1329176982,1,1,0
54022106@N00,2768,8,1330232633,1330232633,1,1,0
54069048@N07,2769,8,1355627027,1355627027,1,3,0
54069048@N07,2769,19,1355627033,1355627033,1,3,0
54069048@N07,2769,29,1355624759,1355624759,1,3,0
54101435@N00,2770,8,1261611376,1261612119,5,1,743
54115632@N00,2771,4,1318110603,1318110958,4,1,355
54115632@N00,2772,4,1318196220,1318197354,7,1,1134
54145418@N00,2773,9,1287790848,1287790913,2,1,65
54151899@N00,2774,15,1277563362,1277563362,1,1,0
54264534@N07,2775,9,1292142001,1292142001,1,2,0
54264534@N07,2775,17,1292142236,1292142236,1,2,0
54264534@N07,2776,28,1293721995,1293721995,1,1,0
54281810@N07,2777,9,1288154065,1288154065,1,2,0
54281810@N07,2777,29,1288151702,1288151702,1,2,0
54290468@N07,2778,29,1290162308,1290162308,1,1,0
54408024@N00,2779,3,1142712966,1142712966,1,1,0
54408024@N00,2780,29,1143632727,1143632727,1,1,0
54408024@N00,2781,4,1153214886,1153214886,1,1,0
54408024@N00,2782,9,1155484225,1155494091,6,1,9866
54408024@N00,2783,9,1155664457,1155664457,1,1,0
54408024@N00,2784,9,1155844902,1155845038,3,1,136
54408024@N00,2785,29,1156740706,1156740706,1,1,0
54408024@N00,2786,13,1157023656,1157023656,1,2,0
54408024@N00,2786,29,1156997882,1156997882,1,2,0
54408024@N00,2787,29,1158210995,1158210995,1,1,0
54408024@N00,2788,29,1158631002,1158631127,3,1,125
54408024@N00,2789,1,1291006150,1291006210,2,1,60
54408024@N00,2790,1,1291104093,1291104093,1,1,0
54458860@N00,2791,2,1257568075,1257568089,2,3,14
54458860@N00,2791,4,1257568046,1257568046,1,3,0
54458860@N00,2791,9,1257564183,1257564314,2,3,131
54458860@N00,2792,1,1258939227,1258939227,1,2,0
54458860@N00,2792,29,1258931978,1258931978,1,2,0
54521680@N00,2793,4,1217027293,1217027293,1,1,0
54549576@N00,2794,1,1243429449,1243429449,1,6,0
54549576@N00,2794,2,1243429487,1243429549,9,6,62
54549576@N00,2794,4,1243429543,1243429543,1,6,0
54549576@N00,2794,10,1243429537,1243429537,1,6,0
54549576@N00,2794,18,1243429480,1243429480,1,6,0
54549576@N00,2794,23,1243429443,1243429474,5,6,31
54549576@N00,2795,3,1243502117,1243502156,8,3,39
54549576@N00,2795,4,1243502161,1243502208,9,3,47
54549576@N00,2795,24,1243502112,1243502112,1,3,0
54837389@N00,2796,4,1104106365,1104106402,2,1,37
54837389@N00,2797,4,1131153623,1131153623,1,1,0
54837389@N00,2798,4,1132189563,1132189563,1,1,0
54858071@N00,2799,28,1208583032,1208583032,1,1,0
54858071@N00,2800,9,1299295903,1299295903,1,2,0
54858071@N00,2800,11,1299293261,1299293261,1,2,0
54879137@N00,2801,14,1370922018,1370922018,1,1,0
54879137@N00,2802,14,1371100241,1371111588,3,2,11347
54879137@N00,2802,15,1371120739,1371120739,1,2,0
54907057@N07,2803,4,1289991948,1289991948,1,1,0
54919879@N00,2804,11,1237450118,1237450118,1,2,0
54919879@N00,2804,23,1237449796,1237450660,2,2,864
55016393@N00,2805,29,1325556824,1325575880,7,1,19056
55016393@N00,2806,9,1325646865,1325646865,1,1,0
55069612@N00,2807,9,1183884992,1183884992,1,1,0
55231259@N00,2808,3,1324957721,1324962297,10,1,4576
55238998@N00,2809,20,1185596125,1185600018,15,1,3893
55238998@N00,2810,8,1185684932,1185684932,1,1,0
55238998@N00,2811,8,1296876985,1296876985,1,1,0
55426027@N03,2812,8,1398313927,1398313927,1,1,0
55456666@N00,2813,3,1150514331,1150514331,1,1,0
55456666@N00,2814,9,1156121037,1156121196,5,1,159
55456666@N00,2815,9,1156316840,1156317615,3,1,775
55548179@N05,2816,16,1371441318,1371441318,1,1,0
55745940@N00,2817,12,1241561085,1241561085,1,1,0
55745940@N00,2818,12,1263806815,1263810771,3,1,3956
55826454@N00,2819,12,1380877267,1380878467,5,1,1200
55826454@N00,2820,1,1380938323,1380938453,3,10,130
55826454@N00,2820,8,1380936398,1380940513,2,10,4115
55826454@N00,2820,9,1380944308,1380945956,2,10,1648
55826454@N00,2820,10,1380948345,1380948345,1,10,0
55826454@N00,2820,12,1380938153,1380938153,1,10,0
55826454@N00,2820,15,1380933332,1380933332,1,10,0
55826454@N00,2820,19,1380940164,1380940164,1,10,0
55826454@N00,2820,23,1380939942,1380939942,1,10,0
55826454@N00,2820,28,1380935346,1380935346,1,10,0
55826454@N00,2820,29,1380938572,1380943757,3,10,5185
55826454@N00,2821,1,1381022207,1381026433,4,1,4226
55919472@N00,2822,3,1338614646,1338616829,7,1,2183
55935853@N00,2823,3,1163305560,1163305560,1,1,0
56044438@N00,2824,29,1121392972,1121392972,1,1,0
56335302@N00,2825,9,1277980954,1277980954,1,2,0
56335302@N00,2825,19,1277978267,1277978267,1,2,0
56335302@N00,2826,9,1300694543,1300694543,1,1,0
56335302@N00,2827,13,1303813751,1303813751,1,1,0
56335302@N00,2828,3,1314324219,1314324219,1,1,0
56339323@N00,2829,10,1238738315,1238738695,3,1,380
56355370@N00,2830,4,1314320681,1314320698,2,1,17
56355370@N00,2831,24,1371185648,1371185648,1,1,0
56357455@N00,2832,17,1235706851,1235706851,1,1,0
56435120@N00,2833,1,1232615073,1232615094,2,1,21
56435120@N00,2834,1,1232680893,1232686053,53,1,5160
56435120@N00,2835,1,1232756737,1232758031,9,1,1294
56435120@N00,2836,1,1232898410,1232900378,2,2,1968
56435120@N00,2836,3,1232926077,1232928932,58,2,2855
56435120@N00,2837,3,1233119989,1233124074,3,1,4085
56566998@N00,2838,20,1298134118,1298134118,1,1,0
56610645@N08,2839,8,1341104436,1341104436,1,1,0
56617401@N00,2840,1,1309046461,1309074547,72,3,28086
56617401@N00,2840,8,1309076938,1309076938,1,3,0
56617401@N00,2840,19,1309036388,1309036388,1,3,0
56617401@N00,2841,8,1309143973,1309143973,1,1,0
56617401@N00,2842,8,1309234005,1309234949,3,1,944
56617401@N00,2843,8,1309354515,1309354515,1,2,0
56617401@N00,2843,9,1309345419,1309345419,1,2,0
56617401@N00,2844,8,1309388430,1309388430,1,1,0
56617401@N00,2845,8,1309424043,1309433173,10,6,9130
56617401@N00,2845,9,1309422625,1309434471,21,6,11846
56617401@N00,2845,15,1309432687,1309432743,3,6,56
56617401@N00,2845,16,1309432521,1309432632,4,6,111
56617401@N00,2845,19,1309433207,1309433229,2,6,22
56617401@N00,2845,29,1309432377,1309432464,4,6,87
56701337@N00,2846,22,1282360327,1282360327,1,1,0
56917152@N00,2847,29,1186194369,1186194369,1,1,0
56917152@N00,2848,3,1186533563,1186533563,1,1,0
56969211@N00,2849,1,1242972169,1242972169,1,1,0
57192952@N00,2850,1,1278125231,1278125231,1,4,0
57192952@N00,2850,8,1278123289,1278123289,1,4,0
57192952@N00,2850,16,1278124663,1278124663,1,4,0
57192952@N00,2850,29,1278124872,1278124872,1,4,0
57192952@N00,2851,4,1278155115,1278155218,2,1,103
57192952@N00,2852,1,1278208713,1278208722,2,1,9
57258627@N00,2853,8,1396743354,1396746640,3,5,3286
57258627@N00,2853,9,1396690677,1396743120,2,5,52443
57258627@N00,2853,16,1396745099,1396745099,1,5,0
57258627@N00,2853,17,1396718437,1396718437,1,5,0
57258627@N00,2853,19,1396690433,1396690433,1,5,0
57299246@N00,2854,9,1250470860,1250470860,1,1,0
57304142@N08,2855,12,1383598778,1383598778,1,1,0
57304142@N08,2856,14,1386554816,1386554816,1,1,0
57446549@N00,2857,17,1250827987,1250827987,1,1,0
57511216@N04,2858,8,1370659118,1370659118,1,2,0
57511216@N04,2858,15,1370661260,1370661260,1,2,0
57518678@N00,2859,29,1343277351,1343277351,1,1,0
57518678@N00,2860,15,1343446830,1343446830,1,1,0
57688343@N00,2861,11,1280496940,1280496940,1,1,0
57761648@N02,2862,1,1309740036,1309740036,1,1,0
57879122@N00,2863,17,1376474701,1376474701,1,1,0
57879122@N00,2864,19,1379663233,1379663233,1,1,0
57879122@N00,2865,16,1384851502,1384851502,1,1,0
57879122@N00,2866,3,1391734135,1391734135,1,1,0
57899800@N00,2867,28,1201312806,1201312806,1,1,0
57899800@N00,2868,3,1218591949,1218591949,1,2,0
57899800@N00,2868,9,1218594294,1218594294,1,2,0
57899800@N00,2869,21,1302572775,1302572775,1,1,0
57899800@N00,2870,18,1313826196,1313826196,1,1,0
57899800@N00,2871,28,1314066231,1314066231,1,1,0
57899800@N00,2872,19,1344236762,1344236762,1,1,0
57899800@N00,2873,13,1345260578,1345260578,1,1,0
57899800@N00,2874,28,1353476991,1353478423,3,1,1432
57899800@N00,2875,19,1360990487,1360991705,3,1,1218
57899800@N00,2876,20,1364089341,1364090220,5,1,879
57899800@N00,2877,28,1376449651,1376449651,1,1,0
57899800@N00,2878,14,1384588282,1384588282,1,1,0
58034287@N00,2879,8,1342655980,1342655980,1,6,0
58034287@N00,2879,9,1342656145,1342656175,2,6,30
58034287@N00,2879,15,1342661067,1342661067,1,6,0
58034287@N00,2879,16,1342656500,1342656500,1,6,0
58034287@N00,2879,19,1342632951,1342633224,2,6,273
58034287@N00,2879,29,1342656296,1342656296,1,6,0
58050880@N02,2880,4,1380935939,1380935939,1,2,0
58050880@N02,2880,9,1380945286,1380945286,1,2,0
58050880@N02,2881,10,1381034458,1381036949,6,2,2491
58050880@N02,2881,15,1381040942,1381040962,2,2,20
58096905@N07,2882,1,1313034337,1313050674,2,1,16337
58096905@N07,2883,13,1370501832,1370517751,4,1,15919
58169987@N00,2884,27,1227407760,1227418866,2,1,11106
58255533@N03,2885,1,1296215629,1296215629,1,1,0
58366288@N07,2886,13,1336263418,1336263418,1,1,0
58372479@N04,2887,8,1341051132,1341051132,1,2,0
58372479@N04,2887,15,1341052333,1341052333,1,2,0
58372479@N04,2888,18,1341091454,1341091454,1,1,0
58372479@N04,2889,13,1345582819,1345582819,1,1,0
58372479@N04,2890,29,1359630983,1359630983,1,1,0
58433801@N07,2891,4,1387506643,1387506643,1,3,0
58433801@N07,2891,15,1387498290,1387498290,1,3,0
58433801@N07,2891,19,1387508105,1387508105,1,3,0
58554451@N00,2892,8,1297481400,1297481490,2,1,90
58554451@N00,2893,2,1362885602,1362886658,6,4,1056
58554451@N00,2893,4,1362885448,1362885758,3,4,310
58554451@N00,2893,9,1362882461,1362883930,7,4,1469
58554451@N00,2893,29,1362882339,1362882922,5,4,583
58554451@N00,2894,3,1362967534,1362968170,8,1,636
58598613@N00,2895,4,1183789723,1183790510,7,2,787
58598613@N00,2895,9,1183791870,1183791929,2,2,59
58598613@N00,2896,2,1183874861,1183874861,1,3,0
58598613@N00,2896,4,1183872914,1183872914,1,3,0
58598613@N00,2896,9,1183869972,1183871149,4,3,1177
58646546@N00,2897,1,1341057702,1341057702,1,2,0
58646546@N00,2897,18,1341057708,1341057708,1,2,0
58648602@N04,2898,3,1339989887,1339991284,2,1,1397
58648602@N04,2899,19,1340936370,1340936390,2,1,20
58648602@N04,2900,17,1342932023,1342932023,1,1,0
58648602@N04,2901,8,1385541706,1385542455,4,1,749
58648602@N04,2902,4,1389060097,1389060212,2,1,115
58695432@N00,2903,1,1049608145,1049608145,2,1,0
58695432@N00,2904,10,1053236945,1053236945,1,1,0
58695432@N00,2905,27,1077670800,1077670800,1,1,0
58695432@N00,2906,19,1155885114,1155885228,2,1,114
58695432@N00,2907,10,1156130664,1156130664,1,3,0
58695432@N00,2907,11,1156130779,1156130779,1,3,0
58695432@N00,2907,19,1156141618,1156141618,1,3,0
58695432@N00,2908,15,1156311255,1156311255,1,2,0
58695432@N00,2908,18,1156312319,1156312319,1,2,0
58695432@N00,2909,9,1156409829,1156412567,2,1,2738
58695432@N00,2910,21,1157331576,1157331576,1,1,0
58804416@N00,2911,8,1283151347,1283151347,1,1,0
58804416@N00,2912,8,1283215562,1283215583,2,2,21
58804416@N00,2912,15,1283215197,1283215197,1,2,0
58804416@N00,2913,8,1292715557,1292731320,4,1,15763
58804416@N00,2914,8,1292810071,1292837405,4,2,27334
58804416@N00,2914,20,1292814451,1292814451,1,2,0
58989967@N00,2915,1,1105224530,1105231792,27,1,7262
58989967@N00,2916,1,1233060145,1233060165,2,1,20
59002912@N08,2917,1,1343363939,1343370049,5,1,6110
59271446@N00,2918,18,1197767902,1197767902,1,1,0
59271446@N00,2919,15,1218154194,1218155921,4,1,1727
59271446@N00,2920,8,1223611822,1223615614,2,1,3792
59271446@N00,2921,15,1224821565,1224821565,1,1,0
59271446@N00,2922,15,1227843060,1227843060,1,1,0
59271446@N00,2923,17,1250136905,1250139418,25,1,2513
59271446@N00,2924,15,1256988934,1256988934,1,3,0
59271446@N00,2924,22,1256984578,1256984578,1,3,0
59271446@N00,2924,29,1256985969,1256988557,32,3,2588
59271446@N00,2925,12,1258723654,1258723654,1,1,0
59271446@N00,2926,3,1262488065,1262493327,5,1,5262
59271446@N00,2927,12,1269043651,1269043651,1,1,0
59271446@N00,2928,12,1277189274,1277193431,6,1,4157
59271446@N00,2929,17,1277529363,1277530226,5,2,863
59271446@N00,2929,18,1277526669,1277526669,1,2,0
59271446@N00,2930,9,1279945990,1279946414,4,1,424
59271446@N00,2931,9,1280287202,1280288045,4,2,843
59271446@N00,2931,29,1280286832,1280286832,1,2,0
59271446@N00,2932,9,1281761015,1281766519,2,1,5504
59271446@N00,2933,29,1289621207,1289624001,4,1,2794
59271446@N00,2934,8,1291529540,1291529540,1,1,0
59271446@N00,2935,18,1293105740,1293105740,1,1,0
59271446@N00,2936,8,1294116338,1294116338,1,1,0
59271446@N00,2937,9,1300176400,1300176400,1,1,0
59271446@N00,2938,12,1325297868,1325297868,1,2,0
59271446@N00,2938,29,1325303000,1325303000,1,2,0
59299893@N00,2939,16,1362002711,1362002711,1,1,0
59353887@N00,2940,12,1280643719,1280646819,4,2,3100
59353887@N00,2940,14,1280631898,1280659939,3,2,28041
59353887@N00,2941,12,1281107726,1281107726,1,2,0
59353887@N00,2941,14,1281088115,1281088115,1,2,0
59446027@N00,2942,1,1238228825,1238238180,2,5,9355
59446027@N00,2942,9,1238230788,1238230788,1,5,0
59446027@N00,2942,11,1238231402,1238254029,2,5,22627
59446027@N00,2942,17,1238226186,1238226186,1,5,0
59446027@N00,2942,29,1238227130,1238229601,2,5,2471
59446027@N00,2943,20,1238311163,1238314222,2,1,3059
59562171@N00,2944,15,1124253050,1124253050,1,1,0
60006733@N05,2945,4,1298346106,1298346106,1,1,0
60006733@N05,2946,2,1298516352,1298516556,2,1,204
60006733@N05,2947,1,1317946528,1317956454,18,3,9926
60006733@N05,2947,9,1317957282,1317957282,1,3,0
60006733@N05,2947,18,1317942308,1317942409,2,3,101
60006733@N05,2948,1,1318567489,1318567489,1,2,0
60006733@N05,2948,2,1318550792,1318555929,11,2,5137
60006733@N05,2949,10,1320371802,1320371802,1,4,0
60006733@N05,2949,11,1320374463,1320374463,1,4,0
60006733@N05,2949,19,1320375541,1320375541,1,4,0
60006733@N05,2949,23,1320368787,1320375139,9,4,6352
60006733@N05,2950,8,1320469050,1320469529,2,5,479
60006733@N05,2950,10,1320455011,1320456130,3,5,1119
60006733@N05,2950,11,1320453037,1320455377,2,5,2340
60006733@N05,2950,16,1320469991,1320469991,1,5,0
60006733@N05,2950,23,1320449366,1320456412,2,5,7046
60006733@N05,2951,3,1322622997,1322623311,3,1,314
60006733@N05,2952,8,1322697699,1322697757,4,1,58
60006733@N05,2953,3,1331949705,1331951685,11,3,1980
60006733@N05,2953,8,1331950112,1331951449,3,3,1337
60006733@N05,2953,28,1331955526,1331956022,4,3,496
60006733@N05,2954,3,1332117746,1332120685,4,2,2939
60006733@N05,2954,27,1332139608,1332140609,9,2,1001
60006733@N05,2955,3,1334280283,1334296010,20,1,15727
60006733@N05,2956,3,1339981357,1339984739,11,1,3382
60006733@N05,2957,3,1340757890,1340765435,24,1,7545
60006733@N05,2958,3,1344471951,1344478103,35,2,6152
60006733@N05,2958,20,1344490758,1344493696,8,2,2938
60006733@N05,2959,3,1344644487,1344653067,5,1,8580
60006733@N05,2960,3,1345251730,1345257485,16,1,5755
60006733@N05,2961,29,1390118419,1390118419,1,1,0
60107315@N00,2962,3,1220081084,1220081084,1,3,0
60107315@N00,2962,4,1220070493,1220070493,1,3,0
60107315@N00,2962,9,1220075214,1220080114,3,3,4900
60107315@N00,2963,9,1250818109,1250831192,3,3,13083
60107315@N00,2963,15,1250825740,1250825740,1,3,0
60107315@N00,2963,18,1250826205,1250826205,1,3,0
60107315@N00,2964,10,1269647303,1269647303,1,2,0
60107315@N00,2964,29,1269654210,1269654210,1,2,0
60179301@N00,2965,3,1339816649,1339816762,4,2,113
60179301@N00,2965,19,1339818857,1339818857,1,2,0
60198748@N02,2966,1,1248226520,1248226520,1,1,0
60206297@N00,2967,9,1351286042,1351295434,3,3,9392
60206297@N00,2967,28,1351294503,1351294503,1,3,0
60206297@N00,2967,29,1351285163,1351285163,1,3,0
60206297@N00,2968,1,1351385712,1351385722,2,3,10
60206297@N00,2968,14,1351385245,1351385245,1,3,0
60206297@N00,2968,29,1351380423,1351380423,1,3,0
60206297@N00,2969,7,1351560172,1351560172,1,3,0
60206297@N00,2969,9,1351565141,1351565141,1,3,0
60206297@N00,2969,17,1351565113,1351565113,1,3,0
60206297@N00,2970,17,1351604377,1351604377,1,1,0
60444977@N00,2971,8,1165282420,1165301433,4,2,19013
60444977@N00,2971,9,1165284542,1165285622,3,2,1080
60444977@N00,2972,8,1165397657,1165398635,3,3,978
60444977@N00,2972,9,1165379929,1165379929,1,3,0
60444977@N00,2972,29,1165382034,1165385738,11,3,3704
60444977@N00,2973,29,1182149839,1182149839,1,1,0
60519007@N00,2974,19,1314407010,1314407010,1,1,0
60519007@N00,2975,3,1314500583,1314500583,1,1,0
60576086@N00,2976,8,1228532196,1228532210,2,1,14
60611127@N00,2977,15,1133854430,1133854430,1,1,0
60611127@N00,2978,1,1133911205,1133911205,1,6,0
60611127@N00,2978,3,1133922566,1133923992,5,6,1426
60611127@N00,2978,15,1133948729,1133948797,2,6,68
60611127@N00,2978,16,1133949001,1133949001,1,6,0
60611127@N00,2978,19,1133949661,1133949661,1,6,0
60611127@N00,2978,29,1133910693,1133949098,7,6,38405
60611127@N00,2979,2,1133998547,1134001112,9,6,2565
60611127@N00,2979,4,1133998063,1133998063,1,6,0
60611127@N00,2979,8,1134010442,1134032455,2,6,22013
60611127@N00,2979,9,1134002645,1134002745,2,6,100
60611127@N00,2979,15,1134028992,1134028992,1,6,0
60611127@N00,2979,29,1134007528,1134030169,10,6,22641
60611127@N00,2980,1,1197350418,1197353936,4,4,3518
60611127@N00,2980,8,1197350597,1197351025,3,4,428
60611127@N00,2980,9,1197351673,1197351842,4,4,169
60611127@N00,2980,29,1197350487,1197354587,9,4,4100
60611127@N00,2981,1,1197423925,1197430109,15,6,6184
60611127@N00,2981,8,1197437978,1197438166,2,6,188
60611127@N00,2981,9,1197431844,1197432334,4,6,490
60611127@N00,2981,11,1197411131,1197412375,13,6,1244
60611127@N00,2981,17,1197432299,1197432310,2,6,11
60611127@N00,2981,29,1197423111,1197455248,11,6,32137
60611127@N00,2982,29,1197519991,1197523087,4,1,3096
60611127@N00,2983,1,1216127894,1216127949,4,5,55
60611127@N00,2983,3,1216127780,1216127977,5,5,197
60611127@N00,2983,9,1216128339,1216128357,3,5,18
60611127@N00,2983,10,1216127829,1216127854,3,5,25
60611127@N00,2983,11,1216127870,1216127877,2,5,7
60664604@N04,2984,18,1309328318,1309329117,4,1,799
60664604@N04,2985,8,1309484100,1309484100,1,1,0
60912828@N00,2986,17,1175316169,1175316169,1,1,0
60956718@N00,2987,1,1275204656,1275204656,1,2,0
60956718@N00,2987,29,1275199969,1275204718,3,2,4749
60992208@N05,2988,1,1300143843,1300146489,3,1,2646
61005109@N06,2989,4,1315360647,1315361423,3,2,776
61005109@N06,2989,24,1315351830,1315351830,1,2,0
61005109@N06,2990,4,1315545056,1315545378,2,2,322
61005109@N06,2990,24,1315536730,1315542376,10,2,5646
61005109@N06,2991,24,1315952309,1315952309,1,1,0
61005109@N06,2992,21,1348445864,1348456396,4,1,10532
61274942@N02,2993,3,1282181862,1282181862,1,1,0
61283368@N00,2994,19,1376347989,1376354370,3,1,6381
61283368@N00,2995,19,1376438632,1376438632,1,1,0
61340363@N05,2996,22,1377405051,1377405051,1,1,0
61340363@N05,2997,28,1396861531,1396861531,1,1,0
61369090@N07,2998,9,1345264153,1345264306,2,3,153
61369090@N07,2998,17,1345265009,1345265031,2,3,22
61369090@N07,2998,19,1345266810,1345267228,2,3,418
61369090@N07,2999,9,1345385219,1345385219,1,1,0
61369090@N07,3000,17,1345537888,1345537888,1,1,0
61369090@N07,3001,9,1345889391,1345889391,1,1,0
61408065@N00,3002,12,1362811785,1362811785,1,1,0
61408065@N00,3003,18,1362962034,1362962034,1,1,0
61416618@N00,3004,20,1099527520,1099538469,3,1,10949
61416618@N00,3005,20,1114735362,1114735530,3,1,168
61416618@N00,3006,20,1119747898,1119747898,1,1,0
61474890@N08,3007,8,1347156378,1347156481,2,1,103
61488183@N06,3008,1,1300577371,1300580196,2,1,2825
61502879@N06,3009,21,1248923292,1248923292,1,1,0
61502879@N06,3010,21,1345101277,1345101277,1,1,0
61502879@N06,3011,28,1354269696,1354269696,1,1,0
61502879@N06,3012,28,1355019091,1355043922,5,1,24831
61502879@N06,3013,21,1360143648,1360143648,1,1,0
61502879@N06,3014,21,1362024078,1362029303,2,1,5225
61502879@N06,3015,21,1363825557,1363825557,1,1,0
61502879@N06,3016,21,1364444992,1364444992,1,1,0
61502879@N06,3017,21,1367424211,1367424211,1,1,0
61502879@N06,3018,21,1367884018,1367884018,1,1,0
61502879@N06,3019,15,1374135573,1374144482,21,1,8909
61547069@N00,3020,17,1229678670,1229678670,1,1,0
61560899@N06,3021,1,1335671703,1335671703,1,2,0
61560899@N06,3021,9,1335684036,1335684036,1,2,0
61590595@N04,3022,16,1386405474,1386406526,2,1,1052
61590595@N04,3023,8,1386589018,1386589018,1,1,0
61590595@N04,3024,3,1396360032,1396360032,1,1,0
61635869@N00,3025,1,1373250498,1373253774,9,6,3276
61635869@N00,3025,8,1373246376,1373263645,7,6,17269
61635869@N00,3025,9,1373263105,1373263105,1,6,0
61635869@N00,3025,16,1373246844,1373246844,1,6,0
61635869@N00,3025,19,1373245675,1373264696,6,6,19021
61635869@N00,3025,29,1373247408,1373263069,15,6,15661
61663261@N00,3026,9,1241311027,1241322098,4,1,11071
61663261@N00,3027,3,1251539362,1251564850,5,1,25488
61663261@N00,3028,8,1280438053,1280438159,5,1,106
61663261@N00,3029,14,1333254905,1333256283,4,1,1378
61663261@N00,3030,3,1342497986,1342497986,1,1,0
61663261@N00,3031,3,1343977971,1343977971,1,1,0
61663261@N00,3032,10,1354177580,1354177580,1,4,0
61663261@N00,3032,11,1354176919,1354176919,1,4,0
61663261@N00,3032,16,1354183939,1354183939,1,4,0
61663261@N00,3032,19,1354180477,1354180477,1,4,0
61663261@N00,3033,10,1394613719,1394613719,1,2,0
61663261@N00,3033,11,1394613032,1394613032,1,2,0
61663261@N00,3034,2,1398479935,1398482196,5,2,2261
61663261@N00,3034,24,1398480459,1398480942,4,2,483
61753503@N00,3035,19,1248827254,1248827254,1,1,0
61753503@N00,3036,24,1255810039,1255816718,3,1,6679
61765284@N00,3037,1,1298660255,1298660255,1,1,0
61897811@N00,3038,2,1193890404,1193890472,3,6,68
61897811@N00,3038,4,1193888116,1193890708,3,6,2592
61897811@N00,3038,8,1193883435,1193893240,3,6,9805
61897811@N00,3038,9,1193883817,1193886846,5,6,3029
61897811@N00,3038,13,1193882858,1193882858,1,6,0
61897811@N00,3038,29,1193883869,1193886034,5,6,2165
61955781@N00,3039,10,1339554585,1339554585,1,1,0
61955972@N00,3040,19,1362017377,1362017377,1,1,0
61955972@N00,3041,2,1382930031,1382930576,6,1,545
61963369@N00,3042,9,1283265869,1283265869,1,1,0
61966064@N00,3043,10,1148363474,1148363474,1,2,0
61966064@N00,3043,18,1148358271,1148358377,2,2,106
61966064@N00,3044,1,1148462481,1148462481,1,1,0
62122462@N00,3045,8,1211316160,1211316160,1,2,0
62122462@N00,3045,15,1211317179,1211317179,1,2,0
62136333@N02,3046,1,1008594000,1008594005,6,5,5
62136333@N02,3046,8,1008594006,1008594020,8,5,14
62136333@N02,3046,10,1008594009,1008594010,2,5,1
62136333@N02,3046,18,1008594015,1008594015,1,5,0
62136333@N02,3046,29,1008594014,1008594014,1,5,0
62136333@N02,3047,1,1008680421,1008680431,11,5,10
62136333@N02,3047,4,1008680413,1008680413,1,5,0
62136333@N02,3047,8,1008680400,1008680411,12,5,11
62136333@N02,3047,10,1008680412,1008680412,1,5,0
62136333@N02,3047,29,1008680414,1008680420,7,5,6
62136333@N02,3048,8,1008766803,1008766804,2,2,1
62136333@N02,3048,22,1008766801,1008766801,1,2,0
62136333@N02,3049,1,1036191824,1036222769,58,3,30945
62136333@N02,3049,8,1036191383,1036211583,45,3,20200
62136333@N02,3049,29,1036211599,1036213844,15,3,2245
62136333@N02,3050,8,1036300305,1036301799,23,1,1494
62136333@N02,3051,7,1146814454,1146820766,92,1,6312
62136333@N02,3052,15,1146910468,1146921607,18,1,11139
62136333@N02,3053,15,1146997563,1146998673,21,1,1110
62136333@N02,3054,15,1147029337,1147029337,1,1,0
62136333@N02,3055,1,1233030472,1233038529,64,2,8057
62136333@N02,3055,8,1233055328,1233055399,5,2,71
62136333@N02,3056,1,1322290676,1322291395,20,5,719
62136333@N02,3056,2,1322278168,1322281627,50,5,3459
62136333@N02,3056,4,1322281662,1322289267,12,5,7605
62136333@N02,3056,8,1322291596,1322292454,10,5,858
62136333@N02,3056,10,1322274349,1322296034,118,5,21685
62136333@N02,3057,3,1322371762,1322374461,46,6,2699
62136333@N02,3057,4,1322364274,1322375689,16,6,11415
62136333@N02,3057,8,1322365023,1322380964,38,6,15941
62136333@N02,3057,10,1322375884,1322375897,2,6,13
62136333@N02,3057,18,1322361952,1322362563,8,6,611
62136333@N02,3057,29,1322363127,1322363373,6,6,246
62277986@N00,3058,28,1219629646,1219634646,14,1,5000
62308216@N00,3059,1,1208311600,1208319489,19,3,7889
62308216@N00,3059,9,1208324546,1208324546,1,3,0
62308216@N00,3059,29,1208324044,1208329289,5,3,5245
62331291@N00,3060,9,1061268266,1061268266,1,1,0
62367143@N00,3061,19,1270335041,1270335041,1,1,0
62397999@N00,3062,29,1303807538,1303807570,2,1,32
62457680@N00,3063,18,1288148496,1288152169,2,1,3673
62579590@N00,3064,1,1273709817,1273709817,1,3,0
62579590@N00,3064,3,1273712136,1273712136,1,3,0
62579590@N00,3064,24,1273722585,1273722585,1,3,0
62606667@N04,3065,1,1208573480,1208585948,15,1,12468
62606667@N04,3066,1,1208655952,1208675066,15,1,19114
62620059@N08,3067,9,1284108608,1284108608,1,1,0
62620059@N08,3068,9,1284270701,1284270759,2,2,58
62620059@N08,3068,29,1284249344,1284249344,1,2,0
62697203@N00,3069,7,1301014553,1301014553,1,1,0
62744044@N00,3070,8,1285487891,1285487891,1,4,0
62744044@N00,3070,9,1285488048,1285488746,4,4,698
62744044@N00,3070,19,1285487544,1285490097,4,4,2553
62744044@N00,3070,29,1285488982,1285489081,2,4,99
62798459@N00,3071,19,1345874101,1345874101,1,1,0
62941576@N00,3072,9,1239634191,1239634191,1,1,0
63051795@N00,3073,19,1250758531,1250758531,1,1,0
63051795@N00,3074,8,1304488681,1304488681,1,1,0
63079834@N00,3075,15,1385377295,1385377295,1,2,0
63079834@N00,3075,18,1385376870,1385376870,1,2,0
63079834@N00,3076,1,1385423734,1385430650,12,3,6916
63079834@N00,3076,18,1385432482,1385432482,1,3,0
63079834@N00,3076,29,1385429634,1385429634,1,3,0
63079834@N00,3077,8,1385462791,1385462791,1,2,0
63079834@N00,3077,23,1385463406,1385463406,1,2,0
63079834@N00,3078,7,1385511377,1385511688,3,2,311
63079834@N00,3078,9,1385523392,1385523392,1,2,0
63079834@N00,3079,3,1385627106,1385627128,2,2,22
63079834@N00,3079,29,1385599228,1385603878,5,2,4650
63238112@N02,3080,12,1306751828,1306753288,2,4,1460
63238112@N02,3080,15,1306751799,1306751799,1,4,0
63238112@N02,3080,18,1306751755,1306753319,4,4,1564
63238112@N02,3080,19,1306751855,1306751865,2,4,10
63238112@N02,3081,9,1333524709,1333524709,1,1,0
63238112@N02,3082,9,1349599060,1349599060,1,2,0
63238112@N02,3082,16,1349600088,1349606845,2,2,6757
63238112@N02,3083,19,1363083062,1363083062,1,1,0
63238112@N02,3084,12,1365420514,1365420514,1,1,0
63238112@N02,3085,9,1366720981,1366720981,1,3,0
63238112@N02,3085,17,1366720452,1366720452,1,3,0
63238112@N02,3085,29,1366720079,1366720079,1,3,0
63238112@N02,3086,8,1366893420,1366893420,1,1,0
63238112@N02,3087,3,1367156830,1367157028,2,2,198
63238112@N02,3087,13,1367157842,1367157842,1,2,0
63238112@N02,3088,1,1367807500,1367807500,1,2,0
63238112@N02,3088,18,1367793544,1367793818,2,2,274
63238112@N02,3089,22,1368758910,1368759055,2,1,145
63238112@N02,3090,23,1378303867,1378303887,2,1,20
63252722@N00,3091,15,1336099469,1336099469,1,2,0
63252722@N00,3091,18,1336096453,1336096453,1,2,0
63252722@N00,3092,5,1336182992,1336182992,1,1,0
63406964@N00,3093,15,1152338382,1152338604,5,2,222
63406964@N00,3093,16,1152338072,1152338373,11,2,301
63425234@N05,3094,9,1296352478,1296352478,1,1,0
63458311@N00,3095,9,1218765858,1218765858,1,1,0
63458311@N00,3096,1,1218854494,1218860545,5,3,6051
63458311@N00,3096,9,1218852573,1218864646,5,3,12073
63458311@N00,3096,29,1218853767,1218853767,1,3,0
63463553@N07,3097,18,1340820269,1340820423,2,1,154
63487182@N00,3098,10,1164322913,1164322913,1,1,0
63679518@N00,3099,1,1304811635,1304811635,1,3,0
63679518@N00,3099,18,1304818973,1304819149,4,3,176
63679518@N00,3099,19,1304820614,1304820614,1,3,0
63679518@N00,3100,14,1304916225,1304917738,6,1,1513
63679518@N00,3101,14,1305001520,1305001553,2,1,33
63679518@N00,3102,16,1305062278,1305062278,1,1,0
63731168@N07,3103,15,1319692337,1319692337,1,1,0
63731168@N07,3104,29,1319855941,1319855941,1,1,0
63775621@N00,3105,9,1111268855,1111269360,2,2,505
63775621@N00,3105,29,1111269897,1111269897,1,2,0
63845798@N04,3106,15,1381121767,1381121767,1,1,0
63974928@N00,3107,18,1369792681,1369792681,1,1,0
63999590@N00,3108,9,1203731235,1203731235,1,2,0
63999590@N00,3108,29,1203707205,1203723160,6,2,15955
63999590@N00,3109,22,1203901260,1203901260,1,1,0
63999590@N00,3110,29,1241322110,1241322110,1,1,0
63999590@N00,3111,9,1241483514,1241483514,1,2,0
63999590@N00,3111,16,1241461387,1241461387,1,2,0
63999590@N00,3112,18,1241565273,1241565273,1,2,0
63999590@N00,3112,22,1241563830,1241563830,1,2,0
64119933@N00,3113,4,1333605395,1333605395,1,5,0
64119933@N00,3113,10,1333598231,1333598551,3,5,320
64119933@N00,3113,11,1333597871,1333597871,1,5,0
64119933@N00,3113,15,1333599561,1333599888,2,5,327
64119933@N00,3113,18,1333612483,1333612656,3,5,173
64247734@N00,3114,29,1373004070,1373004070,1,1,0
64332066@N00,3115,1,1066903407,1066918369,3,8,14962
64332066@N00,3115,2,1066923189,1066923189,1,8,0
64332066@N00,3115,3,1066918074,1066918074,1,8,0
64332066@N00,3115,9,1066918554,1066918554,1,8,0
64332066@N00,3115,11,1066923178,1066923178,1,8,0
64332066@N00,3115,17,1066922595,1066922595,1,8,0
64332066@N00,3115,19,1066924324,1066924324,1,8,0
64332066@N00,3115,29,1066906737,1066906737,1,8,0
64332066@N00,3116,15,1255066470,1255066470,1,1,0
64356017@N07,3117,29,1312248866,1312248866,1,1,0
64356017@N07,3118,10,1312336744,1312336744,1,2,0
64356017@N07,3118,23,1312338105,1312338105,1,2,0
64381378@N00,3119,12,1277285389,1277285389,1,1,0
64636204@N00,3120,16,1376816770,1376816770,1,2,0
64636204@N00,3120,17,1376821209,1376821209,1,2,0
64636204@N00,3121,17,1377012451,1377019176,3,1,6725
64876844@N00,3122,9,1186714139,1186731282,5,4,17143
64876844@N00,3122,11,1186710340,1186710340,1,4,0
64876844@N00,3122,17,1186732680,1186732680,1,4,0
64876844@N00,3122,29,1186717447,1186717447,1,4,0
65016744@N06,3123,20,1349013600,1349013600,3,1,0
65016744@N06,3124,8,1359872674,1359873120,4,1,446
65016744@N06,3125,16,1361343507,1361344823,2,1,1316
65072601@N00,3126,4,1113800892,1113800892,1,1,0
65072601@N00,3127,10,1113888425,1113888432,2,1,7
65072601@N00,3128,17,1301276886,1301276886,1,2,0
65072601@N00,3128,19,1301270980,1301270980,1,2,0
65112820@N00,3129,29,1240885253,1240885598,4,1,345
65173084@N00,3130,1,1204782599,1204784626,30,1,2027
65244239@N00,3131,1,1335490912,1335494697,4,1,3785
65251493@N03,3132,1,1286416249,1286416249,1,1,0
65251493@N03,3133,1,1314172847,1314172854,2,2,7
65251493@N03,3133,18,1314172860,1314172860,1,2,0
65296156@N02,3134,12,1338173519,1338173519,1,1,0
65326158@N00,3135,1,1210653950,1210654778,6,4,828
65326158@N00,3135,2,1210663951,1210663951,2,4,0
65326158@N00,3135,9,1210655829,1210656372,4,4,543
65326158@N00,3135,29,1210655396,1210655682,4,4,286
65393953@N03,3136,3,1346630633,1346636593,4,4,5960
65393953@N03,3136,9,1346629791,1346643650,7,4,13859
65393953@N03,3136,16,1346648669,1346648669,1,4,0
65393953@N03,3136,17,1346643950,1346644123,3,4,173
65632261@N00,3137,9,1145594563,1145598367,3,2,3804
65632261@N00,3137,29,1145598597,1145605418,8,2,6821
65958138@N00,3138,1,1350098287,1350098287,1,4,0
65958138@N00,3138,9,1350099606,1350099941,3,4,335
65958138@N00,3138,15,1350106098,1350106098,1,4,0
65958138@N00,3138,29,1350098616,1350099165,4,4,549
66139643@N00,3139,8,1150107027,1150107105,2,2,78
66139643@N00,3139,18,1150112280,1150112280,1,2,0
66227636@N04,3140,8,1351478244,1351498539,4,3,20295
66227636@N04,3140,9,1351475034,1351476457,6,3,1423
66227636@N04,3140,29,1351475255,1351477466,3,3,2211
66321334@N00,3141,11,1291506550,1291506561,2,2,11
66321334@N00,3141,23,1291505877,1291505877,1,2,0
66397367@N05,3142,19,1336470748,1336470748,1,2,0
66397367@N05,3142,29,1336463628,1336463628,1,2,0
66397367@N05,3143,4,1336528840,1336528840,1,2,0
66397367@N05,3143,11,1336517448,1336517448,1,2,0
66397367@N05,3144,18,1342090231,1342090231,1,1,0
66434265@N00,3145,1,1231815353,1231823363,7,6,8010
66434265@N00,3145,4,1231797259,1231797259,1,6,0
66434265@N00,3145,10,1231793473,1231793925,4,6,452
66434265@N00,3145,11,1231793473,1231794274,4,6,801
66434265@N00,3145,17,1231805280,1231805280,1,6,0
66434265@N00,3145,29,1231802479,1231814356,12,6,11877
66434265@N00,3146,7,1231896210,1231898811,8,4,2601
66434265@N00,3146,12,1231925199,1231930544,4,4,5345
66434265@N00,3146,17,1231906361,1231906361,1,4,0
66434265@N00,3146,24,1231891853,1231892107,2,4,254
66434265@N00,3147,3,1232068586,1232070185,3,3,1599
66434265@N00,3147,9,1232080244,1232080244,1,3,0
66434265@N00,3147,17,1232077718,1232078565,4,3,847
66434265@N00,3148,1,1232764134,1232764134,1,1,0
66434265@N00,3149,16,1316998796,1316998796,1,1,0
66434265@N00,3150,17,1317040475,1317040475,1,1,0
66434265@N00,3151,28,1317124218,1317124218,1,1,0
66579708@N00,3152,9,1165981278,1165981364,4,1,86
66783178@N07,3153,9,1310973286,1310973286,1,1,0
66913692@N00,3154,1,1306181972,1306189343,26,3,7371
66913692@N00,3154,8,1306178332,1306179267,3,3,935
66913692@N00,3154,13,1306175769,1306175796,2,3,27
66913692@N00,3155,8,1306267716,1306267716,1,4,0
66913692@N00,3155,9,1306262477,1306266331,12,4,3854
66913692@N00,3155,23,1306289957,1306290549,7,4,592
66913692@N00,3155,29,1306266974,1306266974,1,4,0
66913692@N00,3156,8,1306360429,1306360640,4,2,211
66913692@N00,3156,16,1306355631,1306355631,1,2,0
66994036@N00,3157,17,1219573783,1219573850,3,1,67
67008765@N00,3158,3,1158241777,1158246726,64,1,4949
67008765@N00,3159,17,1158927361,1158931188,22,1,3827
67008765@N00,3160,28,1162301177,1162301240,3,1,63
67008765@N00,3161,19,1164818380,1164818822,33,2,442
67008765@N00,3161,23,1164817635,1164817889,17,2,254
67008765@N00,3162,3,1166269638,1166269638,1,1,0
67008765@N00,3163,14,1166350896,1166364739,15,1,13843
67008765@N00,3164,2,1169615820,1169615966,5,1,146
67008765@N00,3165,12,1169989828,1169990034,4,1,206
67008765@N00,3166,3,1172653763,1172668379,85,1,14616
67008765@N00,3167,3,1174267335,1174274561,7,1,7226
67008765@N00,3168,3,1174403172,1174406772,71,1,3600
67008765@N00,3169,14,1176280642,1176298308,63,1,17666
67008765@N00,3170,22,1179489937,1179499808,58,1,9871
67008765@N00,3171,3,1183693160,1183693416,13,2,256
67008765@N00,3171,13,1183680967,1183688061,123,2,7094
67008765@N00,3172,12,1191931965,1191943269,58,2,11304
67008765@N00,3172,19,1191951441,1191951849,18,2,408
67008765@N00,3173,4,1216791039,1216791704,4,1,665
67008765@N00,3174,4,1217216106,1217216624,25,1,518
67008765@N00,3175,15,1217737159,1217743443,241,1,6284
67008765@N00,3176,29,1220180043,1220183784,18,1,3741
67008765@N00,3177,11,1241089199,1241101161,199,1,11962
67008765@N00,3178,20,1241402672,1241411305,97,1,8633
67008765@N00,3179,3,1244348516,1244349285,8,1,769
67008765@N00,3180,9,1249094085,1249094344,40,3,259
67008765@N00,3180,17,1249094504,1249094596,15,3,92
67008765@N00,3180,29,1249094605,1249094751,24,3,146
67008765@N00,3181,2,1249796251,1249796259,4,3,8
67008765@N00,3181,4,1249796387,1249796398,4,3,11
67008765@N00,3181,24,1249796356,1249796356,1,3,0
67008765@N00,3182,29,1249985586,1249993977,63,1,8391
67008765@N00,3183,1,1259379365,1259386961,84,7,7596
67008765@N00,3183,8,1259389737,1259397631,67,7,7894
67008765@N00,3183,9,1259387261,1259388660,96,7,1399
67008765@N00,3183,15,1259390994,1259391488,5,7,494
67008765@N00,3183,16,1259391041,1259391384,6,7,343
67008765@N00,3183,19,1259388993,1259389160,4,7,167
67008765@N00,3183,29,1259387052,1259387077,3,7,25
67008765@N00,3184,10,1262266973,1262268618,58,2,1645
67008765@N00,3184,23,1262268632,1262269416,9,2,784
67008765@N00,3185,10,1272626407,1272636398,135,2,9991
67008765@N00,3185,11,1272627305,1272634064,128,2,6759
67008765@N00,3186,18,1291434558,1291434558,1,1,0
67008765@N00,3187,10,1304164765,1304172038,2,1,7273
67008765@N00,3188,11,1356958924,1356958924,1,1,0
67105344@N02,3189,14,1326433321,1326433321,1,1,0
67247290@N00,3190,1,1377057684,1377057684,1,2,0
67247290@N00,3190,10,1377084214,1377084214,1,2,0
67247290@N00,3191,29,1377155338,1377155338,1,1,0
67258954@N00,3192,18,1293250014,1293250325,2,1,311
67258954@N00,3193,12,1351682704,1351683504,2,1,800
67258954@N00,3194,12,1352371411,1352371602,3,1,191
67265930@N00,3195,29,1198137512,1198137512,1,1,0
67265930@N00,3196,18,1198230996,1198230996,1,1,0
67265930@N00,3197,3,1250938639,1250938639,1,1,0
67289016@N00,3198,29,1176608241,1176608333,3,1,92
67433276@N05,3199,3,1335929848,1335929848,1,3,0
67433276@N05,3199,16,1335942587,1335942587,1,3,0
67433276@N05,3199,29,1335930183,1335930183,1,3,0
67566398@N00,3200,9,1184493934,1184493934,1,1,0
67592622@N00,3201,9,1330746520,1330746520,1,1,0
67592622@N00,3202,8,1330820375,1330820375,1,1,0
67592622@N00,3203,8,1376183134,1376183134,1,1,0
67596800@N00,3204,8,1130220528,1130220543,2,1,15
67596800@N00,3205,20,1145423904,1145424270,2,1,366
67596800@N00,3206,20,1146020944,1146020944,1,1,0
67596800@N00,3207,29,1148392224,1148400313,29,1,8089
67596800@N00,3208,21,1152161268,1152161268,1,1,0
67596800@N00,3209,17,1168610091,1168612015,10,1,1924
67596800@N00,3210,29,1176284868,1176284910,2,1,42
67605675@N00,3211,13,1316471112,1316471112,1,2,0
67605675@N00,3211,29,1316488919,1316488919,1,2,0
67839654@N00,3212,1,1201487717,1201487717,1,1,0
67975030@N00,3213,28,1306913540,1306913540,1,1,0
67975030@N00,3214,1,1306976488,1306997417,4,13,20929
67975030@N00,3214,4,1307000319,1307003315,6,13,2996
67975030@N00,3214,8,1306993511,1306995084,9,13,1573
67975030@N00,3214,9,1306978436,1306978436,1,13,0
67975030@N00,3214,10,1306985065,1306985326,4,13,261
67975030@N00,3214,11,1306985435,1306986290,14,13,855
67975030@N00,3214,15,1306994316,1306995572,2,13,1256
67975030@N00,3214,16,1306993722,1306994108,6,13,386
67975030@N00,3214,18,1306996173,1306996982,5,13,809
67975030@N00,3214,19,1306978691,1306978751,2,13,60
67975030@N00,3214,23,1306984250,1306984769,6,13,519
67975030@N00,3214,24,1307001387,1307002012,3,13,625
67975030@N00,3214,29,1306977191,1306977991,3,13,800
67975030@N00,3215,29,1318641546,1318644270,15,1,2724
68121184@N00,3216,9,1263878482,1263878496,2,3,14
68121184@N00,3216,16,1263878509,1263878509,1,3,0
68121184@N00,3216,29,1263878489,1263878489,1,3,0
68121184@N00,3217,7,1327820487,1327820487,1,2,0
68121184@N00,3217,10,1327804933,1327804933,1,2,0
68151423@N00,3218,3,1024584238,1024585752,6,1,1514
68151423@N00,3219,3,1024673758,1024673758,1,2,0
68151423@N00,3219,17,1024682897,1024682897,1,2,0
68151423@N00,3220,3,1024739014,1024751594,3,1,12580
68179203@N03,3221,18,1355839401,1355839401,1,1,0
68382618@N00,3222,19,1367223190,1367228557,3,2,5367
68382618@N00,3222,29,1367227403,1367227403,1,2,0
68493542@N00,3223,22,1183106733,1183106733,1,1,0
68493542@N00,3224,24,1185773675,1185773686,4,1,11
68493542@N00,3225,8,1247625256,1247647496,6,5,22240
68493542@N00,3225,9,1247627238,1247627238,1,5,0
68493542@N00,3225,15,1247625392,1247625392,1,5,0
68493542@N00,3225,19,1247631954,1247648139,2,5,16185
68493542@N00,3225,21,1247634448,1247643886,13,5,9438
68493542@N00,3226,19,1253612392,1253613339,3,1,947
68493542@N00,3227,3,1350635703,1350635703,1,2,0
68493542@N00,3227,13,1350602203,1350617596,3,2,15393
68493542@N00,3228,13,1350693642,1350719188,5,1,25546
68493542@N00,3229,19,1381383007,1381383019,2,1,12
68688301@N00,3230,4,1184563195,1184563195,1,1,0
68688301@N00,3231,4,1184641136,1184655800,3,1,14664
68688301@N00,3232,19,1198186152,1198186152,1,1,0
68838281@N00,3233,8,1239232854,1239232854,1,3,0
68838281@N00,3233,16,1239235410,1239235502,3,3,92
68838281@N00,3233,29,1239236087,1239236351,2,3,264
68838281@N00,3234,10,1239415802,1239416329,2,2,527
68838281@N00,3234,11,1239416350,1239416350,1,2,0
68944617@N00,3235,17,1212809715,1212809715,1,1,0
68944617@N00,3236,3,1222486345,1222486345,1,1,0
69135870@N00,3237,23,1314352651,1314353613,2,1,962
69135870@N00,3238,9,1314408100,1314408100,1,2,0
69135870@N00,3238,29,1314408368,1314409544,13,2,1176
69170071@N05,3239,10,1376821454,1376821454,1,2,0
69170071@N05,3239,11,1376821875,1376821875,1,2,0
69179864@N00,3240,22,1374997832,1374997832,1,1,0
69218326@N06,3241,29,1198341293,1198362190,2,1,20897
69223375@N00,3242,9,1219464552,1219464552,1,2,0
69223375@N00,3242,29,1219464758,1219464758,1,2,0
69252813@N00,3243,17,1274952744,1274963031,9,1,10287
69252813@N00,3244,1,1275009783,1275010109,2,2,326
69252813@N00,3244,17,1275016624,1275016632,3,2,8
69349066@N00,3245,15,1180846598,1180846598,1,3,0
69349066@N00,3245,18,1180844754,1180846172,4,3,1418
69349066@N00,3245,29,1180844625,1180844625,1,3,0
69455149@N00,3246,11,1338710223,1338711788,3,2,1565
69455149@N00,3246,23,1338712983,1338712983,1,2,0
69455149@N00,3247,1,1338785904,1338785904,1,1,0
69519247@N00,3248,6,1217739994,1217739994,1,1,0
69656176@N05,3249,1,1369284392,1369284588,2,1,196
69745998@N00,3250,15,1343177609,1343177609,1,1,0
69843317@N00,3251,14,1311154790,1311154790,1,1,0
69843317@N00,3252,8,1311319061,1311319061,1,1,0
69843317@N00,3253,22,1311417946,1311417946,1,1,0
69845378@N00,3254,15,1177953654,1177953812,2,2,158
69845378@N00,3254,19,1177955157,1177955201,3,2,44
69845378@N00,3255,19,1178437938,1178437952,7,1,14
70021771@N00,3256,11,1286779675,1286781639,2,2,1964
70021771@N00,3256,18,1286768304,1286768304,1,2,0
70384696@N00,3257,1,1319857561,1319857964,3,3,403
70384696@N00,3257,3,1319861286,1319861286,1,3,0
70384696@N00,3257,29,1319857253,1319860664,9,3,3411
70527236@N00,3258,20,1318637084,1318637084,1,1,0
70527236@N00,3259,20,1322094927,1322094927,1,1,0
70527236@N00,3260,20,1325729383,1325729383,1,1,0
70527236@N00,3261,20,1326681597,1326681597,1,1,0
70527236@N00,3262,20,1332205132,1332205334,2,1,202
70527236@N00,3263,18,1357175429,1357175429,1,1,0
70527236@N00,3264,18,1358550306,1358550306,1,1,0
70527236@N00,3265,1,1359763377,1359763377,1,2,0
70527236@N00,3265,18,1359763330,1359763330,1,2,0
70544918@N00,3266,3,1298523499,1298523499,1,2,0
70544918@N00,3266,4,1298511518,1298511664,2,2,146
70544918@N00,3267,8,1303714886,1303714886,1,2,0
70544918@N00,3267,19,1303704604,1303704604,1,2,0
70544918@N00,3268,19,1304588975,1304588975,1,1,0
70544918@N00,3269,3,1340278022,1340278085,5,2,63
70544918@N00,3269,16,1340278099,1340278099,1,2,0
70641280@N00,3270,15,1330932435,1330932435,1,1,0
70641280@N00,3271,3,1336801981,1336810439,2,2,8458
70641280@N00,3271,16,1336797408,1336797408,1,2,0
70641280@N00,3272,27,1354334186,1354334186,1,1,0
70641280@N00,3273,19,1366418925,1366418925,1,1,0
70641280@N00,3274,19,1366533799,1366533799,1,1,0
70641280@N00,3275,3,1389861550,1389861550,1,2,0
70641280@N00,3275,12,1389839856,1389839903,2,2,47
70938076@N00,3276,1,1249731383,1249737191,18,1,5808
70938076@N00,3277,8,1260691021,1260692282,2,1,1261
70938076@N00,3278,4,1272763364,1272763364,1,2,0
70938076@N00,3278,24,1272763577,1272763577,1,2,0
70938076@N00,3279,4,1272870405,1272870439,3,1,34
70938076@N00,3280,12,1292046755,1292047031,4,1,276
70938076@N00,3281,19,1301137089,1301137349,2,1,260
70938076@N00,3282,3,1322974699,1322980522,9,3,5823
70938076@N00,3282,8,1322987685,1322987685,1,3,0
70938076@N00,3282,13,1322981075,1322981075,1,3,0
70938076@N00,3283,3,1334376256,1334377329,2,2,1073
70938076@N00,3283,9,1334379154,1334379154,1,2,0
70938076@N00,3284,2,1348286565,1348290740,6,3,4175
70938076@N00,3284,4,1348292290,1348292290,1,3,0
70938076@N00,3284,23,1348293434,1348293871,5,3,437
70938076@N00,3285,10,1383010366,1383010366,1,3,0
70938076@N00,3285,11,1383009764,1383010649,8,3,885
70938076@N00,3285,23,1383010818,1383010827,2,3,9
71057941@N00,3286,8,1134628568,1134628568,1,1,0
71057941@N00,3287,18,1134795425,1134795425,1,1,0
71057941@N00,3288,8,1148017178,1148017545,5,3,367
71057941@N00,3288,15,1148017964,1148018081,2,3,117
71057941@N00,3288,17,1148019346,1148019520,2,3,174
71057941@N00,3289,19,1155778469,1155778469,1,1,0
71057941@N00,3290,8,1155862473,1155862473,1,1,0
71057941@N00,3291,18,1156311131,1156311281,2,1,150
71057941@N00,3292,9,1157125603,1157134124,2,1,8521
71057941@N00,3293,8,1164351195,1164352505,8,1,1310
71057941@N00,3294,8,1165600609,1165604709,8,2,4100
71057941@N00,3294,9,1165598972,1165598972,1,2,0
71057941@N00,3295,18,1166321092,1166349812,5,1,28720
71057941@N00,3296,3,1167573917,1167577676,4,2,3759
71057941@N00,3296,9,1167570011,1167570077,2,2,66
71057941@N00,3297,8,1186209616,1186209616,1,2,0
71057941@N00,3297,18,1186194984,1186208425,9,2,13441
71057941@N00,3298,22,1191124410,1191125745,2,1,1335
71057941@N00,3299,8,1197085100,1197086784,4,1,1684
71057941@N00,3300,8,1197437872,1197438405,3,1,533
71088526@N00,3301,2,1267659534,1267659534,1,8,0
71088526@N00,3301,7,1267661062,1267661821,7,8,759
71088526@N00,3301,8,1267669860,1267670070,2,8,210
71088526@N00,3301,9,1267677110,1267677283,2,8,173
71088526@N00,3301,15,1267676498,1267676498,1,8,0
71088526@N00,3301,16,1267672452,1267672452,1,8,0
71088526@N00,3301,18,1267654080,1267672902,2,8,18822
71088526@N00,3301,19,1267670062,1267670062,1,8,0
71088526@N00,3302,1,1267750213,1267753500,4,3,3287
71088526@N00,3302,8,1267762123,1267763699,4,3,1576
71088526@N00,3302,29,1267750206,1267754424,3,3,4218
71088526@N00,3303,3,1267837419,1267837540,3,4,121
71088526@N00,3303,15,1267838909,1267838909,1,4,0
71088526@N00,3303,16,1267838443,1267838892,3,4,449
71088526@N00,3303,29,1267838012,1267838012,1,4,0
71138480@N00,3304,1,1199084862,1199084862,1,1,0
71138480@N00,3305,19,1342237320,1342237320,1,1,0
71324729@N07,3306,28,1029538439,1029538439,1,1,0
71324729@N07,3307,1,1282165512,1282165512,1,1,0
71401076@N00,3308,1,1340617154,1340617154,1,5,0
71401076@N00,3308,12,1340589266,1340589266,1,5,0
71401076@N00,3308,14,1340589210,1340589210,1,5,0
71401076@N00,3308,16,1340589613,1340589613,1,5,0
71401076@N00,3308,18,1340589529,1340589529,1,5,0
71401076@N00,3309,12,1340654095,1340654095,1,2,0
71401076@N00,3309,14,1340654144,1340654144,1,2,0
71401076@N00,3310,14,1340919088,1340919088,1,1,0
71401076@N00,3311,8,1370801365,1370801517,2,2,152
71401076@N00,3311,12,1370827220,1370828737,2,2,1517
71401076@N00,3312,14,1370894774,1370894774,1,1,0
71428177@N00,3313,7,1191043141,1191044053,3,2,912
71428177@N00,3313,24,1191046959,1191046959,1,2,0
71428177@N00,3314,21,1390822007,1390822007,1,1,0
71445279@N00,3315,18,1262480319,1262480319,1,1,0
71445279@N00,3316,14,1262575194,1262575194,1,1,0
71445279@N00,3317,18,1263615381,1263615381,1,1,0
71445279@N00,3318,15,1264216733,1264216733,1,2,0
71445279@N00,3318,19,1264217256,1264217256,1,2,0
71445279@N00,3319,14,1264311626,1264311626,1,1,0
71445279@N00,3320,18,1265428444,1265428444,1,1,0
71445279@N00,3321,14,1265784647,1265784647,1,1,0
71445279@N00,3322,19,1266030181,1266030181,1,1,0
71445279@N00,3323,3,1266632876,1266633207,5,8,331
71445279@N00,3323,9,1266632695,1266632695,1,8,0
71445279@N00,3323,13,1266633568,1266633679,4,8,111
71445279@N00,3323,15,1266631528,1266632120,10,8,592
71445279@N00,3323,16,1266632223,1266632223,1,8,0
71445279@N00,3323,18,1266631376,1266631400,3,8,24
71445279@N00,3323,28,1266633301,1266633372,4,8,71
71445279@N00,3323,29,1266632327,1266632327,1,8,0
7150832@N06,3324,2,1379579667,1379579667,1,3,0
7150832@N06,3324,10,1379573749,1379573749,1,3,0
7150832@N06,3324,11,1379571480,1379572470,3,3,990
7150832@N06,3325,3,1379662830,1379663123,2,1,293
71651012@N00,3326,15,1122802080,1122802080,1,1,0
71654172@N00,3327,9,1295332135,1295332135,1,1,0
71654172@N00,3328,3,1299030237,1299038038,31,2,7801
71654172@N00,3328,9,1299039889,1299040293,9,2,404
71668585@N00,3329,1,1239332757,1239334801,3,3,2044
71668585@N00,3329,9,1239334838,1239334838,1,3,0
71668585@N00,3329,29,1239334270,1239334567,4,3,297
71668585@N00,3330,1,1239437240,1239437240,1,2,0
71668585@N00,3330,29,1239437662,1239437662,1,2,0
71668585@N00,3331,29,1269552744,1269552893,2,1,149
71668585@N00,3332,15,1269639171,1269639171,1,3,0
71668585@N00,3332,16,1269638518,1269638518,1,3,0
71668585@N00,3332,18,1269639681,1269639681,1,3,0
71668585@N00,3333,20,1269790622,1269829063,70,1,38441
71668585@N00,3334,20,1270140705,1270142059,5,1,1354
71668585@N00,3335,19,1301702190,1301702524,6,3,334
71668585@N00,3335,20,1301654392,1301686190,17,3,31798
71668585@N00,3335,22,1301698560,1301698664,3,3,104
71668585@N00,3336,10,1301767620,1301771886,14,2,4266
71668585@N00,3336,22,1301778454,1301778454,1,2,0
71668585@N00,3337,4,1301850568,1301850568,1,1,0
71668585@N00,3338,3,1302039880,1302040828,6,2,948
71668585@N00,3338,8,1302043342,1302043342,1,2,0
71668585@N00,3339,22,1302219694,1302219694,1,1,0
71668585@N00,3340,8,1334609007,1334609007,1,3,0
71668585@N00,3340,19,1334600527,1334600527,1,3,0
71668585@N00,3340,24,1334598416,1334598416,1,3,0
71668585@N00,3341,20,1334686250,1334690214,31,1,3964
71745485@N00,3342,15,1243778400,1243778400,1,1,0
71779430@N08,3343,11,1352107959,1352110778,16,2,2819
71779430@N08,3343,19,1352111267,1352111267,1,2,0
71812696@N00,3344,8,1125231416,1125231416,1,3,0
71812696@N00,3344,13,1125220797,1125220797,1,3,0
71812696@N00,3344,19,1125231565,1125231565,1,3,0
71812696@N00,3345,14,1132303990,1132303990,1,1,0
71812696@N00,3346,19,1133226337,1133226337,1,1,0
71812696@N00,3347,18,1133492710,1133492710,1,1,0
71812696@N00,3348,8,1133838918,1133838942,3,2,24
71812696@N00,3348,19,1133838888,1133838888,1,2,0
71812696@N00,3349,19,1137564260,1137564430,3,1,170
71812696@N00,3350,19,1138001255,1138001505,5,1,250
71812696@N00,3351,23,1141278182,1141278182,1,1,0
71812696@N00,3352,8,1141342852,1141342852,1,2,0
71812696@N00,3352,19,1141342441,1141342441,1,2,0
71812696@N00,3353,8,1147917929,1147918325,3,2,396
71812696@N00,3353,19,1147922504,1147922504,1,2,0
71812696@N00,3354,13,1156903610,1156903610,1,2,0
71812696@N00,3354,19,1156904620,1156906417,2,2,1797
71812696@N00,3355,18,1172636689,1172636689,1,1,0
71812696@N00,3356,3,1173223233,1173223233,1,1,0
71812696@N00,3357,19,1186296426,1186296426,1,1,0
71812696@N00,3358,15,1189654705,1189654705,1,1,0
71812696@N00,3359,29,1205578067,1205578067,1,1,0
71812696@N00,3360,15,1211166867,1211166946,3,1,79
7183730@N06,3361,1,1153938167,1153965883,7,1,27716
7183730@N06,3362,1,1154023978,1154043527,6,1,19549
7183730@N06,3363,1,1154104996,1154116610,6,1,11614
71909564@N00,3364,10,1155165505,1155165664,3,3,159
71909564@N00,3364,11,1155165315,1155165488,3,3,173
71909564@N00,3364,29,1155157924,1155157968,2,3,44
71998171@N00,3365,11,1239418347,1239418347,1,1,0
7206146@N04,3366,1,1268368331,1268385090,21,1,16759
7206146@N04,3367,1,1268446572,1268467330,34,1,20758
7206146@N04,3368,1,1268534088,1268551260,10,1,17172
7211295@N04,3369,28,1315232810,1315232810,1,1,0
72429059@N00,3370,19,1167528522,1167528522,1,1,0
72429059@N00,3371,4,1190095223,1190095223,1,3,0
72429059@N00,3371,9,1190093734,1190093734,1,3,0
72429059@N00,3371,29,1190080117,1190080934,3,3,817
72429059@N00,3372,3,1250653015,1250664929,6,4,11914
72429059@N00,3372,9,1250652425,1250652790,7,4,365
72429059@N00,3372,15,1250668652,1250674415,3,4,5763
72429059@N00,3372,17,1250652904,1250652904,1,4,0
7254381@N08,3373,9,1293161054,1293161054,1,1,0
7277182@N04,3374,4,1300409944,1300409944,1,1,0
7277590@N02,3375,8,1333933530,1333958769,2,1,25239
72823411@N00,3376,19,1181290785,1181290785,1,1,0
72987657@N00,3377,16,1338701999,1338701999,1,2,0
72987657@N00,3377,24,1338704461,1338705391,2,2,930
73014677@N05,3378,12,1317376978,1317376978,1,1,0
73014677@N05,3379,9,1328285927,1328285927,1,2,0
73014677@N05,3379,29,1328287853,1328287853,1,2,0
73014677@N05,3380,29,1342789726,1342789726,1,1,0
73014677@N05,3381,1,1357962711,1357962711,1,4,0
73014677@N05,3381,3,1357961699,1357961699,1,4,0
73014677@N05,3381,4,1357964966,1357964966,1,4,0
73014677@N05,3381,15,1357968973,1357968973,1,4,0
73014677@N05,3382,18,1357998246,1357998246,1,1,0
73014677@N05,3383,9,1358054903,1358054903,1,2,0
73014677@N05,3383,29,1358056214,1358056214,1,2,0
73014677@N05,3384,12,1358099754,1358099754,1,1,0
73014677@N05,3385,15,1362973170,1362973707,2,2,537
73014677@N05,3385,18,1362973048,1362973048,1,2,0
7310714@N06,3386,19,1369481636,1369481638,3,1,2
7310714@N06,3387,7,1369532598,1369533069,2,2,471
7310714@N06,3387,13,1369559089,1369559098,3,2,9
7310714@N06,3388,4,1369625065,1369627627,11,4,2562
7310714@N06,3388,9,1369620437,1369621809,9,4,1372
7310714@N06,3388,17,1369611691,1369620242,10,4,8551
7310714@N06,3388,29,1369622122,1369622128,2,4,6
7310714@N06,3389,8,1369702891,1369703744,2,3,853
7310714@N06,3389,9,1369701640,1369701640,1,3,0
7310714@N06,3389,28,1369701845,1369702001,3,3,156
73115625@N00,3390,15,1148359450,1148362405,3,1,2955
73115625@N00,3391,19,1212731890,1212731890,1,2,0
73115625@N00,3391,28,1212729665,1212729665,1,2,0
73115625@N00,3392,8,1351329525,1351329525,1,1,0
73115625@N00,3393,9,1363920540,1363920540,1,1,0
73124528@N00,3394,1,1307653520,1307657875,8,3,4355
73124528@N00,3394,2,1307663453,1307663453,1,3,0
73124528@N00,3394,4,1307660488,1307660488,1,3,0
73124528@N00,3395,1,1307831052,1307831052,1,1,0
73135567@N00,3396,18,1215993646,1215993646,1,1,0
7313591@N02,3397,1,1334375024,1334375024,1,1,0
73165003@N00,3398,9,1239145561,1239145561,1,1,0
73173768@N00,3399,1,1322365058,1322372035,30,5,6977
73173768@N00,3399,14,1322366549,1322366549,1,5,0
73173768@N00,3399,15,1322373669,1322373761,3,5,92
73173768@N00,3399,16,1322369870,1322370004,3,5,134
73173768@N00,3399,29,1322364762,1322372367,5,5,7605
73291330@N00,3400,8,1352249561,1352249969,3,1,408
73291330@N00,3401,9,1352320566,1352320566,1,1,0
7332125@N04,3402,1,1288605818,1288605885,3,2,67
7332125@N04,3402,29,1288604114,1288605592,4,2,1478
7332125@N04,3403,8,1288650469,1288650469,1,2,0
7332125@N04,3403,19,1288649698,1288649702,2,2,4
7332125@N04,3404,9,1288905408,1288905408,1,1,0
7332125@N04,3405,19,1304405606,1304405606,1,1,0
7332125@N04,3406,19,1304503629,1304503629,1,1,0
73362620@N00,3407,21,1287212487,1287212487,1,1,0
73422480@N00,3408,9,1193454044,1193454294,4,2,250
73422480@N00,3408,11,1193459074,1193460140,8,2,1066
73422480@N00,3409,5,1214628746,1214628746,1,2,0
73422480@N00,3409,19,1214629694,1214629694,1,2,0
73422480@N00,3410,8,1309240422,1309240456,2,2,34
73422480@N00,3410,18,1309236504,1309236514,2,2,10
73422480@N00,3411,3,1309299572,1309316961,29,3,17389
73422480@N00,3411,13,1309314267,1309316301,5,3,2034
73422480@N00,3411,18,1309321339,1309321500,3,3,161
73422480@N00,3412,12,1349580575,1349580858,2,1,283
73478860@N00,3413,9,1303875685,1303875685,1,4,0
73478860@N00,3413,19,1303891176,1303891176,1,4,0
73478860@N00,3413,28,1303876238,1303876238,1,4,0
73478860@N00,3413,29,1303888674,1303890542,3,4,1868
7354829@N03,3414,1,1189481490,1189496315,104,3,14825
7354829@N03,3414,9,1189496726,1189497665,21,3,939
7354829@N03,3414,29,1189496323,1189496692,6,3,369
7354829@N03,3415,19,1189553403,1189553553,8,1,150
7354829@N03,3416,1,1189647472,1189647472,1,9,0
7354829@N03,3416,9,1189648271,1189648279,3,9,8
7354829@N03,3416,16,1189647865,1189647865,1,9,0
7354829@N03,3416,17,1189650305,1189650311,2,9,6
7354829@N03,3416,18,1189646991,1189647273,7,9,282
7354829@N03,3416,19,1189669180,1189671020,5,9,1840
7354829@N03,3416,22,1189642896,1189646300,5,9,3404
7354829@N03,3416,23,1189671074,1189671360,3,9,286
7354829@N03,3416,29,1189648105,1189648105,1,9,0
7359973@N08,3417,3,1344038074,1344038074,1,6,0
7359973@N08,3417,9,1344037231,1344048861,4,6,11630
7359973@N08,3417,15,1344035828,1344035879,2,6,51
7359973@N08,3417,18,1344050741,1344050741,1,6,0
7359973@N08,3417,28,1344041570,1344043166,3,6,1596
7359973@N08,3417,29,1344050031,1344050031,1,6,0
7359973@N08,3418,28,1345125414,1345125414,1,1,0
73613701@N00,3419,4,1115431083,1115440053,17,2,8970
73613701@N00,3419,24,1115430817,1115430954,3,2,137
73613701@N00,3420,29,1186229462,1186237696,23,1,8234
73613701@N00,3421,12,1234616684,1234616684,1,1,0
73613701@N00,3422,9,1297938571,1297938936,11,1,365
73788492@N00,3423,1,1371518340,1371525807,17,6,7467
73788492@N00,3423,2,1371532856,1371537657,10,6,4801
73788492@N00,3423,4,1371532185,1371532185,1,6,0
73788492@N00,3423,7,1371541925,1371544669,16,6,2744
73788492@N00,3423,9,1371530328,1371530328,1,6,0
73788492@N00,3423,29,1371527899,1371530072,3,6,2173
73788492@N00,3424,8,1371714377,1371726720,2,7,12343
73788492@N00,3424,10,1371712081,1371712224,4,7,143
73788492@N00,3424,11,1371711598,1371711874,3,7,276
73788492@N00,3424,15,1371720874,1371726423,2,7,5549
73788492@N00,3424,18,1371718895,1371725800,5,7,6905
73788492@N00,3424,19,1371710386,1371727295,2,7,16909
73788492@N00,3424,22,1371717825,1371718069,2,7,244
73788492@N00,3425,2,1371803934,1371804169,5,8,235
73788492@N00,3425,4,1371803688,1371803809,3,8,121
73788492@N00,3425,8,1371805909,1371805965,2,8,56
73788492@N00,3425,9,1371776422,1371798887,10,8,22465
73788492@N00,3425,15,1371806099,1371817599,5,8,11500
73788492@N00,3425,17,1371777537,1371777746,4,8,209
73788492@N00,3425,19,1371776099,1371805457,2,8,29358
73788492@N00,3425,29,1371779499,1371798158,14,8,18659
7381171@N05,3426,9,1343311953,1343311953,1,1,0
7381171@N05,3427,12,1373176800,1373180400,2,1,3600
7381171@N05,3428,29,1381354820,1381354856,2,1,36
74046046@N00,3429,8,1305183232,1305183232,1,1,0
74068217@N00,3430,18,1160424355,1160424355,1,1,0
74122471@N00,3431,1,1340856723,1340856723,1,1,0
7428481@N05,3432,27,1277616688,1277616688,1,1,0
7437393@N05,3433,29,1251555089,1251555547,7,1,458
7437393@N05,3434,12,1252121799,1252121799,1,1,0
7437393@N05,3435,19,1252234336,1252238436,16,1,4100
7437393@N05,3436,18,1289618162,1289618162,1,1,0
7437393@N05,3437,13,1299303491,1299303491,1,1,0
7437393@N05,3438,3,1300787913,1300787913,1,1,0
7437393@N05,3439,12,1304039188,1304039188,1,1,0
7437393@N05,3440,19,1312968938,1312968938,1,1,0
7437393@N05,3441,2,1317991732,1317991732,1,1,0
7437393@N05,3442,19,1324353725,1324353725,1,1,0
7437393@N05,3443,12,1333796477,1333796477,1,1,0
7437393@N05,3444,19,1337559933,1337559933,1,1,0
7437393@N05,3445,19,1338184035,1338184035,1,1,0
7437393@N05,3446,19,1338335176,1338335176,1,1,0
7437393@N05,3447,8,1339920153,1339920153,1,1,0
7437393@N05,3448,19,1348206162,1348206162,1,1,0
7437393@N05,3449,19,1353567620,1353567620,1,1,0
7437393@N05,3450,19,1360913319,1360913319,1,1,0
7437393@N05,3451,29,1364631173,1364631173,1,1,0
7437393@N05,3452,19,1366265452,1366265452,1,1,0
7437393@N05,3453,19,1377678344,1377678344,1,1,0
7437393@N05,3454,12,1378027220,1378027220,1,1,0
7447762@N05,3455,12,1307055543,1307055543,1,1,0
7447762@N05,3456,5,1309663485,1309663485,1,1,0
7447762@N05,3457,5,1317305344,1317305344,1,2,0
7447762@N05,3457,6,1317304477,1317304477,1,2,0
7447762@N05,3458,14,1323283970,1323283970,1,1,0
7447762@N05,3459,16,1323916286,1323916286,1,1,0
7447762@N05,3460,3,1331316499,1331319206,2,1,2707
74531438@N00,3461,1,1336027551,1336027551,1,2,0
74531438@N00,3461,11,1336024395,1336024564,2,2,169
74531438@N00,3462,29,1336087849,1336087849,1,1,0
74603488@N00,3463,7,1269138535,1269138535,1,2,0
74603488@N00,3463,23,1269134856,1269135093,2,2,237
74603488@N00,3464,18,1269216047,1269216047,1,1,0
74637216@N00,3465,27,1144554923,1144557028,4,1,2105
74691311@N00,3466,1,1141005397,1141011495,5,4,6098
74691311@N00,3466,10,1141028102,1141028102,1,4,0
74691311@N00,3466,16,1141003101,1141003740,3,4,639
74691311@N00,3466,23,1141026529,1141027012,2,4,483
74691311@N00,3467,10,1144389247,1144389247,1,1,0
74691311@N00,3468,18,1144488728,1144488728,1,1,0
74733773@N00,3469,4,1104813080,1104813080,1,1,0
7473636@N06,3470,18,1339814381,1339814381,1,1,0
7473636@N06,3471,29,1340451794,1340451794,1,1,0
7473636@N06,3472,15,1342331532,1342331532,1,1,0
7473636@N06,3473,29,1346419699,1346419699,1,1,0
7473636@N06,3474,29,1352436927,1352437404,2,1,477
7486487@N08,3475,3,1120271339,1120271339,1,1,0
74937968@N00,3476,9,1327991592,1327991592,1,1,0
74937968@N00,3477,9,1328046132,1328053611,2,1,7479
75084208@N00,3478,19,1310076451,1310076451,1,1,0
75084208@N00,3479,8,1324615288,1324615288,1,1,0
75084208@N00,3480,16,1349687663,1349687663,1,1,0
75084208@N00,3481,19,1362971693,1362971850,2,1,157
7512717@N06,3482,3,1235900379,1235900379,1,1,0
7512717@N06,3483,19,1237807224,1237807224,1,1,0
7512717@N06,3484,3,1238728769,1238729288,10,1,519
7512717@N06,3485,18,1239193249,1239193249,1,2,0
7512717@N06,3485,22,1239193389,1239193989,8,2,600
7512717@N06,3486,13,1239706765,1239706765,1,1,0
7512717@N06,3487,19,1240025456,1240029615,5,1,4159
7512717@N06,3488,3,1241949411,1241949567,2,1,156
7512717@N06,3489,29,1242906982,1242907037,2,1,55
7512717@N06,3490,19,1243164717,1243164717,1,1,0
7512717@N06,3491,9,1247568431,1247568431,1,1,0
7512717@N06,3492,15,1249299730,1249300070,3,1,340
7512717@N06,3493,24,1249820502,1249821186,10,1,684
7512717@N06,3494,24,1249874143,1249906393,42,1,32250
7512717@N06,3495,9,1250242506,1250243289,16,1,783
7512717@N06,3496,9,1250406108,1250406120,2,2,12
7512717@N06,3496,22,1250428465,1250428465,1,2,0
7512717@N06,3497,9,1250600484,1250600785,4,1,301
7512717@N06,3498,9,1250685306,1250685440,4,1,134
7512717@N06,3499,9,1250860920,1250861247,5,2,327
7512717@N06,3499,22,1250839353,1250840456,6,2,1103
7512717@N06,3500,9,1251035257,1251035329,2,2,72
7512717@N06,3500,22,1251035409,1251035409,1,2,0
7512717@N06,3501,9,1251084696,1251103683,10,1,18987
7512717@N06,3502,9,1251184803,1251184859,3,1,56
7512717@N06,3503,9,1251445454,1251445454,1,2,0
7512717@N06,3503,15,1251444245,1251444245,1,2,0
7512717@N06,3504,22,1251713167,1251713312,2,1,145
7512717@N06,3505,9,1252063053,1252063053,1,4,0
7512717@N06,3505,15,1252063287,1252063287,1,4,0
7512717@N06,3505,18,1252063544,1252063544,1,4,0
7512717@N06,3505,29,1252063126,1252063126,1,4,0
7512717@N06,3506,9,1252665930,1252666701,12,1,771
7512717@N06,3507,22,1253942401,1253942401,1,1,0
7512717@N06,3508,9,1254976075,1255004946,4,1,28871
7512717@N06,3509,9,1256557032,1256557356,5,1,324
7512717@N06,3510,9,1256895315,1256895315,1,1,0
7512717@N06,3511,8,1257589211,1257589752,8,1,541
7512717@N06,3512,1,1258026328,1258026651,4,2,323
7512717@N06,3512,29,1258026229,1258026517,2,2,288
7512717@N06,3513,8,1258793180,1258793295,4,2,115
7512717@N06,3513,15,1258793015,1258793129,3,2,114
7512717@N06,3514,1,1259402213,1259402730,10,2,517
7512717@N06,3514,15,1259402868,1259402868,1,2,0
7512717@N06,3515,1,1259489207,1259489207,1,1,0
7512717@N06,3516,18,1259754607,1259754607,1,1,0
7512717@N06,3517,1,1259916791,1259917097,6,1,306
7512717@N06,3518,1,1260270909,1260271341,8,1,432
7512717@N06,3519,9,1260962550,1260962873,7,1,323
7512717@N06,3520,8,1261393232,1261393301,2,2,69
7512717@N06,3520,9,1261392633,1261392633,1,2,0
7512717@N06,3521,1,1261643848,1261644042,3,2,194
7512717@N06,3521,9,1261643678,1261643733,2,2,55
7512717@N06,3522,17,1264665351,1264667006,2,1,1655
7512717@N06,3523,9,1265092626,1265092626,1,1,0
7512717@N06,3524,17,1265179015,1265179060,2,2,45
7512717@N06,3524,29,1265179233,1265179233,1,2,0
7512717@N06,3525,9,1265783561,1265783561,1,1,0
7512717@N06,3526,8,1266476533,1266476533,1,2,0
7512717@N06,3526,19,1266475072,1266475072,1,2,0
7512717@N06,3527,3,1266553639,1266555917,3,1,2278
7512717@N06,3528,9,1266821488,1266822593,8,1,1105
7512717@N06,3529,27,1270787776,1270788510,4,1,734
7512717@N06,3530,9,1272527312,1272527312,1,3,0
7512717@N06,3530,16,1272527715,1272527741,3,3,26
7512717@N06,3530,18,1272528806,1272528806,1,3,0
7512717@N06,3531,9,1274168287,1274168310,2,2,23
7512717@N06,3531,18,1274169136,1274169362,4,2,226
7512717@N06,3532,15,1274784139,1274784139,1,1,0
7512717@N06,3533,9,1275551593,1275551593,1,1,0
7512717@N06,3534,18,1276157067,1276157190,2,1,123
7512717@N06,3535,13,1276689101,1276689151,3,1,50
7512717@N06,3536,3,1277357263,1277361528,15,2,4265
7512717@N06,3536,9,1277356096,1277356130,3,2,34
7512717@N06,3537,9,1277883632,1277883768,7,1,136
7512717@N06,3538,9,1280734142,1280734203,6,1,61
7512717@N06,3539,9,1280820637,1280820736,6,1,99
7512717@N06,3540,9,1281247180,1281249065,26,2,1885
7512717@N06,3540,28,1281245042,1281245789,8,2,747
7512717@N06,3541,9,1281339603,1281339655,3,1,52
7512717@N06,3542,9,1281598833,1281599929,14,1,1096
7512717@N06,3543,3,1281848499,1281852641,3,2,4142
7512717@N06,3543,9,1281840892,1281846943,16,2,6051
7512717@N06,3544,1,1281944650,1281944650,1,2,0
7512717@N06,3544,9,1281926784,1281926784,1,2,0
7512717@N06,3545,9,1282203609,1282204143,14,1,534
7512717@N06,3546,22,1282539790,1282562081,15,1,22291
7512717@N06,3547,22,1282630837,1282645990,8,1,15153
7512717@N06,3548,9,1282799440,1282800256,2,2,816
7512717@N06,3548,29,1282801072,1282801072,1,2,0
7512717@N06,3549,3,1283846980,1283847049,3,1,69
7512717@N06,3550,9,1284018454,1284018454,1,1,0
7512717@N06,3551,19,1284450270,1284450318,3,1,48
7512717@N06,3552,9,1284623573,1284623573,1,1,0
7512717@N06,3553,3,1284966507,1284973239,4,1,6732
7512717@N06,3554,28,1285045753,1285045863,5,1,110
7512717@N06,3555,19,1285383609,1285387287,22,2,3678
7512717@N06,3555,28,1285388584,1285389244,11,2,660
7512717@N06,3556,8,1286434817,1286434817,1,1,0
7512717@N06,3557,15,1291881775,1291881775,1,1,0
7512717@N06,3558,17,1291959005,1291959005,1,1,0
7512717@N06,3559,8,1292065407,1292065407,1,1,0
7512717@N06,3560,9,1292486550,1292486860,5,1,310
7512717@N06,3561,1,1292655148,1292655148,1,1,0
7512717@N06,3562,28,1298609183,1298609183,1,1,0
7512717@N06,3563,19,1299537802,1299537802,1,1,0
7512717@N06,3564,8,1299745870,1299745870,1,1,0
7512717@N06,3565,1,1300348852,1300348922,2,3,70
7512717@N06,3565,9,1300348132,1300348149,2,3,17
7512717@N06,3565,17,1300347967,1300347967,1,3,0
7512717@N06,3566,9,1300513197,1300516526,44,1,3329
7512717@N06,3567,28,1301105043,1301107697,10,1,2654
7512717@N06,3568,29,1301290211,1301290211,1,1,0
7512717@N06,3569,3,1301536474,1301540378,17,2,3904
7512717@N06,3569,9,1301541396,1301541396,1,2,0
7512717@N06,3570,9,1302162342,1302162342,1,2,0
7512717@N06,3570,17,1302162267,1302162267,1,2,0
7512717@N06,3571,12,1304048827,1304048827,1,1,0
7512717@N06,3572,3,1305261182,1305261971,4,3,789
7512717@N06,3572,13,1305258109,1305258651,2,3,542
7512717@N06,3572,28,1305258199,1305258536,12,3,337
7512717@N06,3573,9,1305790917,1305791081,7,1,164
7512717@N06,3574,9,1305859692,1305859692,1,1,0
7512717@N06,3575,9,1307001229,1307001229,1,1,0
7512717@N06,3576,9,1307933574,1307951504,15,1,17930
7512717@N06,3577,17,1308184591,1308187464,8,2,2873
7512717@N06,3577,18,1308196792,1308196792,1,2,0
7512717@N06,3578,12,1309002342,1309002476,4,1,134
7512717@N06,3579,9,1309333467,1309333467,1,1,0
7512717@N06,3580,18,1309421217,1309422069,20,1,852
7512717@N06,3581,19,1309942396,1309942396,1,1,0
7512717@N06,3582,9,1311647367,1311666031,6,1,18664
7512717@N06,3583,9,1312356990,1312357242,8,2,252
7512717@N06,3583,12,1312357811,1312357860,2,2,49
7512717@N06,3584,9,1312445159,1312445507,12,1,348
7512717@N06,3585,9,1312789114,1312789972,19,1,858
7512717@N06,3586,9,1312875810,1312878527,49,4,2717
7512717@N06,3586,15,1312879556,1312889153,5,4,9597
7512717@N06,3586,16,1312879395,1312879404,2,4,9
7512717@N06,3586,17,1312875700,1312875700,1,4,0
7512717@N06,3587,9,1313049067,1313049349,6,1,282
7512717@N06,3588,28,1313140616,1313140616,1,1,0
7512717@N06,3589,9,1313395090,1313396019,16,2,929
7512717@N06,3589,17,1313396177,1313396219,5,2,42
7512717@N06,3590,22,1313475252,1313475252,1,1,0
7512717@N06,3591,9,1313729802,1313730990,29,1,1188
7512717@N06,3592,9,1314006491,1314006847,2,1,356
7512717@N06,3593,9,1314171547,1314172430,20,1,883
7512717@N06,3594,9,1314258482,1314258927,5,2,445
7512717@N06,3594,19,1314259426,1314259443,2,2,17
7512717@N06,3595,16,1314690522,1314690545,2,1,23
7512717@N06,3596,8,1315381589,1315381935,7,2,346
7512717@N06,3596,15,1315382016,1315382148,6,2,132
7512717@N06,3597,9,1315468167,1315468502,8,3,335
7512717@N06,3597,15,1315469056,1315469470,7,3,414
7512717@N06,3597,16,1315469219,1315469353,7,3,134
7512717@N06,3598,3,1315986171,1315986818,7,1,647
7512717@N06,3599,12,1316151071,1316151118,3,1,47
7512717@N06,3600,28,1316675023,1316676277,10,1,1254
7512717@N06,3601,9,1316833742,1316833742,1,3,0
7512717@N06,3601,28,1316841337,1316842391,25,3,1054
7512717@N06,3601,29,1316836038,1316837082,13,3,1044
7512717@N06,3602,9,1317092954,1317093188,3,1,234
7512717@N06,3603,19,1317883823,1317883881,4,1,58
7512717@N06,3604,3,1317960688,1317962446,16,3,1758
7512717@N06,3604,13,1317957120,1317957659,2,3,539
7512717@N06,3604,28,1317957766,1317958063,3,3,297
7512717@N06,3605,8,1320306397,1320306496,3,1,99
7512717@N06,3606,8,1320911138,1320911373,2,1,235
7512717@N06,3607,8,1322121202,1322121202,1,1,0
7512717@N06,3608,18,1322190299,1322190688,3,1,389
7512717@N06,3609,8,1322726129,1322726129,1,3,0
7512717@N06,3609,9,1322725754,1322725856,2,3,102
7512717@N06,3609,17,1322725674,1322725674,1,3,0
7512717@N06,3610,8,1324546654,1324546654,1,1,0
7512717@N06,3611,9,1326434731,1326434731,1,4,0
7512717@N06,3611,12,1326441252,1326441896,4,4,644
7512717@N06,3611,15,1326439329,1326439953,4,4,624
7512717@N06,3611,29,1326435678,1326439002,24,4,3324
7512717@N06,3612,9,1329291474,1329291491,2,1,17
7512717@N06,3613,8,1329993686,1329993686,1,2,0
7512717@N06,3613,9,1329982803,1329982803,1,2,0
7512717@N06,3614,8,1330232694,1330232809,2,1,115
7512717@N06,3615,8,1330589628,1330589867,4,2,239
7512717@N06,3615,19,1330588384,1330588542,6,2,158
7512717@N06,3616,8,1331798984,1331799780,3,3,796
7512717@N06,3616,15,1331800231,1331800421,5,3,190
7512717@N06,3616,22,1331802672,1331803426,9,3,754
7512717@N06,3617,12,1332738145,1332738145,1,1,0
7512717@N06,3618,8,1333859343,1333859460,3,2,117
7512717@N06,3618,18,1333860612,1333863483,23,2,2871
7512717@N06,3619,3,1334290607,1334290607,1,1,0
7512717@N06,3620,8,1334838997,1334839078,3,1,81
7512717@N06,3621,9,1335253869,1335253869,1,1,0
7512717@N06,3622,17,1335946131,1335946661,5,1,530
7512717@N06,3623,9,1336031569,1336031704,3,3,135
7512717@N06,3623,17,1336031330,1336031330,1,3,0
7512717@N06,3623,29,1336031801,1336031915,2,3,114
7512717@N06,3624,28,1336372980,1336372980,1,1,0
7512717@N06,3625,3,1337488162,1337492117,31,4,3955
7512717@N06,3625,14,1337493945,1337494317,4,4,372
7512717@N06,3625,17,1337492150,1337492150,1,4,0
7512717@N06,3625,28,1337487870,1337487870,1,4,0
7512717@N06,3626,9,1337672340,1337672447,3,2,107
7512717@N06,3626,29,1337672617,1337672617,1,2,0
7512717@N06,3627,9,1337758698,1337758698,1,1,0
7512717@N06,3628,29,1338277923,1338277923,1,1,0
7512717@N06,3629,9,1340237850,1340240068,10,1,2218
7512717@N06,3630,12,1340962777,1340963506,7,1,729
7512717@N06,3631,9,1342424482,1342424554,2,2,72
7512717@N06,3631,29,1342424740,1342424801,2,2,61
7512717@N06,3632,19,1342597260,1342597260,1,1,0
7512717@N06,3633,28,1343202219,1343202219,1,1,0
7512717@N06,3634,9,1343720602,1343721060,13,1,458
7512717@N06,3635,9,1343806753,1343807031,17,1,278
7512717@N06,3636,9,1343879064,1343893577,19,1,14513
7512717@N06,3637,9,1344238705,1344238821,4,2,116
7512717@N06,3637,28,1344223331,1344223367,3,2,36
7512717@N06,3638,9,1344325189,1344327187,24,3,1998
7512717@N06,3638,15,1344327865,1344327865,1,3,0
7512717@N06,3638,16,1344327741,1344327741,1,3,0
7512717@N06,3639,9,1344411573,1344412324,10,1,751
7512717@N06,3640,9,1344498009,1344499454,22,2,1445
7512717@N06,3640,13,1344500308,1344500382,2,2,74
7512717@N06,3641,22,1344683532,1344692199,9,1,8667
7512717@N06,3642,9,1344749719,1344752663,52,1,2944
7512717@N06,3643,9,1344843703,1344843816,3,1,113
7512717@N06,3644,9,1344930279,1344930704,5,3,425
7512717@N06,3644,15,1344932078,1344932078,1,3,0
7512717@N06,3644,17,1344930190,1344930190,1,3,0
7512717@N06,3645,22,1345181826,1345207052,11,1,25226
7512717@N06,3646,9,1345534704,1345534975,18,1,271
7512717@N06,3647,9,1345621547,1345622191,12,1,644
7512717@N06,3648,9,1345707980,1345708730,12,1,750
7512717@N06,3649,28,1346465398,1346468585,11,1,3187
7512717@N06,3650,3,1348286308,1348286424,3,4,116
7512717@N06,3650,4,1348292854,1348292854,1,4,0
7512717@N06,3650,15,1348294983,1348294983,1,4,0
7512717@N06,3650,16,1348286071,1348286071,1,4,0
7512717@N06,3651,8,1348982402,1348982541,3,5,139
7512717@N06,3651,12,1348985462,1348985737,5,5,275
7512717@N06,3651,15,1348982815,1348983153,6,5,338
7512717@N06,3651,18,1348983862,1348984010,2,5,148
7512717@N06,3651,29,1348982039,1348982123,4,5,84
7512717@N06,3652,8,1350543494,1350543605,3,1,111
7512717@N06,3653,9,1350974441,1350974662,4,2,221
7512717@N06,3653,29,1350974747,1350974747,1,2,0
7512717@N06,3654,1,1351062383,1351062383,1,5,0
7512717@N06,3654,9,1351060965,1351061140,5,5,175
7512717@N06,3654,12,1351062654,1351062654,1,5,0
7512717@N06,3654,17,1351060714,1351060714,1,5,0
7512717@N06,3654,29,1351061666,1351061666,1,5,0
7512717@N06,3655,1,1351497443,1351497676,3,2,233
7512717@N06,3655,9,1351496632,1351497055,3,2,423
7512717@N06,3656,8,1352361521,1352361702,3,3,181
7512717@N06,3656,15,1352361994,1352362167,2,3,173
7512717@N06,3656,28,1352360679,1352360757,3,3,78
7512717@N06,3657,8,1352529740,1352530746,10,4,1006
7512717@N06,3657,15,1352530891,1352531450,4,4,559
7512717@N06,3657,16,1352532625,1352532758,2,4,133
7512717@N06,3657,29,1352529550,1352530588,3,4,1038
7512717@N06,3658,8,1357804345,1357804485,4,1,140
7512717@N06,3659,9,1360568484,1360568563,2,2,79
7512717@N06,3659,17,1360568435,1360568435,1,2,0
7512717@N06,3660,19,1361433395,1361433955,6,1,560
7512717@N06,3661,3,1362030863,1362030863,1,2,0
7512717@N06,3661,9,1362030302,1362030359,2,2,57
7512717@N06,3662,9,1362987688,1362987751,2,2,63
7512717@N06,3662,17,1362987597,1362987619,2,2,22
7512717@N06,3663,8,1363043059,1363043350,3,1,291
7512717@N06,3664,16,1363321480,1363321614,5,2,134
7512717@N06,3664,19,1363326660,1363326660,1,2,0
7512717@N06,3665,8,1364456873,1364457450,11,4,577
7512717@N06,3665,15,1364458227,1364458632,8,4,405
7512717@N06,3665,16,1364458516,1364458516,1,4,0
7512717@N06,3665,19,1364457033,1364457145,3,4,112
7512717@N06,3666,16,1367312421,1367312421,1,1,0
7512717@N06,3667,9,1367643457,1367643457,1,4,0
7512717@N06,3667,15,1367642484,1367642679,3,4,195
7512717@N06,3667,16,1367643010,1367643110,2,4,100
7512717@N06,3667,28,1367646091,1367651298,7,4,5207
7512717@N06,3668,27,1368766301,1368769963,22,1,3662
7512717@N06,3669,12,1371193561,1371193561,1,1,0
7512717@N06,3670,3,1371363247,1371363337,4,1,90
7512717@N06,3671,9,1371687142,1371692233,9,1,5091
7512717@N06,3672,12,1372234696,1372234696,1,1,0
7512717@N06,3673,12,1372412846,1372423346,4,1,10500
7512717@N06,3674,9,1375170856,1375170865,2,2,9
7512717@N06,3674,28,1375152327,1375152737,3,2,410
7512717@N06,3675,9,1375256534,1375256650,3,1,116
7512717@N06,3676,9,1375342383,1375344049,16,2,1666
7512717@N06,3676,15,1375344506,1375344536,2,2,30
7512717@N06,3677,9,1375503340,1375506784,66,4,3444
7512717@N06,3677,14,1375510016,1375510656,14,4,640
7512717@N06,3677,15,1375507424,1375507558,5,4,134
7512717@N06,3677,18,1375508753,1375508851,2,4,98
7512717@N06,3678,9,1375688304,1375688707,6,1,403
7512717@N06,3679,9,1375774695,1375774961,6,1,266
7512717@N06,3680,9,1375861136,1375861809,8,1,673
7512717@N06,3681,9,1376111044,1376113358,36,3,2314
7512717@N06,3681,15,1376113828,1376113893,3,3,65
7512717@N06,3681,22,1376114889,1376142895,12,3,28006
7512717@N06,3682,9,1376293130,1376293306,3,1,176
7512717@N06,3683,9,1376379641,1376380067,17,1,426
7512717@N06,3684,9,1376466075,1376466353,6,3,278
7512717@N06,3684,22,1376471045,1376471080,3,3,35
7512717@N06,3684,28,1376456534,1376458571,5,3,2037
7512717@N06,3685,9,1376552184,1376552623,24,1,439
7512717@N06,3686,9,1376897808,1376898186,12,1,378
7512717@N06,3687,9,1377070634,1377071059,13,1,425
7512717@N06,3688,9,1377157445,1377157492,3,1,47
7512717@N06,3689,22,1377235948,1377240039,7,1,4091
7512717@N06,3690,22,1377320976,1377325401,11,1,4425
7512717@N06,3691,9,1377503366,1377503750,7,1,384
7512717@N06,3692,28,1378616500,1378618210,8,1,1710
7512717@N06,3693,1,1379490531,1379490669,2,6,138
7512717@N06,3693,9,1379489882,1379489882,1,6,0
7512717@N06,3693,12,1379490874,1379490886,2,6,12
7512717@N06,3693,14,1379491175,1379491175,1,6,0
7512717@N06,3693,17,1379489738,1379489774,3,6,36
7512717@N06,3693,29,1379490407,1379490447,4,6,40
7512717@N06,3694,15,1380014516,1380014516,1,2,0
7512717@N06,3694,16,1380014327,1380014482,2,2,155
7512717@N06,3695,3,1380094857,1380094857,1,1,0
7512717@N06,3696,3,1380346405,1380346416,2,4,11
7512717@N06,3696,9,1380338729,1380339689,4,4,960
7512717@N06,3696,17,1380337969,1380346273,35,4,8304
7512717@N06,3696,29,1380344912,1380346051,19,4,1139
7512717@N06,3697,8,1382337752,1382337752,1,2,0
7512717@N06,3697,19,1382337478,1382337590,2,2,112
7512717@N06,3698,9,1382510206,1382510228,2,2,22
7512717@N06,3698,17,1382510055,1382510055,1,2,0
7512717@N06,3699,8,1382597681,1382597681,1,3,0
7512717@N06,3699,15,1382597979,1382598162,2,3,183
7512717@N06,3699,19,1382597225,1382597225,1,3,0
7512717@N06,3700,9,1383032397,1383032723,3,3,326
7512717@N06,3700,12,1383033442,1383033696,3,3,254
7512717@N06,3700,14,1383033818,1383033818,1,3,0
7512717@N06,3701,8,1383979414,1383981992,17,3,2578
7512717@N06,3701,18,1383982706,1383983231,8,3,525
7512717@N06,3701,19,1383981220,1383981220,1,3,0
7512717@N06,3702,19,1384415434,1384427247,4,1,11813
7512717@N06,3703,3,1384489021,1384489066,2,1,45
7512717@N06,3704,29,1384846848,1384847125,3,1,277
7512717@N06,3705,9,1385624353,1385624447,2,2,94
7512717@N06,3705,15,1385625178,1385626987,18,2,1809
7512717@N06,3706,12,1386757229,1386757229,1,1,0
7512717@N06,3707,9,1387266772,1387267339,3,4,567
7512717@N06,3707,16,1387267779,1387267779,1,4,0
7512717@N06,3707,17,1387266368,1387266538,3,4,170
7512717@N06,3707,29,1387267488,1387267488,1,4,0
7512717@N06,3708,12,1387777052,1387777052,1,2,0
7512717@N06,3708,18,1387776428,1387776428,1,2,0
7512717@N06,3709,8,1388816183,1388817555,11,3,1372
7512717@N06,3709,15,1388815332,1388816077,2,3,745
7512717@N06,3709,16,1388815695,1388815719,2,3,24
7512717@N06,3710,19,1389254625,1389254726,2,1,101
7512717@N06,3711,8,1390113450,1390113483,2,6,33
7512717@N06,3711,10,1390109228,1390112121,10,6,2893
7512717@N06,3711,11,1390112190,1390112190,1,6,0
7512717@N06,3711,15,1390113325,1390113902,3,6,577
7512717@N06,3711,22,1390115198,1390116198,9,6,1000
7512717@N06,3711,23,1390109030,1390112699,4,6,3669
7512717@N06,3712,19,1390710507,1390710507,1,1,0
7512717@N06,3713,9,1390896038,1390896151,3,1,113
7512717@N06,3714,28,1390980580,1390982485,13,1,1905
7512717@N06,3715,8,1392280257,1392280257,1,2,0
7512717@N06,3715,19,1392278044,1392278044,1,2,0
7512717@N06,3716,28,1392715686,1392715686,1,1,0
7512717@N06,3717,27,1393560825,1393561194,5,1,369
7512717@N06,3718,28,1394095271,1394097979,4,1,2708
7512717@N06,3719,1,1394524502,1394524520,2,3,18
7512717@N06,3719,9,1394523752,1394523838,3,3,86
7512717@N06,3719,12,1394524473,1394524473,1,3,0
7512717@N06,3720,3,1394610073,1394610073,1,1,0
7512717@N06,3721,9,1395205937,1395206120,9,1,183
75136617@N00,3722,23,1173682799,1173682799,1,1,0
75136617@N00,3723,23,1177035082,1177035082,1,1,0
75136617@N00,3724,15,1186288276,1186288276,1,1,0
75136617@N00,3725,15,1187234966,1187234966,1,1,0
75136617@N00,3726,3,1189747290,1189747290,1,1,0
75136617@N00,3727,9,1191650335,1191650335,1,1,0
75136617@N00,3728,15,1191741188,1191741188,1,1,0
75136617@N00,3729,9,1195883834,1195883834,1,1,0
75136617@N00,3730,19,1199163910,1199163910,1,1,0
75136617@N00,3731,1,1206943079,1206943079,1,1,0
75136617@N00,3732,3,1207989500,1207989500,1,1,0
75136617@N00,3733,3,1210595869,1210595869,1,1,0
75136617@N00,3734,9,1211168416,1211168522,4,3,106
75136617@N00,3734,15,1211172618,1211172618,1,3,0
75136617@N00,3734,18,1211173936,1211173936,1,3,0
75136617@N00,3735,18,1216454818,1216454818,1,1,0
75136617@N00,3736,18,1222490204,1222490204,1,1,0
75136617@N00,3737,19,1225606711,1225606711,1,1,0
75136617@N00,3738,8,1227943526,1227943526,1,2,0
75136617@N00,3738,15,1227946164,1227946173,2,2,9
75136617@N00,3739,15,1228015386,1228015620,2,2,234
75136617@N00,3739,18,1228016001,1228016102,2,2,101
75136617@N00,3740,7,1345263033,1345263033,1,1,0
75136617@N00,3741,11,1378648668,1378648668,1,1,0
75173968@N00,3742,9,1375858731,1375861082,2,2,2351
75173968@N00,3742,17,1375861686,1375861686,1,2,0
75173968@N00,3743,9,1376186113,1376190587,10,2,4474
75173968@N00,3743,19,1376191704,1376191704,1,2,0
75173968@N00,3744,13,1376306753,1376306753,1,1,0
75173968@N00,3745,9,1376616327,1376616327,1,1,0
75181076@N00,3746,9,1309382309,1309382309,1,1,0
75181076@N00,3747,29,1309687572,1309687572,1,1,0
75181076@N00,3748,4,1340278434,1340278759,3,7,325
75181076@N00,3748,8,1340265993,1340276468,4,7,10475
75181076@N00,3748,11,1340277353,1340277353,1,7,0
75181076@N00,3748,16,1340276240,1340276240,1,7,0
75181076@N00,3748,19,1340276631,1340276899,5,7,268
75181076@N00,3748,23,1340277346,1340277346,1,7,0
75181076@N00,3748,29,1340275432,1340275839,11,7,407
75181076@N00,3749,19,1340320834,1340320834,1,1,0
75181076@N00,3750,29,1340626798,1340626798,1,1,0
75181076@N00,3751,8,1340659662,1340659662,1,2,0
75181076@N00,3751,29,1340659225,1340659225,1,2,0
75181076@N00,3752,9,1349253465,1349253465,1,1,0
75234774@N00,3753,22,1313014633,1313014633,1,1,0
75286866@N00,3754,28,1343076518,1343076518,1,1,0
75286866@N00,3755,2,1343144793,1343146294,2,1,1501
75286866@N00,3756,2,1343213666,1343213666,1,1,0
75286866@N00,3757,17,1344250697,1344250697,1,1,0
75286866@N00,3758,1,1344353541,1344353541,1,5,0
75286866@N00,3758,3,1344357555,1344361076,2,5,3521
75286866@N00,3758,8,1344349367,1344349367,1,5,0
75286866@N00,3758,11,1344349724,1344352610,2,5,2886
75286866@N00,3758,17,1344352834,1344359356,2,5,6522
75316317@N00,3759,1,1149904716,1149904716,1,1,0
75316317@N00,3760,8,1149989632,1149989632,1,1,0
75316317@N00,3761,10,1150024155,1150024155,1,1,0
75363368@N00,3762,9,1375679998,1375681225,2,1,1227
75363368@N00,3763,12,1376187926,1376187926,1,1,0
75363368@N00,3764,18,1376644682,1376644682,1,2,0
75363368@N00,3764,22,1376653874,1376653874,1,2,0
7545618@N03,3765,29,1124698462,1124698462,1,1,0
75601388@N00,3766,8,1334209665,1334211856,3,2,2191
75601388@N00,3766,18,1334211099,1334211099,1,2,0
75601388@N00,3767,29,1334268868,1334268871,2,1,3
75679864@N05,3768,3,1315019132,1315019132,1,1,0
75873727@N00,3769,9,1254232802,1254232802,1,2,0
75873727@N00,3769,29,1254232801,1254232801,1,2,0
75873727@N00,3770,1,1254281382,1254282628,2,2,1246
75873727@N00,3770,9,1254282588,1254282588,1,2,0
75873727@N00,3771,1,1254807397,1254807397,1,1,0
75873727@N00,3772,1,1254881702,1254881702,1,1,0
75951171@N02,3773,10,1290086633,1290086633,1,1,0
75951171@N02,3774,8,1290758332,1290758544,3,2,212
75951171@N02,3774,18,1290759689,1290759689,1,2,0
75951171@N02,3775,18,1291009836,1291009836,1,1,0
75951171@N02,3776,18,1291192510,1291192510,1,3,0
75951171@N02,3776,28,1291195688,1291195688,1,3,0
75951171@N02,3776,29,1291197128,1291197128,1,3,0
75951171@N02,3777,17,1299129195,1299129195,1,1,0
75951171@N02,3778,17,1299202377,1299202377,1,1,0
75951171@N02,3779,12,1299297110,1299297110,1,1,0
75951171@N02,3780,29,1344857404,1344859537,2,1,2133
75951171@N02,3781,17,1359004857,1359004857,1,1,0
76031956@N04,3782,9,1349408502,1349408502,1,1,0
76063378@N04,3783,8,1251727200,1251727200,1,1,0
76232585@N00,3784,12,1268191980,1268191980,1,1,0
76232585@N00,3785,12,1271840954,1271841060,4,1,106
7626777@N02,3786,17,1248335650,1248335650,1,1,0
7626777@N02,3787,8,1248403831,1248403831,1,1,0
76327930@N00,3788,15,1214273013,1214273013,1,1,0
7633518@N08,3789,1,1365452492,1365475528,43,3,23036
7633518@N08,3789,9,1365466034,1365473214,6,3,7180
7633518@N08,3789,29,1365466029,1365469381,4,3,3352
7633518@N08,3790,8,1365564856,1365564875,3,1,19
7633518@N08,3791,9,1365619373,1365619373,1,1,0
76529721@N00,3792,16,1245836492,1245836802,4,2,310
76529721@N00,3792,19,1245853996,1245853996,1,2,0
7655983@N06,3793,13,1283045669,1283045669,1,1,0
7655983@N06,3794,3,1290970023,1290970023,1,1,0
7666975@N03,3795,23,1337262567,1337262567,1,1,0
7666975@N03,3796,1,1337350035,1337350035,1,3,0
7666975@N03,3796,3,1337361905,1337361905,1,3,0
7666975@N03,3796,29,1337337204,1337340914,7,3,3710
7666975@N03,3797,22,1337413372,1337413447,2,1,75
76676198@N00,3798,20,1153903546,1153903546,1,1,0
76676198@N00,3799,9,1155350398,1155351430,2,1,1032
76676198@N00,3800,20,1155801443,1155801443,1,1,0
76676198@N00,3801,20,1163819992,1163819992,1,1,0
76676198@N00,3802,20,1165025985,1165025985,1,1,0
76795125@N00,3803,7,1137194390,1137194390,1,1,0
76796245@N00,3804,17,1320459297,1320459297,1,1,0
76871899@N02,3805,9,1327896252,1327896263,2,1,11
77036619@N00,3806,8,1245318371,1245318371,1,2,0
77036619@N00,3806,19,1245317919,1245317919,1,2,0
77036619@N00,3807,1,1245374971,1245375585,14,10,614
77036619@N00,3807,2,1245388807,1245391864,3,10,3057
77036619@N00,3807,3,1245395394,1245396330,12,10,936
77036619@N00,3807,4,1245388517,1245392587,7,10,4070
77036619@N00,3807,8,1245373707,1245400830,16,10,27123
77036619@N00,3807,9,1245374319,1245395153,25,10,20834
77036619@N00,3807,16,1245374635,1245374644,3,10,9
77036619@N00,3807,17,1245376780,1245382822,13,10,6042
77036619@N00,3807,19,1245400950,1245411606,7,10,10656
77036619@N00,3807,29,1245374331,1245376328,18,10,1997
77036619@N00,3808,19,1245495048,1245495115,3,1,67
77036619@N00,3809,19,1245536673,1245536673,1,1,0
77036619@N00,3810,8,1245650109,1245650109,1,5,0
77036619@N00,3810,9,1245647250,1245649352,5,5,2102
77036619@N00,3810,17,1245644405,1245646781,10,5,2376
77036619@N00,3810,19,1245643530,1245650150,8,5,6620
77036619@N00,3810,29,1245658436,1245658801,6,5,365
77036619@N00,3811,3,1245726979,1245728620,14,7,1641
77036619@N00,3811,8,1245739487,1245740430,3,7,943
77036619@N00,3811,9,1245719938,1245739766,18,7,19828
77036619@N00,3811,15,1245729917,1245731106,22,7,1189
77036619@N00,3811,17,1245721222,1245721222,1,7,0
77036619@N00,3811,19,1245740367,1245740367,1,7,0
77036619@N00,3811,29,1245722180,1245734294,33,7,12114
77047514@N00,3812,3,1111058444,1111058444,1,1,0
77047514@N00,3813,3,1112314691,1112315022,5,1,331
77047514@N00,3814,9,1113284236,1113284236,1,3,0
77047514@N00,3814,14,1113295835,1113295952,2,3,117
77047514@N00,3814,19,1113285029,1113285029,1,3,0
77047514@N00,3815,20,1113379232,1113379232,1,1,0
77047514@N00,3816,18,1114326150,1114329927,7,1,3777
77047514@N00,3817,23,1114868509,1114871484,3,1,2975
77047514@N00,3818,8,1115448810,1115451200,3,2,2390
77047514@N00,3818,15,1115449854,1115450021,6,2,167
77047514@N00,3819,12,1115675565,1115675608,2,1,43
77047514@N00,3820,19,1115712170,1115712488,2,1,318
77047514@N00,3821,12,1116058854,1116068282,2,1,9428
77047514@N00,3822,19,1119096693,1119096693,1,2,0
77047514@N00,3822,23,1119095903,1119095903,1,2,0
77047514@N00,3823,3,1120278078,1120278099,2,1,21
77047514@N00,3824,18,1120364723,1120377924,5,1,13201
77047514@N00,3825,3,1196443754,1196443754,1,7,0
77047514@N00,3825,13,1196443734,1196443734,1,7,0
77047514@N00,3825,14,1196462314,1196462314,1,7,0
77047514@N00,3825,15,1196444144,1196444144,1,7,0
77047514@N00,3825,18,1196462364,1196462364,1,7,0
77047514@N00,3825,19,1196443586,1196444171,3,7,585
77047514@N00,3825,23,1196443675,1196443682,3,7,7
77047514@N00,3826,12,1197704924,1197715238,4,1,10314
77047514@N00,3827,17,1198061739,1198067252,2,1,5513
77047514@N00,3828,3,1199070883,1199072045,6,2,1162
77047514@N00,3828,17,1199098861,1199106223,6,2,7362
77047514@N00,3829,12,1211084461,1211089865,3,1,5404
77047514@N00,3830,29,1211697241,1211712843,4,1,15602
77047514@N00,3831,4,1211888495,1211888495,1,1,0
77047514@N00,3832,3,1212210289,1212210289,1,2,0
77047514@N00,3832,29,1212211199,1212211199,1,2,0
77047514@N00,3833,4,1212895212,1212895212,1,2,0
77047514@N00,3833,18,1212891648,1212891648,1,2,0
77047514@N00,3834,17,1213841233,1213841284,2,1,51
77047514@N00,3835,17,1213875862,1213875862,1,1,0
77047514@N00,3836,19,1213920038,1213920038,1,1,0
77047514@N00,3837,8,1214030056,1214030056,1,1,0
77047514@N00,3838,12,1214882830,1214882830,1,2,0
77047514@N00,3838,13,1214900748,1214900748,1,2,0
77047514@N00,3839,3,1215161614,1215161614,1,4,0
77047514@N00,3839,12,1215163789,1215163789,1,4,0
77047514@N00,3839,17,1215167273,1215169158,2,4,1885
77047514@N00,3839,29,1215165161,1215165180,2,4,19
77047514@N00,3840,3,1215937450,1215937450,1,3,0
77047514@N00,3840,12,1215919899,1215919899,1,3,0
77047514@N00,3840,13,1215937601,1215937601,1,3,0
77047514@N00,3841,3,1216116417,1216116417,1,1,0
77047514@N00,3842,3,1216534515,1216534515,1,6,0
77047514@N00,3842,4,1216531411,1216531925,5,6,514
77047514@N00,3842,8,1216525085,1216526997,2,6,1912
77047514@N00,3842,15,1216527759,1216527759,1,6,0
77047514@N00,3842,23,1216531028,1216531028,1,6,0
77047514@N00,3842,24,1216520432,1216520432,1,6,0
77047514@N00,3843,12,1216720113,1216720153,2,1,40
77047514@N00,3844,12,1216772474,1216772474,1,1,0
77047514@N00,3845,3,1216810946,1216810946,1,2,0
77047514@N00,3845,28,1216812779,1216812779,1,2,0
77047514@N00,3846,14,1217441185,1217441185,1,1,0
77047514@N00,3847,3,1217513716,1217513716,1,1,0
77047514@N00,3848,10,1217844992,1217844992,1,1,0
77047514@N00,3849,3,1218269080,1218269080,1,1,0
77047514@N00,3850,19,1218787525,1218787525,1,1,0
77047514@N00,3851,3,1219666503,1219670201,10,1,3698
77047514@N00,3852,28,1219743545,1219743545,1,1,0
77047514@N00,3853,18,1220177547,1220179795,5,1,2248
77047514@N00,3854,29,1220761043,1220761043,1,1,0
77047514@N00,3855,28,1222483156,1222483156,1,2,0
77047514@N00,3855,29,1222490254,1222491187,4,2,933
77047514@N00,3856,16,1223796186,1223796519,2,2,333
77047514@N00,3856,29,1223798382,1223798595,2,2,213
77047514@N00,3857,18,1224305571,1224305571,1,1,0
77047514@N00,3858,19,1224627551,1224627551,1,1,0
77047514@N00,3859,12,1225069903,1225070140,4,2,237
77047514@N00,3859,19,1225088382,1225088382,1,2,0
77047514@N00,3860,19,1226359431,1226359431,1,1,0
77047514@N00,3861,8,1228542502,1228547060,2,2,4558
77047514@N00,3861,15,1228537625,1228540733,4,2,3108
77047514@N00,3862,3,1229735823,1229738892,3,4,3069
77047514@N00,3862,9,1229752410,1229753097,6,4,687
77047514@N00,3862,15,1229746198,1229746198,1,4,0
77047514@N00,3862,16,1229747494,1229747494,1,4,0
77047514@N00,3863,3,1230728400,1230728400,1,1,0
77047514@N00,3864,9,1232157544,1232160418,7,1,2874
77047514@N00,3865,3,1233140507,1233140810,2,1,303
77047514@N00,3866,8,1233329028,1233329028,1,2,0
77047514@N00,3866,14,1233327183,1233327183,1,2,0
77047514@N00,3867,3,1234059778,1234066383,8,1,6605
77047514@N00,3868,27,1235190450,1235190450,1,1,0
77047514@N00,3869,29,1235269842,1235269842,1,1,0
77047514@N00,3870,28,1235886705,1235888728,3,1,2023
77047514@N00,3871,8,1236179025,1236179025,1,1,0
77047514@N00,3872,1,1236386042,1236386042,1,1,0
77047514@N00,3873,3,1236691251,1236691251,1,2,0
77047514@N00,3873,9,1236684899,1236685373,2,2,474
77047514@N00,3874,3,1237856731,1237856731,1,2,0
77047514@N00,3874,28,1237867294,1237867294,1,2,0
77047514@N00,3875,19,1239193931,1239193931,1,1,0
77047514@N00,3876,9,1239983853,1239983853,1,1,0
77117560@N00,3877,22,1321673060,1321673060,1,1,0
77117560@N00,3878,22,1322270823,1322270823,1,1,0
77125925@N00,3879,8,1213078276,1213079148,3,1,872
77125925@N00,3880,1,1213500206,1213500206,1,2,0
77125925@N00,3880,18,1213508087,1213508087,1,2,0
77321230@N00,3881,29,1191655334,1191657809,2,1,2475
77321230@N00,3882,1,1218193944,1218194743,2,4,799
77321230@N00,3882,9,1218188496,1218190859,13,4,2363
77321230@N00,3882,12,1218194868,1218194868,1,4,0
77321230@N00,3882,29,1218193787,1218194325,4,4,538
77321230@N00,3883,29,1344421455,1344421455,1,1,0
77321230@N00,3884,10,1365311884,1365311884,1,1,0
77321230@N00,3885,16,1366545693,1366546900,2,1,1207
77321230@N00,3886,16,1375511312,1375511312,1,1,0
77321230@N00,3887,16,1375585243,1375585243,1,1,0
77321230@N00,3888,18,1375615969,1375615969,1,1,0
77351046@N00,3889,8,1338212628,1338212628,1,4,0
77351046@N00,3889,9,1338212683,1338212683,1,4,0
77351046@N00,3889,11,1338212687,1338212687,1,4,0
77351046@N00,3889,16,1338212685,1338212685,1,4,0
77422605@N00,3890,19,1280815313,1280815313,1,1,0
77422605@N00,3891,19,1295022329,1295022329,1,1,0
7743836@N02,3892,9,1019560795,1019560795,1,1,0
77456049@N00,3893,29,1346202866,1346202866,1,1,0
77456049@N00,3894,17,1346239108,1346239108,1,1,0
77456049@N00,3895,2,1346289794,1346289944,3,8,150
77456049@N00,3895,8,1346293141,1346293141,1,8,0
77456049@N00,3895,9,1346292038,1346292301,2,8,263
77456049@N00,3895,15,1346292846,1346293027,3,8,181
77456049@N00,3895,16,1346292632,1346292810,2,8,178
77456049@N00,3895,19,1346293385,1346307621,3,8,14236
77456049@N00,3895,24,1346290348,1346290772,4,8,424
77456049@N00,3895,29,1346292611,1346292611,1,8,0
77704116@N00,3896,8,1354971606,1354971616,8,5,10
77704116@N00,3896,15,1354971608,1354971618,4,5,10
77704116@N00,3896,18,1354971617,1354971620,2,5,3
77704116@N00,3896,19,1354971604,1354971604,1,5,0
77704116@N00,3896,29,1354971619,1354971619,1,5,0
77704116@N00,3897,8,1385969630,1385977992,9,1,8362
77704116@N00,3898,8,1386464197,1386472517,2,2,8320
77704116@N00,3898,15,1386473546,1386473546,1,2,0
77726415@N00,3899,19,1299821929,1299821929,1,1,0
7773270@N02,3900,9,1286947741,1286947741,1,2,0
7773270@N02,3900,17,1286948147,1286948147,1,2,0
7773270@N02,3901,29,1287008110,1287008110,1,1,0
7773270@N02,3902,3,1356749809,1356749809,1,1,0
77769331@N07,3903,2,1167774740,1167774740,1,1,0
77769331@N07,3904,1,1185225004,1185225004,1,1,0
77784942@N00,3905,19,1275564917,1275569580,4,1,4663
77862309@N00,3906,1,1193268344,1193268344,1,1,0
77879116@N00,3907,23,1317002411,1317002411,1,1,0
7790703@N02,3908,8,1231991823,1231991823,1,2,0
7790703@N02,3908,16,1232001530,1232001530,1,2,0
7790703@N02,3909,19,1242345694,1242345694,1,1,0
7790703@N02,3910,19,1247897390,1247897390,1,2,0
7790703@N02,3910,21,1247893297,1247893297,1,2,0
7790703@N02,3911,14,1254309462,1254309462,1,1,0
7790703@N02,3912,14,1257894966,1257894966,1,1,0
7790703@N02,3913,20,1275283117,1275283117,1,1,0
7790703@N02,3914,22,1280669038,1280669038,1,1,0
7790703@N02,3915,19,1280915281,1280915281,1,1,0
7790703@N02,3916,9,1281509100,1281509100,1,1,0
7790703@N02,3917,1,1282221176,1282221176,1,2,0
7790703@N02,3917,12,1282219512,1282219512,1,2,0
7790703@N02,3918,8,1284444410,1284445613,5,2,1203
7790703@N02,3918,29,1284442883,1284443147,3,2,264
7790703@N02,3919,9,1292737059,1292737059,1,1,0
7790703@N02,3920,1,1295312797,1295312797,2,4,0
7790703@N02,3920,2,1295314789,1295314789,1,4,0
7790703@N02,3920,4,1295314605,1295314605,2,4,0
7790703@N02,3920,9,1295313320,1295313320,1,4,0
7790703@N02,3921,14,1298327482,1298327482,1,1,0
7790703@N02,3922,15,1299219210,1299219210,1,1,0
7790703@N02,3923,4,1305861810,1305862081,2,2,271
7790703@N02,3923,11,1305855066,1305875177,5,2,20111
7790703@N02,3924,9,1307946487,1307948450,6,1,1963
7790703@N02,3925,3,1311489178,1311489178,1,2,0
7790703@N02,3925,13,1311489419,1311489419,1,2,0
7790703@N02,3926,29,1312537849,1312537849,1,1,0
7790703@N02,3927,3,1313117082,1313118104,5,2,1022
7790703@N02,3927,9,1313115105,1313115599,9,2,494
7790703@N02,3928,9,1313302625,1313304054,5,3,1429
7790703@N02,3928,15,1313301691,1313301691,2,3,0
7790703@N02,3928,29,1313304648,1313304648,1,3,0
7790703@N02,3929,15,1315645282,1315645282,1,1,0
7790703@N02,3930,3,1315967572,1315971292,3,3,3720
7790703@N02,3930,12,1315961301,1315961301,2,3,0
7790703@N02,3930,19,1315975389,1315975389,1,3,0
7790703@N02,3931,22,1318993741,1318993741,1,1,0
7790703@N02,3932,29,1319963289,1319972991,30,1,9702
7790703@N02,3933,29,1320102992,1320102992,1,1,0
7790703@N02,3934,29,1320137272,1320137272,1,1,0
7790703@N02,3935,22,1322282501,1322282501,1,1,0
7790703@N02,3936,23,1331902800,1331902800,1,1,0
7790703@N02,3937,10,1331948525,1331948525,1,2,0
7790703@N02,3937,23,1331949945,1331950234,2,2,289
7790703@N02,3938,25,1336873047,1336873047,1,1,0
7790703@N02,3939,14,1338749324,1338749324,1,1,0
7790703@N02,3940,18,1341714527,1341714527,1,1,0
7790703@N02,3941,9,1344311271,1344314290,17,1,3019
7790703@N02,3942,9,1344485607,1344497385,11,1,11778
7790703@N02,3943,29,1358474509,1358476962,5,1,2453
7790703@N02,3944,10,1361772695,1361782219,14,1,9524
7790703@N02,3945,9,1375416967,1375417165,3,1,198
7790703@N02,3946,9,1375935402,1375938495,20,2,3093
7790703@N02,3946,17,1375935154,1375935174,2,2,20
7790703@N02,3947,9,1376537110,1376542482,13,1,5372
7790703@N02,3948,8,1385286922,1385288257,4,3,1335
7790703@N02,3948,15,1385286636,1385286636,1,3,0
7790703@N02,3948,29,1385285974,1385286155,2,3,181
7790703@N02,3949,19,1386653303,1386653303,1,2,0
7790703@N02,3949,29,1386651629,1386653159,2,2,1530
7790703@N02,3950,2,1393647687,1393647687,1,1,0
77914365@N02,3951,29,1352440490,1352444632,2,1,4142
7792743@N05,3952,23,1207275973,1207275973,1,1,0
7797604@N05,3953,4,1182847290,1182847290,1,1,0
7797604@N05,3954,4,1183073487,1183081079,28,2,7592
7797604@N05,3954,9,1183074525,1183084413,8,2,9888
78005203@N00,3955,9,1155606100,1155606100,1,1,0
78042364@N00,3956,18,1156648572,1156676776,38,1,28204
7811565@N03,3957,9,1262156955,1262156955,1,1,0
7811565@N03,3958,11,1262225639,1262229616,2,1,3977
7811565@N03,3959,9,1262332671,1262332671,1,1,0
78131858@N00,3960,19,1252234230,1252236571,7,1,2341
78131858@N00,3961,1,1253354289,1253354289,1,2,0
78131858@N00,3961,18,1253353636,1253353636,1,2,0
78156422@N06,3962,21,1325336400,1325336400,7,1,0
78231096@N00,3963,3,1347156932,1347156932,1,2,0
78231096@N00,3963,17,1347156681,1347156681,1,2,0
78239672@N00,3964,29,1186622770,1186622770,1,1,0
78239672@N00,3965,29,1186669714,1186670590,4,1,876
78361112@N00,3966,2,1380093651,1380093651,1,3,0
78361112@N00,3966,9,1380097064,1380097064,1,3,0
78361112@N00,3966,29,1380095833,1380095833,1,3,0
7842778@N04,3967,7,1196478000,1196478006,2,1,6
78461351@N00,3968,8,1325326309,1325326309,1,5,0
78461351@N00,3968,9,1325291999,1325319804,3,5,27805
78461351@N00,3968,18,1325328289,1325328289,1,5,0
78461351@N00,3968,19,1325318412,1325318412,1,5,0
78461351@N00,3968,29,1325293321,1325325625,4,5,32304
7856302@N02,3969,29,1168750753,1168753070,4,1,2317
7856302@N02,3970,3,1179853461,1179859095,72,2,5634
7856302@N02,3970,13,1179852124,1179852139,3,2,15
7856302@N02,3971,13,1280542221,1280543155,3,1,934
7856302@N02,3972,28,1318478098,1318478098,1,1,0
7856302@N02,3973,22,1331709408,1331709446,6,1,38
7856302@N02,3974,12,1336783651,1336783651,2,1,0
7856302@N02,3975,17,1337343227,1337343227,1,1,0
7856302@N02,3976,28,1341908827,1341915784,78,1,6957
7856302@N02,3977,3,1341998188,1342015388,52,1,17200
7856302@N02,3978,18,1346583754,1346586602,71,1,2848
7856302@N02,3979,19,1373667631,1373667631,1,1,0
7868489@N05,3980,18,1189664239,1189665112,8,1,873
7880512@N06,3981,28,1345340538,1345340538,1,1,0
7880512@N06,3982,13,1345424957,1345424957,1,2,0
7880512@N06,3982,29,1345434322,1345434322,1,2,0
7880512@N06,3983,13,1345463578,1345463578,1,1,0
7880512@N06,3984,12,1345691224,1345691634,2,2,410
7880512@N06,3984,19,1345691055,1345691055,1,2,0
7880512@N06,3985,7,1345786475,1345786475,1,3,0
7880512@N06,3985,17,1345776601,1345776601,1,3,0
7880512@N06,3985,24,1345784294,1345784529,2,3,235
7883724@N05,3986,3,1365116369,1365116457,2,2,88
7883724@N05,3986,29,1365118431,1365119774,2,2,1343
7885919@N07,3987,16,1217146116,1217146116,1,2,0
7885919@N07,3987,29,1217146015,1217156993,7,2,10978
7886651@N03,3988,3,1249539454,1249539454,1,1,0
7886651@N03,3989,3,1280884878,1280884878,1,1,0
7886651@N03,3990,13,1283174825,1283174825,1,1,0
7888746@N08,3991,8,1237786103,1237809571,6,4,23468
7888746@N08,3991,15,1237786110,1237789689,4,4,3579
7888746@N08,3991,17,1237799113,1237801139,8,4,2026
7888746@N08,3991,18,1237789795,1237789904,3,4,109
7888746@N08,3992,14,1237849640,1237873404,30,1,23764
78897418@N00,3993,9,1184194969,1184194969,1,2,0
78897418@N00,3993,29,1184193551,1184193994,3,2,443
78976320@N00,3994,14,1357473697,1357473697,1,1,0
79016591@N07,3995,17,1279490164,1279499210,3,1,9046
79016591@N07,3996,19,1279577652,1279577652,1,1,0
79016591@N07,3997,17,1350798136,1350798181,2,1,45
79066497@N00,3998,2,1151991845,1151991845,1,2,0
79066497@N00,3998,24,1151992537,1151992537,1,2,0
79188546@N06,3999,18,1374382172,1374382172,1,1,0
79229619@N00,4000,18,1313826438,1313826455,4,1,17
79229619@N00,4001,1,1314265968,1314265975,2,2,7
79229619@N00,4001,12,1314265982,1314265996,3,2,14
79239302@N00,4002,9,1201834739,1201834739,1,1,0
79239302@N00,4003,12,1356958957,1356958957,1,1,0
79239302@N00,4004,9,1366679428,1366679428,1,1,0
79239302@N00,4005,11,1388395993,1388395993,1,1,0
7928282@N08,4006,1,1145069753,1145078372,3,1,8619
7928282@N08,4007,1,1187232591,1187232591,1,1,0
79295762@N00,4008,9,1287640786,1287640786,1,1,0
79295762@N00,4009,1,1287713134,1287713134,1,1,0
79295762@N00,4010,9,1287806141,1287806141,1,3,0
79295762@N00,4010,19,1287814554,1287814554,1,3,0
79295762@N00,4010,29,1287799902,1287799902,1,3,0
7929654@N05,4011,3,1315626154,1315626708,3,6,554
7929654@N05,4011,4,1315640502,1315640502,1,6,0
7929654@N05,4011,7,1315646218,1315649466,4,6,3248
7929654@N05,4011,10,1315660263,1315660263,1,6,0
7929654@N05,4011,11,1315660534,1315660534,1,6,0
7929654@N05,4011,23,1315658648,1315660945,2,6,2297
7929654@N05,4012,2,1316249599,1316249669,3,5,70
7929654@N05,4012,4,1316249201,1316249864,6,5,663
7929654@N05,4012,8,1316251742,1316251756,2,5,14
7929654@N05,4012,9,1316246553,1316251295,11,5,4742
7929654@N05,4012,18,1316252298,1316252298,1,5,0
7929654@N05,4013,20,1316850100,1316851006,14,1,906
7929654@N05,4014,9,1319878542,1319878542,1,1,0
79335735@N06,4015,20,1336181244,1336184509,28,1,3265
79335735@N06,4016,15,1338861862,1338861907,3,2,45
79335735@N06,4016,18,1338861176,1338861862,7,2,686
79335735@N06,4017,10,1349340866,1349340883,2,2,17
79335735@N06,4017,23,1349341214,1349341214,1,2,0
79335735@N06,4018,10,1349851835,1349851835,1,1,0
79335735@N06,4019,10,1365657834,1365658172,2,2,338
79335735@N06,4019,11,1365658601,1365658601,1,2,0
79335735@N06,4020,8,1366695701,1366695701,1,3,0
79335735@N06,4020,15,1366696187,1366696504,3,3,317
79335735@N06,4020,16,1366695921,1366695921,1,3,0
79335735@N06,4021,20,1366773119,1366773119,1,1,0
79335735@N06,4022,29,1386055874,1386056320,4,1,446
79428370@N05,4023,15,1326085081,1326085081,1,1,0
7943031@N07,4024,29,1281352601,1281352601,1,1,0
7946624@N03,4025,1,1358485706,1358485706,1,1,0
7946624@N03,4026,1,1358556618,1358556663,2,1,45
7946624@N03,4027,2,1358643332,1358644302,2,2,970
7946624@N03,4027,18,1358640655,1358641156,5,2,501
79483207@N00,4028,9,1345933955,1345933955,1,2,0
79483207@N00,4028,18,1345933816,1345933816,1,2,0
79578508@N08,4029,19,1355833480,1355833480,1,1,0
79578508@N08,4030,15,1360648114,1360648114,1,1,0
7958312@N08,4031,1,1183599200,1183611009,18,5,11809
7958312@N08,4031,8,1183596019,1183596104,3,5,85
7958312@N08,4031,9,1183610485,1183610485,1,5,0
7958312@N08,4031,15,1183596391,1183596416,3,5,25
7958312@N08,4031,29,1183597661,1183610912,23,5,13251
7958312@N08,4032,8,1183861569,1183862063,8,1,494
79624226@N00,4033,1,1352426542,1352429410,2,1,2868
79669883@N05,4034,3,1361529492,1361529492,1,1,0
79716843@N00,4035,8,1287881419,1287881419,1,1,0
7974576@N06,4036,18,1260423811,1260423811,1,1,0
7974576@N06,4037,2,1368942693,1368942693,1,2,0
7974576@N06,4037,24,1368937938,1368941047,16,2,3109
79792940@N00,4038,8,1224379995,1224380539,2,1,544
7980118@N03,4039,29,1177265068,1177265068,1,1,0
79981524@N03,4040,1,1341693358,1341699077,35,1,5719
79981524@N03,4041,3,1341876794,1341883520,15,1,6726
79981524@N03,4042,3,1342151195,1342152311,40,1,1116
80021819@N00,4043,1,1340853094,1340853223,3,6,129
80021819@N00,4043,2,1340845820,1340845820,1,6,0
80021819@N00,4043,4,1340845123,1340845275,4,6,152
80021819@N00,4043,9,1340852048,1340852546,3,6,498
80021819@N00,4043,16,1340843965,1340844136,4,6,171
80021819@N00,4043,17,1340851914,1340851914,1,6,0
80021819@N00,4044,10,1341034876,1341035059,2,3,183
80021819@N00,4044,11,1341035355,1341035816,7,3,461
80021819@N00,4044,23,1341036090,1341036090,1,3,0
80021819@N00,4045,7,1341082160,1341100365,8,1,18205
80052783@N00,4046,1,1216352627,1216352906,6,7,279
80052783@N00,4046,2,1216357049,1216357339,3,7,290
80052783@N00,4046,4,1216356809,1216356886,2,7,77
80052783@N00,4046,9,1216351457,1216353657,7,7,2200
80052783@N00,4046,19,1216350848,1216350848,1,7,0
80052783@N00,4046,23,1216357973,1216357997,2,7,24
80052783@N00,4046,29,1216352157,1216352226,2,7,69
80156731@N00,4047,28,1156057525,1156059925,9,1,2400
80156731@N00,4048,28,1156178491,1156178491,1,1,0
80156731@N00,4049,28,1157168585,1157168592,4,1,7
80156731@N00,4050,28,1186213655,1186213655,1,1,0
80246494@N00,4051,1,1230056946,1230057317,2,5,371
80246494@N00,4051,2,1230070522,1230071718,3,5,1196
80246494@N00,4051,4,1230071544,1230071852,2,5,308
80246494@N00,4051,23,1230072319,1230072319,1,5,0
80246494@N00,4051,29,1230058196,1230058196,1,5,0
80424201@N00,4052,3,1183527846,1183527846,1,1,0
8043663@N04,4053,1,1278810504,1278810504,1,4,0
8043663@N04,4053,11,1278823666,1278823666,1,4,0
8043663@N04,4053,15,1278829686,1278829686,1,4,0
8043663@N04,4053,18,1278831273,1278831273,1,4,0
80459729@N00,4054,3,1375677314,1375677314,1,1,0
80459729@N00,4055,29,1378541678,1378541678,1,1,0
80459729@N00,4056,12,1384773747,1384773830,2,1,83
80459729@N00,4057,20,1385269955,1385269955,1,1,0
80459729@N00,4058,29,1385329674,1385329674,1,1,0
80459729@N00,4059,16,1388809381,1388809381,1,1,0
80459729@N00,4060,29,1388925569,1388925569,1,1,0
80459729@N00,4061,3,1389533380,1389533380,1,1,0
80459729@N00,4062,12,1389880699,1389880699,1,1,0
80459729@N00,4063,18,1390469813,1390469813,1,1,0
80459729@N00,4064,15,1391395339,1391395339,1,1,0
8057454@N06,4065,3,1226882804,1226882816,2,3,12
8057454@N06,4065,9,1226880822,1226881048,3,3,226
8057454@N06,4065,29,1226891962,1226893796,3,3,1834
8057454@N06,4066,2,1226980392,1226980392,1,5,0
8057454@N06,4066,4,1226978691,1226980779,4,5,2088
8057454@N06,4066,11,1226970081,1226970164,2,5,83
8057454@N06,4066,19,1226971256,1226971256,1,5,0
8057454@N06,4066,23,1226968027,1226968027,1,5,0
8057454@N06,4067,3,1227055684,1227059798,10,2,4114
8057454@N06,4067,9,1227055472,1227067922,3,2,12450
8057454@N06,4068,1,1227139176,1227140861,2,1,1685
8059995@N02,4069,28,1248699219,1248701202,37,1,1983
8060457@N02,4070,29,1256464312,1256464312,1,1,0
80649505@N08,4071,1,1372907971,1372915089,4,3,7118
80649505@N08,4071,7,1372924538,1372926396,4,3,1858
80649505@N08,4071,24,1372922836,1372922836,1,3,0
80675016@N00,4072,7,1375771670,1375774298,8,1,2628
8087020@N07,4073,12,1148487571,1148487611,3,1,40
8087020@N07,4074,12,1149862030,1149864280,5,1,2250
8087020@N07,4075,12,1167539417,1167539417,1,2,0
8087020@N07,4075,14,1167540444,1167540539,2,2,95
8087020@N07,4076,13,1173337388,1173337418,2,1,30
8087020@N07,4077,14,1178690546,1178690579,3,1,33
8087020@N07,4078,12,1185705220,1185705220,1,2,0
8087020@N07,4078,13,1185695912,1185695912,1,2,0
8095059@N02,4079,29,1224991894,1224991894,1,1,0
8095506@N07,4080,1,1216081685,1216089128,39,7,7443
8095506@N07,4080,8,1216082470,1216082480,2,7,10
8095506@N07,4080,9,1216082324,1216082365,2,7,41
8095506@N07,4080,12,1216080589,1216080604,2,7,15
8095506@N07,4080,15,1216082557,1216082609,3,7,52
8095506@N07,4080,18,1216082691,1216083368,12,7,677
8095506@N07,4080,29,1216082154,1216082246,3,7,92
80975088@N00,4081,8,1088604000,1088604006,7,1,6
80975088@N00,4082,8,1088863207,1088863208,2,1,1
80997939@N00,4083,1,1157852339,1157852564,3,3,225
80997939@N00,4083,9,1157856735,1157860867,9,3,4132
80997939@N00,4083,17,1157853259,1157853289,2,3,30
81004917@N00,4084,2,1304562576,1304562576,1,1,0
81004917@N00,4085,8,1333090005,1333090005,1,1,0
81004917@N00,4086,28,1334887534,1334888727,2,1,1193
8110030@N05,4087,2,1212919661,1212919661,1,10,0
8110030@N05,4087,7,1212916681,1212918412,22,10,1731
8110030@N05,4087,9,1212885694,1212931353,6,10,45659
8110030@N05,4087,10,1212888941,1212889532,3,10,591
8110030@N05,4087,11,1212887941,1212888715,4,10,774
8110030@N05,4087,15,1212930697,1212930739,2,10,42
8110030@N05,4087,16,1212929948,1212929982,2,10,34
8110030@N05,4087,19,1212887115,1212928813,3,10,41698
8110030@N05,4087,23,1212887777,1212887777,1,10,0
8110030@N05,4087,29,1212885482,1212885482,1,10,0
8110030@N05,4088,15,1212971860,1212971860,1,1,0
8115132@N06,4089,29,1288329650,1288329650,1,1,0
81257638@N00,4090,7,1121140234,1121140234,1,1,0
81257638@N00,4091,7,1121225875,1121229265,25,1,3390
81275975@N00,4092,9,1378809387,1378809387,1,1,0
81275975@N00,4093,8,1378881633,1378881935,2,2,302
81275975@N00,4093,9,1378874484,1378874484,1,2,0
8127640@N06,4094,2,1369507196,1369507220,2,2,24
8127640@N06,4094,23,1369500194,1369500194,1,2,0
81311832@N00,4095,1,1315012079,1315018176,13,3,6097
81311832@N00,4095,19,1314999027,1314999027,1,3,0
81311832@N00,4095,29,1315010488,1315019645,2,3,9157
81311832@N00,4096,15,1315049965,1315049965,1,1,0
81311832@N00,4097,2,1315101673,1315101673,1,2,0
81311832@N00,4097,4,1315104060,1315104060,1,2,0
81311832@N00,4098,9,1333961774,1333961774,1,1,0
81395338@N00,4099,3,1015131273,1015131273,1,1,0
81395338@N00,4100,14,1027492979,1027492979,1,1,0
81395338@N00,4101,1,1145673778,1145673778,1,1,0
81395338@N00,4102,19,1164433117,1164433117,1,1,0
81395338@N00,4103,29,1218971136,1218974262,29,1,3126
81395338@N00,4104,4,1230986476,1230986476,1,1,0
81395338@N00,4105,24,1241941626,1241942608,5,1,982
81395338@N00,4106,9,1271365344,1271365344,1,1,0
81395338@N00,4107,28,1357967475,1357967475,1,1,0
81397230@N00,4108,3,1317523896,1317525817,4,4,1921
81397230@N00,4108,9,1317515624,1317516317,2,4,693
81397230@N00,4108,15,1317527179,1317527179,1,4,0
81397230@N00,4108,29,1317517531,1317517531,1,4,0
81397230@N00,4109,11,1317673429,1317673429,1,1,0
81506496@N00,4110,1,1123360620,1123360620,1,1,0
81506496@N00,4111,23,1124096037,1124096037,1,1,0
81521569@N00,4112,8,1306307982,1306307982,1,1,0
8160642@N02,4113,2,1253262283,1253262283,1,1,0
81653261@N00,4114,9,1309838484,1309838484,1,2,0
81653261@N00,4114,18,1309833109,1309834441,2,2,1332
81653261@N00,4115,18,1309937451,1309937451,1,2,0
81653261@N00,4115,29,1309936157,1309936157,1,2,0
81653261@N00,4116,1,1310035800,1310035800,1,2,0
81653261@N00,4116,29,1310036513,1310036513,1,2,0
81719291@N00,4117,10,1208679759,1208680984,12,3,1225
81719291@N00,4117,11,1208680107,1208680408,5,3,301
81719291@N00,4117,23,1208679898,1208680009,5,3,111
81719291@N00,4118,11,1208789505,1208789769,2,1,264
81795065@N00,4119,3,1214527819,1214530230,3,1,2411
81795065@N00,4120,10,1224822500,1224823632,8,3,1132
81795065@N00,4120,11,1224822890,1224824309,11,3,1419
81795065@N00,4120,23,1224819712,1224825137,7,3,5425
81813159@N00,4121,28,1096111313,1096111313,1,1,0
81813159@N00,4122,28,1101734262,1101735518,4,1,1256
81813159@N00,4123,29,1122084516,1122087220,2,1,2704
81813159@N00,4124,13,1164457269,1164457269,1,1,0
81813159@N00,4125,13,1164682305,1164682305,1,1,0
81813159@N00,4126,8,1165370175,1165370175,1,2,0
81813159@N00,4126,18,1165369168,1165369703,2,2,535
81813159@N00,4127,13,1313478923,1313478923,1,1,0
81867054@N00,4128,7,1268284474,1268284474,1,1,0
81867054@N00,4129,18,1271043093,1271043104,2,1,11
81977592@N00,4130,28,1186306588,1186306588,1,1,0
82027065@N00,4131,23,1338104892,1338104892,1,1,0
8208003@N04,4132,22,1222298409,1222298409,1,1,0
82081676@N00,4133,28,1362795201,1362795221,2,1,20
82103247@N00,4134,9,1343097013,1343097013,1,1,0
82103247@N00,4135,21,1366531486,1366538111,4,1,6625
82103247@N00,4136,20,1370671763,1370672593,5,1,830
8214325@N07,4137,4,1249260971,1249274877,5,1,13906
8214325@N07,4138,2,1249368279,1249369715,3,2,1436
8214325@N07,4138,4,1249361610,1249370331,4,2,8721
8214325@N07,4139,1,1249440195,1249441134,2,1,939
8214325@N07,4140,4,1249694417,1249694417,1,1,0
8214325@N07,4141,1,1249728677,1249729181,3,1,504
8214325@N07,4142,29,1249791886,1249791886,1,1,0
8215861@N07,4143,7,1372838889,1372838889,1,1,0
82251431@N00,4144,13,1378005305,1378005332,2,1,27
82482569@N00,4145,20,1146361381,1146362882,5,1,1501
82482569@N00,4146,29,1156063106,1156063315,3,1,209
82482569@N00,4147,27,1196490138,1196490138,1,1,0
82482569@N00,4148,3,1197457550,1197457640,2,2,90
82482569@N00,4148,19,1197460822,1197460822,1,2,0
82482569@N00,4149,9,1202893662,1202893662,1,2,0
82482569@N00,4149,17,1202893667,1202893667,1,2,0
82508858@N00,4150,18,1114365082,1114365082,1,1,0
82619366@N00,4151,18,1156668436,1156679093,8,1,10657
82643656@N00,4152,29,1180766403,1180766403,1,1,0
82684837@N04,4153,9,1333962742,1333971027,2,1,8285
82684837@N04,4154,1,1334467922,1334467922,1,1,0
8286908@N02,4155,1,1279160041,1279160041,1,3,0
8286908@N02,4155,8,1279152152,1279152152,1,3,0
8286908@N02,4155,19,1279152225,1279152225,1,3,0
82976024@N00,4156,1,1278572296,1278572312,2,1,16
8308954@N06,4157,1,1376280610,1376305668,3,3,25058
8308954@N06,4157,9,1376287749,1376288188,2,3,439
8308954@N06,4157,12,1376292031,1376292031,1,3,0
83215505@N00,4158,9,1282359268,1282363527,6,2,4259
83215505@N00,4158,28,1282369888,1282370832,4,2,944
83215505@N00,4159,9,1282444162,1282444162,1,1,0
8326485@N06,4160,1,1287718171,1287718171,1,6,0
8326485@N06,4160,3,1287709643,1287712002,6,6,2359
8326485@N06,4160,4,1287720955,1287720955,1,6,0
8326485@N06,4160,9,1287718703,1287718703,1,6,0
8326485@N06,4160,23,1287702725,1287702725,1,6,0
8326485@N06,4160,29,1287717011,1287717011,1,6,0
8328114@N02,4161,1,1276241587,1276241587,1,4,0
8328114@N02,4161,8,1276243435,1276243435,1,4,0
8328114@N02,4161,16,1276242967,1276244539,5,4,1572
8328114@N02,4161,29,1276244582,1276244582,1,4,0
8328114@N02,4162,8,1276940241,1276940241,1,3,0
8328114@N02,4162,16,1276940398,1276940398,1,3,0
8328114@N02,4162,29,1276940193,1276940193,1,3,0
83308875@N00,4163,10,1276068693,1276068693,1,1,0
83308875@N00,4164,8,1346751614,1346751866,2,5,252
83308875@N00,4164,15,1346752507,1346752669,2,5,162
83308875@N00,4164,16,1346752240,1346752240,1,5,0
83308875@N00,4164,19,1346752354,1346752354,1,5,0
83308875@N00,4164,29,1346752603,1346752603,1,5,0
83308875@N00,4165,3,1346832431,1346832592,3,7,161
83308875@N00,4165,9,1346821812,1346826926,18,7,5114
83308875@N00,4165,10,1346809549,1346811439,7,7,1890
83308875@N00,4165,11,1346810400,1346810468,2,7,68
83308875@N00,4165,17,1346823810,1346823810,1,7,0
83308875@N00,4165,19,1346812704,1346818936,2,7,6232
83308875@N00,4165,23,1346811966,1346812592,2,7,626
83432431@N00,4166,1,1255479955,1255483936,4,2,3981
83432431@N00,4166,8,1255496884,1255496884,1,2,0
8349002@N04,4167,9,1189965372,1189965619,6,1,247
8349002@N04,4168,1,1190030494,1190040251,15,8,9757
8349002@N04,4168,2,1190044459,1190044459,1,8,0
8349002@N04,4168,4,1190044172,1190044597,8,8,425
8349002@N04,4168,8,1190027867,1190027985,4,8,118
8349002@N04,4168,15,1190021432,1190022072,3,8,640
8349002@N04,4168,18,1190021037,1190021037,1,8,0
8349002@N04,4168,19,1190045850,1190045850,1,8,0
8349002@N04,4168,29,1190040835,1190040854,2,8,19
83511002@N00,4169,7,1374193604,1374193604,1,4,0
83511002@N00,4169,11,1374203398,1374203398,1,4,0
83511002@N00,4169,15,1374207087,1374207087,1,4,0
83511002@N00,4169,23,1374202568,1374202568,1,4,0
83511002@N00,4170,15,1375425836,1375425957,2,1,121
83514819@N00,4171,1,1185703863,1185704034,3,2,171
83514819@N00,4171,29,1185703922,1185703922,1,2,0
83808396@N00,4172,12,1344398188,1344398188,1,1,0
8389569@N08,4173,8,1319609431,1319609431,1,5,0
8389569@N08,4173,9,1319606417,1319609597,2,5,3180
8389569@N08,4173,10,1319609587,1319609587,1,5,0
8389569@N08,4173,17,1319606445,1319606445,1,5,0
8389569@N08,4173,29,1319606480,1319615064,17,5,8584
8389569@N08,4174,1,1319669958,1319678256,4,13,8298
8389569@N08,4174,2,1319682106,1319682106,1,13,0
8389569@N08,4174,4,1319682133,1319682133,1,13,0
8389569@N08,4174,8,1319679285,1319684433,8,13,5148
8389569@N08,4174,9,1319669499,1319669541,3,13,42
8389569@N08,4174,10,1319681042,1319681333,2,13,291
8389569@N08,4174,11,1319682281,1319682289,2,13,8
8389569@N08,4174,15,1319680036,1319680066,3,13,30
8389569@N08,4174,16,1319679208,1319679208,1,13,0
8389569@N08,4174,19,1319680157,1319680199,2,13,42
8389569@N08,4174,23,1319682413,1319682413,1,13,0
8389569@N08,4174,28,1319668329,1319668329,1,13,0
8389569@N08,4174,29,1319680103,1319708925,2,13,28822
8389569@N08,4175,1,1319780403,1319781241,3,9,838
8389569@N08,4175,2,1319757092,1319763873,24,9,6781
8389569@N08,4175,4,1319756508,1319771838,4,9,15330
8389569@N08,4175,8,1319780655,1319780655,1,9,0
8389569@N08,4175,10,1319755835,1319755835,1,9,0
8389569@N08,4175,11,1319756312,1319756312,1,9,0
8389569@N08,4175,16,1319780614,1319780614,1,9,0
8389569@N08,4175,18,1319781008,1319781008,1,9,0
8389569@N08,4175,29,1319780279,1319780279,1,9,0
8389569@N08,4176,9,1319843964,1319855907,2,3,11943
8389569@N08,4176,10,1319843645,1319843645,1,3,0
8389569@N08,4176,19,1319843760,1319843760,1,3,0
8391678@N07,4177,9,1062784135,1062784135,1,1,0
8391678@N07,4178,22,1116987907,1116987907,1,1,0
8391678@N07,4179,29,1174541944,1174541944,1,1,0
84035351@N00,4180,1,1146259738,1146266982,7,4,7244
84035351@N00,4180,9,1146285496,1146285496,1,4,0
84035351@N00,4180,18,1146283751,1146283751,1,4,0
84035351@N00,4180,29,1146258192,1146258259,2,4,67
84035351@N00,4181,9,1146346824,1146347090,3,3,266
84035351@N00,4181,10,1146363406,1146370827,7,3,7421
84035351@N00,4181,17,1146342482,1146342482,1,3,0
84035351@N00,4182,1,1147565947,1147565947,1,1,0
84041989@N00,4183,15,1092286562,1092286562,1,1,0
84041989@N00,4184,8,1092358899,1092358904,2,1,5
84041989@N00,4185,3,1177975066,1177989260,5,1,14194
84041989@N00,4186,19,1253750745,1253750763,2,1,18
84041989@N00,4187,15,1253839942,1253839942,1,1,0
84041989@N00,4188,18,1254228025,1254228025,1,1,0
84041989@N00,4189,18,1254808295,1254808295,1,1,0
84041989@N00,4190,8,1256351613,1256351613,1,1,0
8404368@N04,4191,19,1370512420,1370512420,1,1,0
84129012@N00,4192,29,1247032597,1247052508,3,1,19911
84129012@N00,4193,29,1247122651,1247134857,3,1,12206
84129012@N00,4194,29,1247365676,1247368966,3,1,3290
84276425@N00,4195,18,1175853173,1175853646,3,1,473
84276425@N00,4196,3,1175931528,1175931528,1,6,0
84276425@N00,4196,4,1175926931,1175927972,5,6,1041
84276425@N00,4196,9,1175922908,1175926020,7,6,3112
84276425@N00,4196,10,1175928769,1175930541,9,6,1772
84276425@N00,4196,18,1175911091,1175913118,15,6,2027
84276425@N00,4196,29,1175913434,1175922700,27,6,9266
84276425@N00,4197,3,1176001808,1176003980,14,8,2172
84276425@N00,4197,9,1176000774,1176000839,3,8,65
84276425@N00,4197,15,1176009808,1176010132,5,8,324
84276425@N00,4197,17,1176001591,1176001591,1,8,0
84276425@N00,4197,18,1176033440,1176033516,3,8,76
84276425@N00,4197,22,1176026132,1176036403,5,8,10271
84276425@N00,4197,28,1176004465,1176007742,6,8,3277
84276425@N00,4197,29,1176000237,1176000561,4,8,324
84337607@N00,4198,29,1356959049,1356959189,3,1,140
84337607@N00,4199,1,1363917771,1363917771,1,1,0
84337607@N00,4200,5,1369962396,1369962396,1,1,0
84337607@N00,4201,7,1388033665,1388033665,1,1,0
84338502@N00,4202,1,1350804128,1350804128,1,2,0
84338502@N00,4202,29,1350801687,1350801918,2,2,231
84338502@N00,4203,12,1351232953,1351232953,1,1,0
84371026@N00,4204,1,1228528603,1228528603,1,1,0
84435494@N00,4205,9,1252714276,1252741333,3,2,27057
84435494@N00,4205,17,1252717268,1252746674,2,2,29406
8452611@N05,4206,1,1161911110,1161911110,1,1,0
84527803@N00,4207,9,1167649379,1167649379,1,1,0
84527803@N00,4208,29,1169979450,1169979450,1,1,0
84527803@N00,4209,17,1170266734,1170266734,1,1,0
84533614@N00,4210,10,1342838152,1342838584,3,3,432
84533614@N00,4210,13,1342855916,1342855916,1,3,0
84533614@N00,4210,23,1342839895,1342839895,1,3,0
84533614@N00,4211,20,1342916714,1342918493,2,1,1779
84533614@N00,4212,3,1343017803,1343017803,1,3,0
84533614@N00,4212,28,1343015320,1343015442,4,3,122
84533614@N00,4212,29,1343008509,1343008509,1,3,0
84533614@N00,4213,7,1343094491,1343095434,2,5,943
84533614@N00,4213,8,1343114864,1343115201,3,5,337
84533614@N00,4213,9,1343111948,1343112167,2,5,219
84533614@N00,4213,15,1343113532,1343113532,1,5,0
84533614@N00,4213,19,1343116825,1343116825,1,5,0
8469032@N04,4214,8,1354251009,1354251782,2,1,773
84771460@N00,4215,1,1307590730,1307590730,1,1,0
84771460@N00,4216,23,1307666799,1307666799,1,1,0
84901326@N00,4217,9,1343006454,1343010172,4,2,3718
84901326@N00,4217,29,1343009088,1343009088,1,2,0
84938488@N02,4218,3,1285461575,1285461980,4,1,405
84989911@N00,4219,1,1369931350,1369931803,4,9,453
84989911@N00,4219,2,1369941059,1369946975,2,9,5916
84989911@N00,4219,4,1369937307,1369947870,4,9,10563
84989911@N00,4219,9,1369933655,1369935806,8,9,2151
84989911@N00,4219,17,1369951927,1369951927,1,9,0
84989911@N00,4219,18,1369971090,1369971357,3,9,267
84989911@N00,4219,19,1369938495,1369939945,2,9,1450
84989911@N00,4219,23,1369938114,1369938244,2,9,130
84989911@N00,4219,29,1369931927,1369953420,11,9,21493
84989911@N00,4220,1,1370019108,1370028544,21,7,9436
84989911@N00,4220,3,1370030676,1370054622,16,7,23946
84989911@N00,4220,4,1370042707,1370047059,20,7,4352
84989911@N00,4220,16,1370020925,1370020925,1,7,0
84989911@N00,4220,17,1370016927,1370016927,1,7,0
84989911@N00,4220,28,1370017184,1370017184,1,7,0
84989911@N00,4220,29,1370018825,1370018987,2,7,162
8503026@N04,4221,1,1281668673,1281673583,9,4,4910
8503026@N04,4221,9,1281665279,1281665279,1,4,0
8503026@N04,4221,15,1281676822,1281676846,2,4,24
8503026@N04,4221,29,1281666251,1281666251,1,4,0
85111818@N00,4222,3,1362270852,1362272955,4,2,2103
85111818@N00,4222,29,1362267844,1362269725,3,2,1881
85144188@N00,4223,1,1199106000,1199106000,1,1,0
8515976@N05,4224,3,1180748533,1180748533,1,1,0
85171719@N00,4225,1,1251554049,1251554049,1,1,0
8520591@N03,4226,9,1247370980,1247371152,2,2,172
8520591@N03,4226,24,1247376832,1247376832,1,2,0
8520591@N03,4227,9,1247496062,1247496062,1,5,0
8520591@N03,4227,19,1247493702,1247493702,1,5,0
8520591@N03,4227,22,1247465517,1247465517,1,5,0
8520591@N03,4227,28,1247461015,1247461015,1,5,0
8520591@N03,4227,29,1247495469,1247495469,1,5,0
8520591@N03,4228,23,1247560068,1247560068,1,1,0
85217508@N00,4229,1,1250912015,1250921297,7,5,9282
85217508@N00,4229,9,1250908694,1250908715,2,5,21
85217508@N00,4229,15,1250903601,1250903601,1,5,0
85217508@N00,4229,19,1250907656,1250907656,1,5,0
85217508@N00,4229,29,1250909649,1250922696,3,5,13047
85217508@N00,4230,9,1251067179,1251067279,3,2,100
85217508@N00,4230,29,1251067494,1251068463,3,2,969
85217508@N00,4231,9,1251113443,1251113495,2,1,52
85217508@N00,4232,11,1251193014,1251193382,4,3,368
85217508@N00,4232,19,1251192768,1251192768,1,3,0
85217508@N00,4232,23,1251192985,1251192985,1,3,0
85318305@N00,4233,8,1291195611,1291195611,1,1,0
85318305@N00,4234,3,1375590273,1375617328,7,2,27055
85318305@N00,4234,13,1375606489,1375608137,2,2,1648
85318305@N00,4235,1,1375676072,1375679403,2,8,3331
85318305@N00,4235,3,1375695310,1375707544,5,8,12234
85318305@N00,4235,9,1375678508,1375678515,2,8,7
85318305@N00,4235,13,1375699964,1375700363,5,8,399
85318305@N00,4235,16,1375680344,1375680344,1,8,0
85318305@N00,4235,17,1375678665,1375678665,1,8,0
85318305@N00,4235,19,1375679575,1375679575,1,8,0
85318305@N00,4235,29,1375667523,1375682989,8,8,15466
85318305@N00,4236,3,1375766148,1375878941,14,7,112793
85318305@N00,4236,9,1375764605,1375764701,4,7,96
85318305@N00,4236,12,1375761288,1375762913,5,7,1625
85318305@N00,4236,13,1375766051,1375864906,33,7,98855
85318305@N00,4236,17,1375872618,1375872618,1,7,0
85318305@N00,4236,19,1375815555,1375815722,3,7,167
85318305@N00,4236,28,1375765997,1375801041,3,7,35044
85397137@N00,4237,11,1345612633,1345612633,1,1,0
85397137@N00,4238,11,1356958846,1356959266,10,2,420
85397137@N00,4238,23,1356960286,1356960305,2,2,19
85603833@N00,4239,10,1283076552,1283076995,2,3,443
85603833@N00,4239,23,1283075397,1283075397,1,3,0
85603833@N00,4239,28,1283072899,1283072899,1,3,0
8566146@N04,4240,9,1230760193,1230760193,1,1,0
85756708@N07,4241,7,1339302713,1339302713,1,1,0
8590701@N06,4242,1,1245628556,1245632918,7,6,4362
8590701@N06,4242,4,1245652650,1245655167,15,6,2517
8590701@N06,4242,8,1245646338,1245646338,1,6,0
8590701@N06,4242,9,1245637461,1245649471,10,6,12010
8590701@N06,4242,19,1245658270,1245658761,4,6,491
8590701@N06,4242,29,1245625297,1245647978,12,6,22681
8590701@N06,4243,8,1245739354,1245739752,4,2,398
8590701@N06,4243,19,1245738867,1245739171,5,2,304
8616953@N04,4244,19,1262772977,1262773006,3,1,29
86174736@N00,4245,11,1396949323,1396949323,1,1,0
86176561@N00,4246,8,1114754797,1114754797,1,1,0
86176561@N00,4247,20,1115008823,1115011879,13,1,3056
86176561@N00,4248,8,1116556582,1116558519,11,1,1937
86176561@N00,4249,8,1118199935,1118199935,1,1,0
86176561@N00,4250,20,1119413740,1119416640,14,1,2900
86176561@N00,4251,8,1120875538,1120877213,7,1,1675
86176561@N00,4252,20,1122180731,1122188606,12,1,7875
86176561@N00,4253,20,1122872652,1122879380,8,1,6728
86176561@N00,4254,20,1129957269,1129957894,3,1,625
86176561@N00,4255,20,1131848230,1131855092,34,1,6862
86176561@N00,4256,8,1134611679,1134611899,3,1,220
86176561@N00,4257,18,1135914049,1135915079,7,1,1030
86176561@N00,4258,18,1136345904,1136347591,16,1,1687
86176561@N00,4259,8,1136598825,1136599163,4,1,338
86176561@N00,4260,20,1137293074,1137297142,6,1,4068
86176561@N00,4261,19,1138260213,1138260213,1,1,0
86176561@N00,4262,8,1140149675,1140149675,1,1,0
86176561@N00,4263,20,1140919285,1140919285,1,1,0
86176561@N00,4264,20,1145156069,1145156069,1,1,0
86176561@N00,4265,20,1149302463,1149305079,5,1,2616
86176561@N00,4266,20,1150010583,1150015220,8,1,4637
86176561@N00,4267,8,1152827881,1152827881,1,1,0
86176561@N00,4268,20,1158385675,1158385675,1,1,0
86176561@N00,4269,3,1160637197,1160637197,1,1,0
86176561@N00,4270,20,1162701957,1162703906,8,1,1949
86176561@N00,4271,15,1166940268,1166943853,13,2,3585
86176561@N00,4271,16,1166944516,1166944516,1,2,0
86176561@N00,4272,18,1167450949,1167450949,1,1,0
86262655@N00,4273,9,1319529098,1319529098,1,1,0
86262655@N00,4274,1,1319595484,1319595484,1,1,0
86262655@N00,4275,9,1319625020,1319626394,2,1,1374
86262655@N00,4276,4,1319693733,1319693733,1,2,0
86262655@N00,4276,24,1319693596,1319693596,1,2,0
86401769@N00,4277,1,1217922660,1217922660,1,4,0
86401769@N00,4277,2,1217935740,1217936460,3,4,720
86401769@N00,4277,15,1217946180,1217946180,1,4,0
86401769@N00,4277,29,1217924880,1217924880,1,4,0
86401769@N00,4278,9,1218218944,1218218944,1,2,0
86401769@N00,4278,17,1218218429,1218218429,1,2,0
86424983@N00,4279,29,1188726333,1188726333,1,1,0
86424983@N00,4280,1,1281672693,1281672693,1,1,0
86424983@N00,4281,1,1282124905,1282124905,1,1,0
86424983@N00,4282,4,1301602004,1301602004,1,1,0
86424983@N00,4283,24,1302563971,1302563971,1,1,0
86424983@N00,4284,20,1331908452,1331908452,1,1,0
86424983@N00,4285,29,1343717292,1343717292,1,1,0
86424983@N00,4286,29,1344509900,1344509900,1,1,0
86533211@N00,4287,4,1219562159,1219562159,1,5,0
86533211@N00,4287,17,1219551728,1219553422,2,5,1694
86533211@N00,4287,18,1219547567,1219547567,1,5,0
86533211@N00,4287,19,1219565954,1219565954,1,5,0
86533211@N00,4287,24,1219558844,1219558844,1,5,0
86533211@N00,4288,11,1233147382,1233147382,1,1,0
86533211@N00,4289,11,1239722815,1239722815,1,1,0
86533211@N00,4290,16,1277032998,1277032998,1,1,0
86537625@N00,4291,1,1135213218,1135216846,3,1,3628
86752930@N00,4292,8,1187036594,1187036594,1,3,0
86752930@N00,4292,9,1187060634,1187060634,1,3,0
86752930@N00,4292,15,1187036162,1187036162,1,3,0
86765090@N00,4293,4,1280793654,1280793661,2,4,7
86765090@N00,4293,11,1280795272,1280795307,2,4,35
86765090@N00,4293,23,1280795420,1280795420,1,4,0
86765090@N00,4293,24,1280790905,1280790923,2,4,18
8684258@N02,4294,1,1188713908,1188715111,2,1,1203
8684258@N02,4295,1,1188762299,1188795890,5,6,33591
8684258@N02,4295,3,1188773215,1188773834,7,6,619
8684258@N02,4295,9,1188774413,1188774413,1,6,0
8684258@N02,4295,11,1188785512,1188786350,5,6,838
8684258@N02,4295,23,1188785122,1188785122,1,6,0
8684258@N02,4295,29,1188765403,1188795705,18,6,30302
8684258@N02,4296,2,1189207140,1189207140,1,1,0
8701764@N02,4297,1,1186883906,1186884545,5,4,639
8701764@N02,4297,9,1186885258,1186889167,70,4,3909
8701764@N02,4297,15,1186883051,1186883803,10,4,752
8701764@N02,4297,29,1186884682,1186885153,7,4,471
87053269@N00,4298,2,1240629831,1240629951,3,2,120
87053269@N00,4298,3,1240649945,1240649945,1,2,0
87065732@N00,4299,8,1301096969,1301096969,1,2,0
87065732@N00,4299,16,1301069354,1301069354,1,2,0
8719865@N02,4300,1,1154685988,1154685988,1,1,0
87206651@N00,4301,19,1294307217,1294318403,25,1,11186
87206651@N00,4302,19,1294404878,1294429733,3,1,24855
87206651@N00,4303,19,1294493737,1294495030,2,1,1293
87206651@N00,4304,19,1294566468,1294579670,2,1,13202
87285907@N00,4305,1,1204957243,1204957243,1,2,0
87285907@N00,4305,29,1204952754,1204953341,2,2,587
87306906@N00,4306,23,1325235381,1325235579,6,1,198
87306906@N00,4307,8,1325330194,1325330594,2,2,400
87306906@N00,4307,18,1325326980,1325326980,1,2,0
87306906@N00,4308,1,1325381850,1325382833,6,2,983
87306906@N00,4308,15,1325391579,1325391579,1,2,0
87363185@N00,4309,17,1222490270,1222490270,1,2,0
87363185@N00,4309,28,1222488463,1222488791,10,2,328
87363185@N00,4310,15,1290821767,1290822392,2,1,625
87363185@N00,4311,2,1291004910,1291004976,2,1,66
87363185@N00,4312,2,1291090857,1291090857,1,1,0
87363185@N00,4313,15,1291618838,1291619019,2,1,181
87463936@N00,4314,9,1186110483,1186110483,1,2,0
87463936@N00,4314,29,1186105151,1186105482,4,2,331
87586534@N00,4315,19,1349934834,1349934834,1,1,0
87658636@N00,4316,9,1234758240,1234758391,2,3,151
87658636@N00,4316,13,1234753614,1234753614,1,3,0
87658636@N00,4316,29,1234759000,1234759000,1,3,0
87658636@N00,4317,3,1234833490,1234833764,2,2,274
87658636@N00,4317,4,1234835928,1234835928,1,2,0
87658636@N00,4318,3,1236397592,1236397592,1,3,0
87658636@N00,4318,9,1236398477,1236398477,1,3,0
87658636@N00,4318,29,1236397568,1236397568,1,3,0
87661786@N08,4319,11,1337167994,1337167994,1,2,0
87661786@N08,4319,18,1337161634,1337161634,1,2,0
87703047@N00,4320,13,1175688159,1175688330,4,1,171
87703047@N00,4321,13,1175728820,1175771101,27,1,42281
87703047@N00,4322,13,1175816760,1175816760,1,1,0
87703047@N00,4323,13,1310077420,1310107101,17,1,29681
87781873@N00,4324,1,1181804929,1181804929,1,2,0
87781873@N00,4324,12,1181806383,1181806383,1,2,0
87962300@N00,4325,7,1316935586,1316935904,2,1,318
88132889@N00,4326,2,1319320336,1319320336,1,1,0
88178000@N00,4327,8,1380553288,1380553288,1,1,0
88185060@N00,4328,15,1064031820,1064033059,2,1,1239
88185060@N00,4329,4,1086070126,1086070126,1,2,0
88185060@N00,4329,11,1086088617,1086089177,2,2,560
88185060@N00,4330,18,1100321821,1100321821,1,1,0
88185060@N00,4331,11,1110687898,1110687898,1,1,0
88185060@N00,4332,9,1123470880,1123470880,1,1,0
88185060@N00,4333,9,1123573224,1123581058,2,2,7834
88185060@N00,4333,29,1123593956,1123594002,2,2,46
88185060@N00,4334,9,1124005550,1124006210,3,1,660
88185060@N00,4335,1,1124526214,1124526928,2,3,714
88185060@N00,4335,9,1124513544,1124523904,4,3,10360
88185060@N00,4335,14,1124528148,1124528212,2,3,64
88185060@N00,4336,9,1124604844,1124619796,3,1,14952
88185060@N00,4337,9,1125114318,1125118524,7,1,4206
88185060@N00,4338,15,1127532065,1127532885,4,1,820
88185060@N00,4339,29,1130308563,1130321367,5,1,12804
88185060@N00,4340,15,1130562981,1130563352,12,1,371
88185060@N00,4341,15,1131260623,1131260655,2,1,32
88185060@N00,4342,15,1133068577,1133071707,11,1,3130
88185060@N00,4343,15,1133760529,1133760635,4,1,106
88185060@N00,4344,15,1134188005,1134189620,7,1,1615
88185060@N00,4345,15,1135829625,1135833067,8,1,3442
88185060@N00,4346,9,1136185828,1136186818,2,3,990
88185060@N00,4346,12,1136189136,1136189200,2,3,64
88185060@N00,4346,15,1136182202,1136187018,19,3,4816
88185060@N00,4347,1,1136273724,1136274289,2,2,565
88185060@N00,4347,15,1136270342,1136273552,11,2,3210
88185060@N00,4348,1,1139359094,1139367851,25,2,8757
88185060@N00,4348,9,1139368074,1139368536,4,2,462
88185060@N00,4349,3,1139721348,1139724504,12,1,3156
88185060@N00,4350,20,1144815254,1144820284,7,1,5030
88185060@N00,4351,1,1144906737,1144906737,1,1,0
88185060@N00,4352,9,1147489781,1147490289,11,3,508
88185060@N00,4352,15,1147493521,1147495230,13,3,1709
88185060@N00,4352,23,1147492321,1147492682,3,3,361
88185060@N00,4353,9,1147578599,1147579769,6,3,1170
88185060@N00,4353,15,1147584523,1147586109,22,3,1586
88185060@N00,4353,19,1147580895,1147581054,3,3,159
88185060@N00,4354,15,1148106617,1148106622,2,2,5
88185060@N00,4354,18,1148106341,1148107291,10,2,950
88185060@N00,4355,3,1148816206,1148816237,3,4,31
88185060@N00,4355,15,1148816117,1148819659,6,4,3542
88185060@N00,4355,17,1148815702,1148815809,3,4,107
88185060@N00,4355,18,1148808450,1148818803,14,4,10353
88185060@N00,4356,3,1149655344,1149655536,3,3,192
88185060@N00,4356,18,1149661017,1149661782,11,3,765
88185060@N00,4356,19,1149656634,1149656649,2,3,15
88185060@N00,4357,4,1150000488,1150002590,12,4,2102
88185060@N00,4357,9,1150002921,1150002921,1,4,0
88185060@N00,4357,18,1150004823,1150009621,6,4,4798
88185060@N00,4357,24,1150000684,1150002476,13,4,1792
88185060@N00,4358,4,1151118103,1151118103,1,5,0
88185060@N00,4358,11,1151118683,1151118899,5,5,216
88185060@N00,4358,15,1151120715,1151126421,3,5,5706
88185060@N00,4358,23,1151119010,1151119600,11,5,590
88185060@N00,4358,24,1151117695,1151117746,3,5,51
88185060@N00,4359,23,1151292588,1151292588,1,1,0
88185060@N00,4360,15,1153534497,1153538222,13,2,3725
88185060@N00,4360,20,1153541677,1153543614,7,2,1937
88185060@N00,4361,9,1154741964,1154752417,3,1,10453
88185060@N00,4362,9,1154852239,1154853184,8,3,945
88185060@N00,4362,15,1154835503,1154844760,24,3,9257
88185060@N00,4362,29,1154847842,1154854525,2,3,6683
88185060@N00,4363,9,1155444653,1155444653,1,1,0
88185060@N00,4364,9,1155531270,1155531283,2,1,13
88185060@N00,4365,9,1155954114,1155956744,4,1,2630
88185060@N00,4366,9,1156041762,1156060133,8,2,18371
88185060@N00,4366,12,1156048558,1156048558,1,2,0
88185060@N00,4367,9,1156136643,1156139647,6,1,3004
88185060@N00,4368,3,1156560747,1156561045,2,2,298
88185060@N00,4368,9,1156562464,1156564463,2,2,1999
88185060@N00,4369,1,1156650523,1156651270,2,4,747
88185060@N00,4369,3,1156647639,1156647639,1,4,0
88185060@N00,4369,9,1156649913,1156664719,10,4,14806
88185060@N00,4369,11,1156689336,1156689336,1,4,0
88185060@N00,4370,9,1156744308,1156746243,8,2,1935
88185060@N00,4370,17,1156747155,1156747228,4,2,73
88185060@N00,4371,3,1158381477,1158387498,7,1,6021
88185060@N00,4372,18,1159587191,1159587191,1,1,0
88185060@N00,4373,18,1160199240,1160199524,2,1,284
88185060@N00,4374,8,1161929377,1161929534,2,1,157
88185060@N00,4375,9,1174970816,1174970973,2,2,157
88185060@N00,4375,18,1174966929,1174966929,1,2,0
88185060@N00,4376,15,1175920482,1175920490,2,1,8
88185060@N00,4377,20,1176788930,1176790975,13,1,2045
88185060@N00,4378,12,1184377166,1184383814,2,1,6648
88185060@N00,4379,9,1186189920,1186195760,8,1,5840
88185060@N00,4380,9,1186795437,1186802313,10,1,6876
88185060@N00,4381,9,1186886283,1186886898,3,2,615
88185060@N00,4381,17,1186888277,1186888277,1,2,0
88185060@N00,4382,3,1209263257,1209276860,42,1,13603
88185060@N00,4383,3,1209309354,1209311410,2,1,2056
88185060@N00,4384,9,1210390766,1210390766,1,2,0
88185060@N00,4384,15,1210390039,1210390281,4,2,242
88185060@N00,4385,20,1215922939,1215926417,6,1,3478
88185060@N00,4386,9,1217740881,1217744049,5,1,3168
88185060@N00,4387,9,1218344567,1218346458,8,1,1891
88185060@N00,4388,9,1218589638,1218597405,9,1,7767
88185060@N00,4389,9,1218857796,1218858901,3,1,1105
88185060@N00,4390,18,1222486105,1222486403,3,1,298
88185060@N00,4391,15,1259471787,1259471796,2,1,9
88185060@N00,4392,9,1281159411,1281159411,1,1,0
88185060@N00,4393,9,1281675642,1281682270,4,1,6628
88185060@N00,4394,9,1281841136,1281845979,8,1,4843
88185060@N00,4395,9,1282187465,1282188692,2,1,1227
88185060@N00,4396,9,1282453448,1282453448,1,1,0
88185060@N00,4397,9,1283045234,1283045738,2,1,504
88185060@N00,4398,9,1313895240,1313900831,4,1,5591
88209366@N07,4399,1,1373316005,1373326393,2,1,10388
8829172@N02,4400,23,1359364228,1359364228,1,1,0
8833673@N05,4401,10,1379401238,1379401434,3,2,196
8833673@N05,4401,11,1379401023,1379401023,1,2,0
8833673@N05,4402,7,1379639016,1379642801,11,1,3785
88704699@N00,4403,3,1157281943,1157284358,5,1,2415
88704699@N00,4404,17,1158665897,1158666456,2,1,559
88704699@N00,4405,17,1173783415,1173783415,1,1,0
88704699@N00,4406,17,1175250870,1175253022,7,1,2152
88704699@N00,4407,29,1177135498,1177135561,2,1,63
88704699@N00,4408,29,1205744373,1205746016,2,1,1643
88704699@N00,4409,13,1205813288,1205813288,1,2,0
88704699@N00,4409,28,1205819398,1205819398,1,2,0
88704699@N00,4410,13,1238134233,1238134270,2,2,37
88704699@N00,4410,28,1238134482,1238134482,1,2,0
88704699@N00,4411,15,1281697789,1281697789,1,1,0
88704699@N00,4412,3,1291600533,1291600533,1,2,0
88704699@N00,4412,16,1291613536,1291613567,2,2,31
88704699@N00,4413,29,1292741934,1292741934,1,1,0
88704699@N00,4414,3,1311898164,1311898859,4,1,695
88802654@N00,4415,8,1346188539,1346188539,1,1,0
88916285@N00,4416,3,1317086991,1317089245,7,1,2254
8898359@N07,4417,1,1342143298,1342147321,2,1,4023
89182227@N00,4418,3,1258876416,1258876416,1,1,0
89182227@N00,4419,28,1364379452,1364386461,67,1,7009
89187910@N00,4420,8,1270454666,1270454839,7,1,173
89187910@N00,4421,3,1303968189,1303969517,2,4,1328
89187910@N00,4421,9,1303974574,1303974574,1,4,0
89187910@N00,4421,10,1303986051,1303986051,1,4,0
89187910@N00,4421,11,1303954098,1303956004,3,4,1906
89201858@N00,4422,23,1183082661,1183082661,1,1,0
89201858@N00,4423,23,1183129850,1183144082,5,1,14232
89305761@N00,4424,1,1296172724,1296172724,1,2,0
89305761@N00,4424,16,1296170822,1296170822,1,2,0
89305761@N00,4425,11,1296358074,1296358074,1,1,0
8944205@N02,4426,8,978267600,978267600,1,1,0
8944205@N02,4427,8,1172459333,1172459333,1,2,0
8944205@N02,4427,9,1172460761,1172460761,1,2,0
8944205@N02,4428,14,1205473718,1205473718,1,1,0
8944205@N02,4429,3,1213495370,1213495431,2,1,61
8944205@N02,4430,22,1217495344,1217495344,1,1,0
89466603@N00,4431,23,1230728126,1230728920,8,1,794
89466603@N00,4432,23,1230764534,1230765082,3,1,548
89611854@N00,4433,12,1131320693,1131320693,2,1,0
89611854@N00,4434,18,1211168375,1211168375,1,1,0
89611854@N00,4435,12,1219877422,1219877435,2,1,13
89611854@N00,4436,12,1223095525,1223096232,2,1,707
89611854@N00,4437,8,1332398336,1332398336,1,1,0
89611854@N00,4438,22,1345177887,1345177887,1,1,0
89611854@N00,4439,18,1346584048,1346584929,5,1,881
89611854@N00,4440,9,1356681494,1356681494,1,1,0
89611854@N00,4441,20,1358562071,1358563135,3,1,1064
89611854@N00,4442,18,1358639611,1358639632,2,1,21
89611854@N00,4443,29,1366541553,1366541553,1,1,0
89611854@N00,4444,7,1375956535,1375956535,1,1,0
89611854@N00,4445,12,1384763047,1384763047,1,1,0
89611854@N00,4446,29,1385970185,1385970185,1,1,0
89611854@N00,4447,6,1388791707,1388791707,1,1,0
89611854@N00,4448,21,1389406763,1389407336,5,1,573
89611854@N00,4449,12,1394268258,1394268258,1,1,0
89611854@N00,4450,8,1397821028,1397822102,5,1,1074
8961540@N07,4451,8,1348010291,1348010291,1,2,0
8961540@N07,4451,19,1348030085,1348030322,2,2,237
89669379@N00,4452,28,1148712262,1148712262,1,1,0
89669379@N00,4453,9,1208514012,1208514012,1,1,0
89669379@N00,4454,13,1233535756,1233535756,1,1,0
8970099@N04,4455,3,1312951305,1312956504,16,3,5199
8970099@N04,4455,9,1312941669,1312947695,5,3,6026
8970099@N04,4455,17,1312943687,1312943932,2,3,245
8970099@N04,4456,3,1372323553,1372324407,9,4,854
8970099@N04,4456,9,1372322764,1372326251,3,4,3487
8970099@N04,4456,17,1372322996,1372322996,1,4,0
8970099@N04,4456,29,1372318873,1372338222,14,4,19349
8970099@N04,4457,4,1372390343,1372390663,2,6,320
8970099@N04,4457,7,1372385008,1372386513,5,6,1505
8970099@N04,4457,9,1372375684,1372377026,2,6,1342
8970099@N04,4457,10,1372392545,1372392685,3,6,140
8970099@N04,4457,11,1372391194,1372393321,4,6,2127
8970099@N04,4457,23,1372391771,1372392796,4,6,1025
8970099@N04,4458,29,1373693604,1373693604,1,1,0
8970099@N04,4459,29,1376543923,1376543923,1,1,0
89782291@N00,4460,4,1162647098,1162647153,7,1,55
89904893@N00,4461,9,1222414343,1222414343,1,1,0
89904893@N00,4462,9,1222484661,1222484661,1,1,0
89904893@N00,4463,1,1279930560,1279930560,1,2,0
89904893@N00,4463,29,1279948936,1279948936,1,2,0
89904893@N00,4464,2,1280016443,1280019749,6,2,3306
89904893@N00,4464,10,1280034944,1280035196,2,2,252
89904893@N00,4465,3,1335404714,1335404714,1,1,0
89904893@N00,4466,9,1335467996,1335467996,1,2,0
89904893@N00,4466,19,1335464276,1335464276,1,2,0
89904893@N00,4467,19,1336906560,1336906560,1,1,0
8997662@N06,4468,10,1192773748,1192773798,3,7,50
8997662@N06,4468,11,1192773410,1192774189,2,7,779
8997662@N06,4468,15,1192777720,1192777720,1,7,0
8997662@N06,4468,16,1192777469,1192777469,1,7,0
8997662@N06,4468,19,1192772087,1192783385,14,7,11298
8997662@N06,4468,23,1192773311,1192774822,4,7,1511
8997662@N06,4468,29,1192776303,1192776564,4,7,261
8997662@N06,4469,1,1192849902,1192852651,5,3,2749
8997662@N06,4469,19,1192862392,1192862752,3,3,360
8997662@N06,4469,29,1192848925,1192859234,5,3,10309
8997662@N06,4470,2,1192934673,1192935181,2,7,508
8997662@N06,4470,4,1192930600,1192930600,1,7,0
8997662@N06,4470,8,1192956033,1192956068,2,7,35
8997662@N06,4470,15,1192955846,1192955846,1,7,0
8997662@N06,4470,18,1192955234,1192955234,1,7,0
8997662@N06,4470,19,1192951882,1192956320,4,7,4438
8997662@N06,4470,24,1192931503,1192931503,1,7,0
8997662@N06,4471,3,1193020328,1193032275,13,8,11947
8997662@N06,4471,4,1193021447,1193022025,2,8,578
8997662@N06,4471,8,1193022641,1193022641,1,8,0
8997662@N06,4471,16,1193026821,1193026821,1,8,0
8997662@N06,4471,18,1193019941,1193019941,1,8,0
8997662@N06,4471,19,1193022406,1193022417,2,8,11
8997662@N06,4471,24,1193021728,1193021728,1,8,0
8997662@N06,4471,29,1193022915,1193022915,1,8,0
90001203@N00,4472,20,1146979012,1146979012,1,1,0
90001203@N00,4473,1,1321665649,1321665649,1,3,0
90001203@N00,4473,9,1321665414,1321665414,1,3,0
90001203@N00,4473,29,1321660669,1321665983,3,3,5314
90001203@N00,4474,9,1344653232,1344656543,2,4,3311
90001203@N00,4474,12,1344650164,1344650164,1,4,0
90001203@N00,4474,17,1344652703,1344652819,2,4,116
90001203@N00,4474,29,1344652532,1344652551,2,4,19
90113037@N00,4475,3,1150773217,1150784930,11,3,11713
90113037@N00,4475,15,1150788098,1150788121,3,3,23
90113037@N00,4475,17,1150786500,1150786500,1,3,0
90146022@N00,4476,22,1250668228,1250668228,1,1,0
90146022@N00,4477,9,1250906776,1250906776,1,1,0
90208555@N06,4478,1,1293610638,1293627183,3,1,16545
90208555@N06,4479,9,1293694437,1293725611,5,1,31174
90208555@N06,4480,9,1293788137,1293792120,6,1,3983
90213651@N00,4481,1,1140317581,1140318828,4,1,1247
90213651@N00,4482,9,1141314200,1141326905,4,1,12705
90213651@N00,4483,1,1146809790,1146809857,2,1,67
90213651@N00,4484,1,1147194782,1147194875,3,1,93
90334391@N00,4485,29,1341796067,1341796067,1,1,0
90334391@N00,4486,8,1342168377,1342169804,2,1,1427
90334391@N00,4487,4,1342241544,1342241544,1,2,0
90334391@N00,4487,10,1342229216,1342229216,1,2,0
90334391@N00,4488,23,1342432498,1342432498,1,1,0
90334391@N00,4489,3,1342488850,1342503353,3,1,14503
9047223@N07,4490,6,1269257666,1269257666,1,3,0
9047223@N07,4490,18,1269257667,1269257667,1,3,0
9047223@N07,4490,29,1269257667,1269257667,1,3,0
90514086@N00,4491,1,1343965796,1343965802,2,6,6
90514086@N00,4491,9,1343965344,1343965424,5,6,80
90514086@N00,4491,15,1343952230,1343965226,7,6,12996
90514086@N00,4491,16,1343965236,1343965257,2,6,21
90514086@N00,4491,22,1343964597,1343964805,10,6,208
90514086@N00,4491,29,1343965295,1343965724,6,6,429
90514086@N00,4492,3,1344063527,1344063536,2,1,9
90585585@N00,4493,1,1164247419,1164253742,4,3,6323
90585585@N00,4493,8,1164304668,1164304668,1,3,0
90585585@N00,4493,24,1164231134,1164276457,17,3,45323
90585585@N00,4494,3,1202608284,1202608876,8,1,592
90585585@N00,4495,29,1204541426,1204541959,8,1,533
90585585@N00,4496,9,1249696777,1249696777,1,3,0
90585585@N00,4496,19,1249696432,1249696432,1,3,0
90585585@N00,4496,28,1249697013,1249718723,11,3,21710
90585585@N00,4497,28,1249772768,1249772781,3,1,13
90585585@N00,4498,13,1348740530,1348740530,1,1,0
90585585@N00,4499,3,1352007498,1352007498,1,1,0
90585585@N00,4500,8,1367034409,1367034409,1,2,0
90585585@N00,4500,12,1367036486,1367036486,1,2,0
90585585@N00,4501,18,1367809213,1367809213,1,1,0
90585585@N00,4502,10,1373617876,1373629000,6,1,11124
90585585@N00,4503,29,1375539057,1375539057,1,1,0
90585585@N00,4504,16,1375611789,1375611789,1,1,0
90585585@N00,4505,9,1377316957,1377316957,1,1,0
90585585@N00,4506,9,1377421042,1377421042,1,1,0
90585585@N00,4507,8,1386751025,1386751025,1,1,0
90703254@N00,4508,8,1230725823,1230725823,1,1,0
90703254@N00,4509,8,1230756011,1230756017,2,1,6
9087290@N02,4510,1,1217819412,1217827987,3,2,8575
9087290@N02,4510,8,1217825043,1217825043,1,2,0
9087290@N02,4511,28,1223170447,1223170480,2,1,33
9087290@N02,4512,12,1244873837,1244873871,2,1,34
9087290@N02,4513,4,1253003718,1253005726,2,1,2008
9087290@N02,4514,12,1261098874,1261098880,2,1,6
9087290@N02,4515,15,1261282862,1261282862,1,1,0
9087290@N02,4516,12,1267850009,1267850009,1,1,0
9087290@N02,4517,19,1276161575,1276174225,2,1,12650
9087290@N02,4518,17,1279967847,1279967847,1,1,0
9087290@N02,4519,15,1281170017,1281170484,3,1,467
9087290@N02,4520,17,1282813668,1282813668,1,1,0
9087290@N02,4521,28,1291437108,1291437108,1,1,0
9087290@N02,4522,19,1297336164,1297336164,1,1,0
9087290@N02,4523,18,1303467890,1303467890,1,1,0
9087290@N02,4524,13,1304934136,1304934136,1,1,0
9087290@N02,4525,9,1308463731,1308463827,2,1,96
9087290@N02,4526,22,1313318268,1313318268,1,1,0
9087290@N02,4527,3,1333160829,1333160829,1,1,0
9087290@N02,4528,12,1339041702,1339041702,1,1,0
9087290@N02,4529,3,1342577197,1342577197,1,1,0
9087290@N02,4530,3,1346394118,1346394118,1,1,0
9087290@N02,4531,13,1359507300,1359517802,5,2,10502
9087290@N02,4531,28,1359507333,1359507333,1,2,0
9087290@N02,4532,3,1360643602,1360643602,1,1,0
9087290@N02,4533,22,1383299719,1383299719,1,1,0
9087290@N02,4534,28,1387330030,1387330043,3,1,13
9087290@N02,4535,28,1390973891,1390974120,6,1,229
9087290@N02,4536,8,1394518940,1394518940,1,1,0
9087290@N02,4537,9,1394603739,1394603739,1,1,0
9087290@N02,4538,3,1394747889,1394747889,1,1,0
90949166@N00,4539,1,1253761368,1253762694,2,1,1326
91016294@N00,4540,1,1176286159,1176286159,1,1,0
91035108@N00,4541,3,1210136427,1210136427,1,1,0
91035108@N00,4542,19,1210392711,1210392711,1,1,0
9112792@N02,4543,9,1186999631,1186999631,1,2,0
9112792@N02,4543,13,1187006459,1187009849,4,2,3390
9112792@N02,4544,15,1187042917,1187042917,1,1,0
9130180@N04,4545,12,1207532729,1207532959,3,1,230
91321092@N02,4546,3,1317958258,1317958258,1,1,0
91321092@N02,4547,4,1318129041,1318129041,1,1,0
91357983@N05,4548,8,1325712958,1325712958,1,1,0
91357983@N05,4549,23,1326697554,1326697554,1,1,0
91357983@N05,4550,16,1327355339,1327355339,1,1,0
91357983@N05,4551,4,1327442588,1327442588,1,1,0
91357983@N05,4552,19,1328165818,1328165818,1,1,0
91357983@N05,4553,18,1329342510,1329342510,1,1,0
91357983@N05,4554,17,1329892226,1329892226,1,1,0
91357983@N05,4555,22,1332650145,1332650145,1,1,0
91357983@N05,4556,19,1338004474,1338004474,1,1,0
91357983@N05,4557,8,1364770543,1364770543,1,3,0
91357983@N05,4557,11,1364770575,1364770575,1,3,0
91357983@N05,4557,12,1364770605,1364770625,2,3,20
91426379@N00,4558,13,1164934716,1164934727,2,1,11
91426379@N00,4559,13,1165044280,1165044280,1,1,0
91426379@N00,4560,15,1176625409,1176625409,1,1,0
91426379@N00,4561,19,1184933180,1184937891,6,1,4711
91426379@N00,4562,9,1185577747,1185577766,2,1,19
91426379@N00,4563,13,1196202933,1196217873,4,1,14940
91426379@N00,4564,9,1201163339,1201168281,4,1,4942
91426379@N00,4565,2,1201219558,1201219558,1,1,0
91426379@N00,4566,12,1370827358,1370827408,2,1,50
91535395@N00,4567,11,1199962631,1199972378,3,1,9747
9156485@N02,4568,8,1120622489,1120633264,7,5,10775
9156485@N02,4568,9,1120629329,1120629436,5,5,107
9156485@N02,4568,15,1120622844,1120632993,10,5,10149
9156485@N02,4568,16,1120625774,1120626633,3,5,859
9156485@N02,4568,29,1120626929,1120628910,12,5,1981
9156485@N02,4569,29,1182405760,1182405770,4,1,10
9156485@N02,4570,4,1182494790,1182494822,2,1,32
9156485@N02,4571,9,1230796638,1230802850,14,1,6212
91572751@N00,4572,19,1156305004,1156305004,1,1,0
91572751@N00,4573,1,1162939249,1162939249,1,2,0
91572751@N00,4573,19,1162939449,1162939449,1,2,0
9159505@N02,4574,1,1180510514,1180510514,1,3,0
9159505@N02,4574,9,1180511723,1180513858,3,3,2135
9159505@N02,4574,29,1180509707,1180511698,28,3,1991
9159505@N02,4575,2,1180760077,1180760167,4,8,90
9159505@N02,4575,4,1180759951,1180761765,7,8,1814
9159505@N02,4575,8,1180770594,1180770832,4,8,238
9159505@N02,4575,10,1180768656,1180769250,18,8,594
9159505@N02,4575,11,1180769316,1180770120,10,8,804
9159505@N02,4575,19,1180765967,1180765967,1,8,0
9159505@N02,4575,23,1180765818,1180768340,6,8,2522
9159505@N02,4575,24,1180761475,1180761611,6,8,136
91685781@N00,4576,1,1031978631,1031984706,3,1,6075
91685781@N00,4577,8,1032083287,1032090905,7,1,7618
91685781@N00,4578,4,1032138013,1032138013,1,2,0
91685781@N00,4578,9,1032142030,1032154435,2,2,12405
91697420@N00,4579,28,1345200083,1345200083,1,1,0
91712888@N00,4580,20,1377913707,1377913707,1,1,0
91712888@N00,4581,9,1385198370,1385203284,6,1,4914
91712888@N00,4582,8,1387071531,1387071531,1,2,0
91712888@N00,4582,15,1387067803,1387070388,5,2,2585
91712888@N00,4583,20,1388196652,1388197321,3,1,669
91712888@N00,4584,15,1388801611,1388801611,1,1,0
91712888@N00,4585,21,1391313656,1391313656,1,1,0
91719530@N00,4586,19,1042134417,1042134417,1,2,0
91719530@N00,4586,25,1042109112,1042109112,1,2,0
91782666@N00,4587,8,1348281968,1348283521,5,2,1553
91782666@N00,4587,15,1348283729,1348284157,4,2,428
9190877@N07,4588,1,1195266085,1195266085,1,2,0
9190877@N07,4588,29,1195262124,1195262566,2,2,442
91968820@N00,4589,28,1302061643,1302061643,1,1,0
92011564@N00,4590,10,1280158616,1280158616,1,1,0
92134758@N00,4591,8,1249979513,1249980429,8,3,916
92134758@N00,4591,15,1249977916,1249978656,6,3,740
92134758@N00,4591,19,1249979789,1249980099,10,3,310
92237387@N00,4592,8,1157860168,1157860592,3,5,424
92237387@N00,4592,9,1157860692,1157860703,2,5,11
92237387@N00,4592,15,1157868589,1157868589,1,5,0
92237387@N00,4592,18,1157860930,1157862888,7,5,1958
92237387@N00,4592,19,1157859233,1157859319,4,5,86
92237387@N00,4593,2,1157940231,1157947660,33,3,7429
92237387@N00,4593,7,1157933044,1157936299,12,3,3255
92237387@N00,4593,24,1157931615,1157932272,4,3,657
92237387@N00,4594,1,1158020869,1158023608,9,2,2739
92237387@N00,4594,29,1158028752,1158028775,2,2,23
92237387@N00,4595,7,1158263374,1158263374,1,2,0
92237387@N00,4595,19,1158263775,1158263775,1,2,0
92243383@N03,4596,2,1371074974,1371074974,1,1,0
92393992@N00,4597,29,1199245481,1199245481,1,1,0
92393992@N00,4598,11,1237528628,1237528628,1,1,0
92431035@N00,4599,1,1276047289,1276048238,8,1,949
92431035@N00,4600,3,1276196350,1276196350,1,1,0
92455828@N00,4601,17,1369434670,1369448813,4,2,14143
92455828@N00,4601,19,1369451102,1369451129,3,2,27
92455828@N00,4602,14,1369481944,1369481978,5,1,34
92455828@N00,4603,12,1369652345,1369652438,8,2,93
92455828@N00,4603,14,1369652149,1369652857,5,2,708
92496717@N00,4604,15,1237004227,1237004227,1,1,0
92496717@N00,4605,1,1254607714,1254630857,2,1,23143
92496717@N00,4606,15,1298762101,1298763133,4,1,1032
92549514@N00,4607,15,1191404264,1191404271,2,1,7
9255261@N07,4608,1,1278292727,1278292727,1,1,0
92607898@N00,4609,17,956053265,956053265,1,1,0
92607898@N00,4610,13,956135644,956135644,1,2,0
92607898@N00,4610,28,956147356,956147356,1,2,0
92607898@N00,4611,17,956317299,956317299,1,1,0
92607898@N00,4612,13,1155526075,1155573606,14,1,47531
92607898@N00,4613,13,1155604014,1155650709,20,1,46695
92607898@N00,4614,17,1155888548,1155889426,2,1,878
92607898@N00,4615,17,1155975714,1155991142,4,1,15428
92607898@N00,4616,17,1156161188,1156161188,1,1,0
92607898@N00,4617,17,1156665375,1156692233,4,1,26858
92607898@N00,4618,13,1156907237,1156907237,1,1,0
92607898@N00,4619,17,1185951323,1185951381,3,1,58
92607898@N00,4620,17,1186067009,1186067009,1,1,0
92607898@N00,4621,17,1186670012,1186676688,6,1,6676
92607898@N00,4622,13,1186765508,1186769666,4,2,4158
92607898@N00,4622,28,1186748375,1186748400,3,2,25
92607898@N00,4623,13,1186848184,1186848221,2,2,37
92607898@N00,4623,17,1186832774,1186832774,1,2,0
92607898@N00,4624,28,1186981685,1186981685,1,1,0
92607898@N00,4625,28,1187057894,1187100004,104,1,42110
92607898@N00,4626,13,1187192157,1187192157,1,1,0
92607898@N00,4627,17,1187446533,1187447790,3,1,1257
92607898@N00,4628,17,1187519935,1187539203,8,1,19268
92607898@N00,4629,13,1187796722,1187800473,17,1,3751
92607898@N00,4630,17,1187879703,1187887017,16,1,7314
92607898@N00,4631,28,1188056859,1188056859,1,1,0
92607898@N00,4632,17,1188118407,1188130169,4,1,11762
92607898@N00,4633,17,1217675050,1217675050,1,1,0
92607898@N00,4634,3,1218093423,1218094275,6,1,852
92607898@N00,4635,13,1218209906,1218213098,2,2,3192
92607898@N00,4635,17,1218195466,1218195466,1,2,0
92607898@N00,4636,13,1218284796,1218287531,2,1,2735
92607898@N00,4637,13,1218379485,1218381715,8,1,2230
92607898@N00,4638,13,1218474404,1218474404,1,1,0
92607898@N00,4639,13,1218551168,1218554452,8,2,3284
92607898@N00,4639,17,1218535690,1218535690,1,2,0
92607898@N00,4640,13,1218722336,1218727805,13,1,5469
92607898@N00,4641,13,1218811010,1218814050,12,1,3040
92607898@N00,4642,3,1218958316,1218958316,1,1,0
92607898@N00,4643,3,1219060739,1219064534,3,2,3795
92607898@N00,4643,17,1219054793,1219054793,1,2,0
92607898@N00,4644,17,1219145726,1219147913,4,1,2187
92607898@N00,4645,13,1219421822,1219427321,2,2,5499
92607898@N00,4645,17,1219405811,1219405815,2,2,4
92607898@N00,4646,17,1219488218,1219493790,2,1,5572
92607898@N00,4647,17,1219578372,1219584995,5,1,6623
92607898@N00,4648,28,1219643147,1219644433,5,1,1286
92607898@N00,4649,13,1250092781,1250092936,3,1,155
92607898@N00,4650,13,1250520366,1250572200,125,1,51834
92607898@N00,4651,13,1251039869,1251048905,33,1,9036
92607898@N00,4652,13,1257302334,1257307344,5,1,5010
92607898@N00,4653,13,1280911007,1280911007,1,1,0
92607898@N00,4654,17,1281274769,1281274769,1,1,0
92607898@N00,4655,13,1281415725,1281415725,1,1,0
92607898@N00,4656,29,1281514947,1281521593,3,1,6646
92607898@N00,4657,28,1281665033,1281665047,2,1,14
92607898@N00,4658,29,1281709389,1281709389,1,1,0
92607898@N00,4659,28,1281748595,1281764060,3,1,15465
92607898@N00,4660,13,1281894555,1281894555,1,1,0
92607898@N00,4661,18,1281971008,1281974690,2,1,3682
92607898@N00,4662,18,1282050938,1282061744,41,1,10806
92607898@N00,4663,13,1282237150,1282237150,1,1,0
92607898@N00,4664,28,1282316937,1282321406,5,1,4469
92607898@N00,4665,13,1282402710,1282402710,1,1,0
92607898@N00,4666,17,1282649441,1282649441,1,1,0
92607898@N00,4667,3,1282753052,1282753052,1,1,0
92607898@N00,4668,28,1282839767,1282839767,1,1,0
92607898@N00,4669,13,1282925429,1282927489,6,1,2060
92607898@N00,4670,3,1282964121,1282964121,1,2,0
92607898@N00,4670,28,1282972305,1282972305,1,2,0
92607898@N00,4671,13,1283181794,1283193792,3,1,11998
92607898@N00,4672,17,1313144334,1313144334,1,1,0
92607898@N00,4673,28,1313484531,1313487971,13,1,3440
92607898@N00,4674,13,1313583960,1313615329,57,1,31369
92607898@N00,4675,28,1313987507,1313987507,1,1,0
92607898@N00,4676,13,1314025488,1314032548,47,1,7060
92607898@N00,4677,3,1314105108,1314115399,64,2,10291
92607898@N00,4677,13,1314116918,1314119164,23,2,2246
92607898@N00,4678,13,1314198319,1314206454,59,1,8135
92607898@N00,4679,3,1314665897,1314667452,5,2,1555
92607898@N00,4679,13,1314671204,1314671204,1,2,0
92607898@N00,4680,17,1343890261,1343893563,11,2,3302
92607898@N00,4680,28,1343917407,1343920472,5,2,3065
92607898@N00,4681,13,1344352868,1344359181,31,1,6313
92607898@N00,4682,29,1344491725,1344491725,1,1,0
92607898@N00,4683,13,1344956150,1344963591,47,1,7441
92607898@N00,4684,17,1345010797,1345011350,4,1,553
92607898@N00,4685,13,1345115135,1345115135,1,1,0
92607898@N00,4686,13,1345225057,1345225057,1,2,0
92607898@N00,4686,17,1345219627,1345220410,4,2,783
92607898@N00,4687,17,1345350231,1345350260,3,2,29
92607898@N00,4687,28,1345354690,1345354703,2,2,13
92607898@N00,4688,13,1345471649,1345474755,4,1,3106
92607898@N00,4689,13,1345561318,1345568627,48,1,7309
92607898@N00,4690,17,1345692764,1345692764,1,1,0
92607898@N00,4691,13,1345877232,1345877881,10,1,649
92607898@N00,4692,17,1345987003,1345987162,3,2,159
92607898@N00,4692,29,1345976739,1345977367,9,2,628
92607898@N00,4693,3,1346070680,1346071721,2,2,1041
92607898@N00,4693,13,1346084528,1346084528,1,2,0
92607898@N00,4694,13,1346122402,1346127413,24,1,5011
92607898@N00,4695,13,1375278378,1375279717,2,1,1339
92607898@N00,4696,13,1375455462,1375455469,2,1,7
92607898@N00,4697,3,1375688735,1375688735,1,2,0
92607898@N00,4697,13,1375688823,1375688823,1,2,0
92607898@N00,4698,13,1376234530,1376234539,2,1,9
92607898@N00,4699,13,1376382514,1376382514,1,1,0
92607898@N00,4700,3,1377239625,1377239625,1,1,0
92607898@N00,4701,3,1377412866,1377415923,3,1,3057
92742787@N04,4702,3,1378101394,1378101584,2,4,190
92742787@N04,4702,9,1378103216,1378103942,2,4,726
92742787@N04,4702,10,1378106105,1378107879,5,4,1774
92742787@N04,4702,29,1378103891,1378103891,1,4,0
92782066@N00,4703,9,1251961796,1251961796,1,2,0
92782066@N00,4703,15,1251944312,1251944312,1,2,0
93003266@N04,4704,18,1361938078,1361938078,1,1,0
93182020@N00,4705,9,1218948589,1218948589,1,1,0
93182020@N00,4706,8,1236926978,1236926978,1,1,0
93372608@N00,4707,1,1144646946,1144652394,10,1,5448
93372608@N00,4708,1,1144732240,1144733293,3,1,1053
93372608@N00,4709,18,1144892780,1144892780,1,1,0
9337758@N02,4710,3,1345878839,1345878839,1,1,0
9337758@N02,4711,17,1345908022,1345908022,1,1,0
9337758@N02,4712,17,1345991539,1345997357,5,2,5818
9337758@N02,4712,29,1346001276,1346001276,1,2,0
9337758@N02,4713,9,1346046306,1346070905,4,2,24599
9337758@N02,4713,17,1346069386,1346071117,4,2,1731
9337758@N02,4714,29,1346133614,1346133614,1,1,0
93384183@N00,4715,29,1375447347,1375447347,1,1,0
93472925@N00,4716,13,1302076482,1302076482,1,1,0
93472925@N00,4717,12,1303462768,1303462768,1,1,0
9351020@N06,4718,1,1372153740,1372153740,1,3,0
9351020@N06,4718,9,1372156126,1372156126,1,3,0
9351020@N06,4718,15,1372156236,1372156236,1,3,0
9351020@N06,4719,9,1372208970,1372209482,2,3,512
9351020@N06,4719,19,1372222281,1372222281,1,3,0
9351020@N06,4719,29,1372212348,1372212348,1,3,0
9351020@N06,4720,28,1372339557,1372339557,1,1,0
9351020@N06,4721,1,1372389209,1372389407,2,3,198
9351020@N06,4721,19,1372400047,1372403223,2,3,3176
9351020@N06,4721,29,1372389756,1372389756,1,3,0
93511097@N00,4722,9,1150176118,1150176118,1,3,0
93511097@N00,4722,17,1150174211,1150174211,1,3,0
93511097@N00,4722,29,1150173524,1150173524,1,3,0
93511097@N00,4723,1,1154143613,1154158093,62,2,14480
93511097@N00,4723,29,1154144531,1154146919,3,2,2388
93511097@N00,4724,3,1250334657,1250334657,1,2,0
93511097@N00,4724,13,1250317203,1250317203,1,2,0
93511097@N00,4725,6,1292128795,1292128795,1,1,0
93511097@N00,4726,7,1298780073,1298780073,1,1,0
9352211@N06,4727,1,1332668154,1332668896,2,6,742
9352211@N06,4727,8,1332639469,1332640163,2,6,694
9352211@N06,4727,9,1332670280,1332670438,2,6,158
9352211@N06,4727,12,1332662656,1332662696,2,6,40
9352211@N06,4727,18,1332637230,1332665723,3,6,28493
9352211@N06,4727,29,1332638569,1332669649,3,6,31080
9352211@N06,4728,9,1333762993,1333762993,1,3,0
9352211@N06,4728,15,1333759280,1333759280,1,3,0
9352211@N06,4728,29,1333763500,1333768574,25,3,5074
9352211@N06,4729,1,1333830434,1333830434,1,1,0
93542697@N00,4730,17,1173141372,1173141372,1,1,0
93543821@N00,4731,1,1214617114,1214619700,6,2,2586
93543821@N00,4731,18,1214613635,1214613635,1,2,0
93726493@N00,4732,29,1251607197,1251607197,1,1,0
9400713@N03,4733,8,1381719544,1381719544,1,2,0
9400713@N03,4733,15,1381720387,1381720387,1,2,0
94018078@N00,4734,1,1239959604,1239959975,2,1,371
94018078@N00,4735,29,1240060242,1240060242,1,1,0
94069795@N00,4736,8,1150355596,1150355656,2,1,60
94069795@N00,4737,10,1154782591,1154782882,2,1,291
94414747@N00,4738,9,1172881750,1172881750,1,1,0
94488969@N05,4739,9,1374562640,1374562640,1,1,0
94624316@N00,4740,15,1376507763,1376507763,1,1,0
94624316@N00,4741,22,1376576228,1376576228,1,1,0
94624316@N00,4742,8,1377186423,1377186423,1,2,0
94624316@N00,4742,15,1377190088,1377190088,1,2,0
94624316@N00,4743,8,1386182094,1386182094,1,1,0
94735786@N00,4744,1,1364252797,1364281350,99,5,28553
94735786@N00,4744,8,1364268349,1364269168,6,5,819
94735786@N00,4744,15,1364268332,1364268450,3,5,118
94735786@N00,4744,19,1364284860,1364286682,8,5,1822
94735786@N00,4744,29,1364270767,1364284507,12,5,13740
94735786@N00,4745,1,1364354661,1364357093,16,10,2432
94735786@N00,4745,2,1364357182,1364357226,6,10,44
94735786@N00,4745,3,1364356182,1364367621,15,10,11439
94735786@N00,4745,4,1364356876,1364356924,5,10,48
94735786@N00,4745,8,1364339770,1364365056,12,10,25286
94735786@N00,4745,12,1364355238,1364373123,5,10,17885
94735786@N00,4745,17,1364356675,1364367855,12,10,11180
94735786@N00,4745,19,1364357701,1364368135,6,10,10434
94735786@N00,4745,28,1364356424,1364356424,1,10,0
94735786@N00,4745,29,1364356156,1364356156,1,10,0
94735786@N00,4746,1,1364434559,1364434566,2,4,7
94735786@N00,4746,8,1364432818,1364432872,5,4,54
94735786@N00,4746,15,1364434573,1364434573,1,4,0
94735786@N00,4746,19,1364432421,1364433843,5,4,1422
94735786@N00,4747,19,1364466845,1364468909,2,1,2064
94735786@N00,4748,1,1364535021,1364535432,5,12,411
94735786@N00,4748,2,1364536998,1364537049,3,12,51
94735786@N00,4748,3,1364536122,1364536122,1,12,0
94735786@N00,4748,8,1364531861,1364531877,2,12,16
94735786@N00,4748,9,1364537814,1364539972,3,12,2158
94735786@N00,4748,10,1364537621,1364537621,1,12,0
94735786@N00,4748,15,1364519210,1364534190,4,12,14980
94735786@N00,4748,17,1364540470,1364540830,3,12,360
94735786@N00,4748,19,1364531005,1364545243,8,12,14238
94735786@N00,4748,22,1364531126,1364531126,1,12,0
94735786@N00,4748,27,1364534913,1364539781,3,12,4868
94735786@N00,4748,29,1364535586,1364535586,1,12,0
94735786@N00,4749,19,1364602776,1364602857,2,1,81
94869158@N00,4750,8,1185932391,1185932873,3,3,482
94869158@N00,4750,15,1185931684,1185931684,1,3,0
94869158@N00,4750,29,1185933414,1185933520,3,3,106
94869158@N00,4751,20,1186016743,1186021763,41,1,5020
94956595@N00,4752,19,1090401111,1090401540,6,1,429
94956595@N00,4753,19,1141541105,1141541105,1,1,0
94991702@N00,4754,19,1351305991,1351318333,8,1,12342
95012874@N00,4755,4,1148358148,1148367895,53,1,9747
95285464@N00,4756,1,671896800,671896801,2,1,1
95285464@N00,4757,10,672069602,672069602,1,2,0
95285464@N00,4757,11,672069603,672069603,1,2,0
9539183@N06,4758,17,1367210061,1367210061,1,1,0
9539613@N03,4759,10,1304163515,1304173354,2,2,9839
9539613@N03,4759,11,1304165315,1304165595,2,2,280
9539613@N03,4760,3,1336284007,1336288881,3,1,4874
9539613@N03,4761,9,1351684340,1351689710,6,1,5370
9539613@N03,4762,3,1364018476,1364019626,6,1,1150
95457978@N00,4763,19,1104498000,1104498000,1,1,0
95709825@N00,4764,1,1178673830,1178673830,1,1,0
95808812@N00,4765,16,1371158514,1371158514,1,1,0
95808812@N00,4766,3,1372142505,1372142505,1,1,0
95808812@N00,4767,17,1375360048,1375360048,1,1,0
95808812@N00,4768,18,1376303000,1376303000,1,2,0
95808812@N00,4768,22,1376304496,1376304496,1,2,0
95808812@N00,4769,15,1376342173,1376342173,1,1,0
95808812@N00,4770,3,1377574886,1377574886,1,1,0
95808812@N00,4771,15,1378902673,1378902673,1,2,0
95808812@N00,4771,29,1378892004,1378892004,1,2,0
95808812@N00,4772,16,1380493864,1380493864,1,1,0
95808812@N00,4773,29,1382305701,1382305701,1,1,0
95808812@N00,4774,3,1382391677,1382391677,1,2,0
95808812@N00,4774,8,1382390374,1382390374,1,2,0
95808812@N00,4775,3,1383013721,1383013721,1,1,0
95808812@N00,4776,8,1383510949,1383510949,1,1,0
95808812@N00,4777,18,1387766369,1387768673,3,1,2304
95808812@N00,4778,15,1388957884,1388957884,1,1,0
95808812@N00,4779,15,1390901239,1390901239,1,1,0
95808812@N00,4780,18,1390962151,1390962151,1,1,0
95808812@N00,4781,15,1392328343,1392328343,1,1,0
95808812@N00,4782,12,1392361482,1392361482,1,1,0
95808812@N00,4783,29,1394520612,1394520612,1,1,0
95808812@N00,4784,16,1394660443,1394660443,1,2,0
95808812@N00,4784,18,1394659935,1394659935,1,2,0
95808812@N00,4785,18,1395006714,1395006714,1,1,0
95808812@N00,4786,8,1395610801,1395610801,1,1,0
95808812@N00,4787,29,1395644437,1395644437,1,1,0
95808812@N00,4788,1,1395726166,1395726166,1,1,0
95808812@N00,4789,12,1395784140,1395784140,1,1,0
95808812@N00,4790,12,1395818849,1395818849,1,1,0
95808812@N00,4791,8,1395869149,1395869149,1,1,0
95808812@N00,4792,29,1395910736,1395914454,4,1,3718
95808812@N00,4793,15,1396313269,1396313269,1,1,0
95808812@N00,4794,15,1396996608,1396996608,1,1,0
95808812@N00,4795,29,1397550708,1397550708,1,1,0
95808812@N00,4796,18,1397603396,1397603396,1,1,0
9588476@N02,4797,19,1291438707,1291438774,3,1,67
9588476@N02,4798,8,1291617702,1291617869,3,2,167
9588476@N02,4798,15,1291618083,1291618083,1,2,0
9588476@N02,4799,8,1291691735,1291691735,1,3,0
9588476@N02,4799,15,1291690314,1291690623,8,3,309
9588476@N02,4799,18,1291688993,1291690306,5,3,1313
9588476@N02,4800,14,1296443419,1296443419,1,1,0
9588476@N02,4801,1,1297922207,1297922212,2,1,5
9588476@N02,4802,27,1303532882,1303540569,3,1,7687
9588476@N02,4803,15,1303705892,1303705916,3,1,24
9588476@N02,4804,1,1304320418,1304320418,1,5,0
9588476@N02,4804,4,1304321676,1304321820,4,5,144
9588476@N02,4804,9,1304320782,1304320988,4,5,206
9588476@N02,4804,12,1304320140,1304320288,3,5,148
9588476@N02,4804,29,1304320744,1304320744,1,5,0
9588476@N02,4805,18,1309652191,1309652282,4,3,91
9588476@N02,4805,22,1309665357,1309665357,1,3,0
9588476@N02,4805,27,1309654922,1309658990,4,3,4068
9588476@N02,4806,27,1330217178,1330219964,5,1,2786
9588476@N02,4807,19,1344856130,1344856130,1,1,0
9588476@N02,4808,14,1368759120,1368759120,1,1,0
9588476@N02,4809,14,1390960378,1390960378,1,1,0
9588476@N02,4810,9,1391314618,1391316707,7,2,2089
9588476@N02,4810,17,1391314672,1391316073,3,2,1401
95974557@N08,4811,16,1356059463,1356080167,77,1,20704
95974557@N08,4812,8,1356132639,1356137492,13,3,4853
95974557@N08,4812,16,1356137530,1356137530,1,3,0
95974557@N08,4812,19,1356128770,1356128797,3,3,27
95974557@N08,4813,16,1369097977,1369097977,3,1,0
96104378@N00,4814,22,1379205384,1379205384,1,1,0
96104378@N00,4815,18,1379283942,1379283942,1,1,0
96116162@N00,4816,1,1014901200,1014901200,12,1,0
96241281@N00,4817,9,1177105435,1177106201,2,3,766
96241281@N00,4817,11,1177099074,1177099074,1,3,0
96241281@N00,4817,17,1177106533,1177108515,3,3,1982
96241281@N00,4818,1,1177192400,1177197939,13,5,5539
96241281@N00,4818,3,1177202900,1177204169,8,5,1269
96241281@N00,4818,8,1177189877,1177189877,1,5,0
96241281@N00,4818,11,1177190146,1177190146,1,5,0
96241281@N00,4818,29,1177198341,1177198617,2,5,276
96396057@N00,4819,9,1126512760,1126512760,1,1,0
96423179@N00,4820,19,1255673565,1255673623,2,1,58
96423179@N00,4821,21,1255756196,1255756196,1,1,0
96423179@N00,4822,18,1261378165,1261378165,1,1,0
96423179@N00,4823,15,1268203876,1268203876,1,3,0
96423179@N00,4823,19,1268204284,1268204284,1,3,0
96423179@N00,4823,29,1268204512,1268204610,2,3,98
96424614@N00,4824,10,1192938636,1192938636,1,1,0
96424614@N00,4825,29,1202340204,1202340204,1,1,0
96424614@N00,4826,15,1203136294,1203136427,3,1,133
96424614@N00,4827,20,1205035127,1205035316,2,1,189
96424614@N00,4828,19,1205788907,1205788918,2,1,11
96424614@N00,4829,19,1206047902,1206047902,1,1,0
96424614@N00,4830,19,1206566499,1206566499,1,1,0
96424614@N00,4831,19,1207810495,1207810495,1,1,0
96424614@N00,4832,29,1214712511,1214712511,1,1,0
96424614@N00,4833,3,1214955352,1214955441,2,2,89
96424614@N00,4833,28,1214950289,1214950409,3,2,120
96424614@N00,4834,12,1217827966,1217827966,1,1,0
96424614@N00,4835,19,1218613850,1218613850,1,1,0
96424614@N00,4836,19,1218666221,1218666221,1,1,0
96424614@N00,4837,19,1219271118,1219271760,2,1,642
96424614@N00,4838,28,1221776936,1221776936,1,1,0
96424614@N00,4839,29,1222749450,1222749450,1,1,0
96424614@N00,4840,16,1224823583,1224823583,1,1,0
96424614@N00,4841,19,1226476283,1226476283,1,1,0
96424614@N00,4842,18,1248061795,1248061795,1,1,0
96453841@N00,4843,3,1240037323,1240037323,1,1,0
9648799@N07,4844,1,1299830852,1299830852,1,2,0
9648799@N07,4844,29,1299814604,1299814604,1,2,0
9656812@N03,4845,29,1364629588,1364635897,4,1,6309
96635144@N00,4846,14,1310448990,1310456226,12,1,7236
96635144@N00,4847,14,1310507441,1310560414,30,1,52973
96635144@N00,4848,14,1310602526,1310648989,19,1,46463
96635144@N00,4849,14,1310682175,1310691980,11,1,9805
96635144@N00,4850,1,1340612578,1340625973,3,1,13395
96635144@N00,4851,9,1340674548,1340692061,18,1,17513
96635144@N00,4852,9,1340779573,1340800315,3,1,20742
96635144@N00,4853,9,1340838525,1340869412,7,1,30887
96635144@N00,4854,9,1340924459,1340934611,2,1,10152
96684313@N00,4855,18,1196750856,1196751667,3,1,811
96684313@N00,4856,18,1196809976,1196809976,1,1,0
96684313@N00,4857,8,1229333160,1229334325,14,2,1165
96684313@N00,4857,18,1229327131,1229327131,1,2,0
96721948@N00,4858,1,1195609691,1195609691,1,7,0
96721948@N00,4858,4,1195601461,1195601461,1,7,0
96721948@N00,4858,9,1195603061,1195611214,4,7,8153
96721948@N00,4858,10,1195598741,1195598741,1,7,0
96721948@N00,4858,11,1195599249,1195599682,2,7,433
96721948@N00,4858,17,1195611693,1195611693,1,7,0
96721948@N00,4858,29,1195604860,1195619004,2,7,14144
96811126@N00,4859,28,1311046560,1311046560,1,1,0
96811126@N00,4860,3,1311139343,1311139343,1,1,0
96811126@N00,4861,1,1311217629,1311217629,1,1,0
96854970@N00,4862,3,1363176577,1363176577,1,1,0
96854970@N00,4863,3,1363253166,1363253166,1,1,0
96854970@N00,4864,17,1371028303,1371028303,1,1,0
96854970@N00,4865,17,1371072292,1371072292,1,1,0
96883485@N00,4866,22,1198009047,1198009047,1,1,0
96883485@N00,4867,21,1232072999,1232080945,8,1,7946
96883485@N00,4868,21,1232263875,1232263875,1,1,0
96883485@N00,4869,21,1255398188,1255402976,5,1,4788
96883485@N00,4870,21,1267067326,1267071722,5,1,4396
96883485@N00,4871,21,1291071767,1291096038,5,1,24271
96883485@N00,4872,21,1291158337,1291195263,4,1,36926
96883485@N00,4873,11,1394446154,1394446154,1,1,0
9697853@N03,4874,8,1337593980,1337593980,1,2,0
9697853@N03,4874,9,1337594511,1337594911,2,2,400
97093596@N08,4875,28,1370581086,1370581086,1,1,0
97093596@N08,4876,9,1371195075,1371203461,23,1,8386
97093596@N08,4877,29,1371282820,1371292196,10,1,9376
97093596@N08,4878,29,1371335741,1371338182,5,1,2441
97093596@N08,4879,9,1371590150,1371592332,11,2,2182
97093596@N08,4879,12,1371616473,1371616629,6,2,156
97093596@N08,4880,2,1371966681,1371966681,1,2,0
97093596@N08,4880,29,1371968812,1371968823,2,2,11
97153232@N00,4881,9,1125781141,1125781141,1,1,0
97153232@N00,4882,29,1125874954,1125874954,1,1,0
97153232@N00,4883,20,1206586442,1206586442,1,1,0
97188231@N00,4884,5,1296870861,1296870861,1,1,0
97206958@N00,4885,28,1276927511,1276927511,1,1,0
97206958@N00,4886,1,1346585002,1346585002,1,1,0
97206958@N00,4887,9,1357016667,1357016667,1,1,0
97206958@N00,4888,8,1357544229,1357544229,1,1,0
97206958@N00,4889,9,1359012946,1359015941,2,1,2995
97206958@N00,4890,4,1359539189,1359539189,1,1,0
97206958@N00,4891,23,1359679930,1359679930,1,1,0
97206958@N00,4892,8,1360625498,1360625498,1,1,0
97206958@N00,4893,18,1360711345,1360711345,1,1,0
97206958@N00,4894,1,1360830479,1360830479,1,3,0
97206958@N00,4894,19,1360829838,1360829838,1,3,0
97206958@N00,4894,23,1360829569,1360829569,1,3,0
97206958@N00,4895,29,1361229812,1361229812,1,1,0
97206958@N00,4896,3,1361347903,1361347903,1,1,0
97206958@N00,4897,9,1361434401,1361434401,1,1,0
97206958@N00,4898,9,1361517212,1361517212,1,1,0
97206958@N00,4899,9,1362644559,1362644559,1,1,0
97206958@N00,4900,18,1362744109,1362744109,1,1,0
97206958@N00,4901,27,1362801988,1362801988,1,1,0
97206958@N00,4902,29,1363433611,1363433611,1,1,0
97206958@N00,4903,3,1363683367,1363683367,1,1,0
97206958@N00,4904,9,1363863332,1363863332,1,1,0
97206958@N00,4905,29,1363949149,1363949149,1,1,0
97206958@N00,4906,18,1364023310,1364023310,1,1,0
97206958@N00,4907,29,1364637528,1364638391,3,1,863
97206958@N00,4908,18,1366619040,1366619040,1,1,0
97206958@N00,4909,1,1367277090,1367277090,1,1,0
97206958@N00,4910,12,1367397288,1367397288,1,1,0
97206958@N00,4911,8,1368401793,1368401793,1,1,0
97206958@N00,4912,2,1368948505,1368948505,1,1,0
97206958@N00,4913,3,1369818606,1369818606,1,1,0
97206958@N00,4914,18,1369993695,1369993695,1,1,0
97206958@N00,4915,9,1372057552,1372057552,1,1,0
97206958@N00,4916,17,1372202426,1372202426,1,1,0
97206958@N00,4917,15,1372662232,1372662232,1,1,0
97206958@N00,4918,9,1372835285,1372835285,1,1,0
97206958@N00,4919,3,1373007615,1373007615,1,1,0
97206958@N00,4920,8,1391412213,1391412213,1,1,0
97206958@N00,4921,8,1391499378,1391499859,3,1,481
97534175@N00,4922,1,1187050792,1187050792,1,4,0
97534175@N00,4922,3,1187062325,1187062325,1,4,0
97534175@N00,4922,9,1187051289,1187051702,9,4,413
97534175@N00,4922,29,1187050801,1187051513,5,4,712
97534175@N00,4923,3,1187237549,1187252200,2,4,14651
97534175@N00,4923,9,1187251945,1187251945,1,4,0
97534175@N00,4923,17,1187252048,1187252146,4,4,98
97534175@N00,4923,29,1187233425,1187233425,1,4,0
97534175@N00,4924,19,1217059871,1217059871,1,1,0
97534175@N00,4925,3,1217468842,1217468865,2,2,23
97534175@N00,4925,28,1217469059,1217486212,18,2,17153
97534175@N00,4926,28,1217573724,1217573724,1,1,0
97534175@N00,4927,28,1218171278,1218171278,1,1,0
97568990@N00,4928,18,1294376921,1294376921,1,1,0
97595808@N00,4929,22,1248340198,1248340884,6,1,686
97595808@N00,4930,4,1252734493,1252736433,18,2,1940
97595808@N00,4930,24,1252734634,1252735470,9,2,836
97595808@N00,4931,20,1258941529,1258944329,16,1,2800
97595808@N00,4932,9,1266117814,1266117814,1,2,0
97595808@N00,4932,17,1266116139,1266116139,1,2,0
97595808@N00,4933,9,1272094358,1272094358,1,1,0
97595808@N00,4934,4,1274595798,1274596734,12,1,936
97595808@N00,4935,21,1276762641,1276762641,1,1,0
97595808@N00,4936,9,1284888552,1284888552,1,1,0
97595808@N00,4937,4,1291605128,1291608534,13,4,3406
97595808@N00,4937,10,1291611556,1291612464,7,4,908
97595808@N00,4937,11,1291605384,1291605698,3,4,314
97595808@N00,4937,24,1291607893,1291607999,2,4,106
97595808@N00,4938,8,1309332333,1309336348,5,2,4015
97595808@N00,4938,19,1309335879,1309335879,1,2,0
97595808@N00,4939,1,1309423862,1309423862,1,2,0
97595808@N00,4939,12,1309424282,1309438445,33,2,14163
97595808@N00,4940,3,1312599179,1312612465,30,1,13286
97595808@N00,4941,3,1316835198,1316845774,4,4,10576
97595808@N00,4941,13,1316845519,1316845624,2,4,105
97595808@N00,4941,17,1316832803,1316833040,4,4,237
97595808@N00,4941,28,1316845968,1316845968,1,4,0
97595808@N00,4942,3,1318810208,1318827757,8,1,17549
97595808@N00,4943,3,1321001973,1321010579,20,1,8606
97595808@N00,4944,9,1330476708,1330478153,3,1,1445
97595808@N00,4945,19,1337727528,1337727528,1,1,0
97595808@N00,4946,19,1337932958,1337932958,1,1,0
97595808@N00,4947,9,1344672181,1344674386,4,1,2205
97595808@N00,4948,4,1345709956,1345714228,4,1,4272
9772804@N05,4949,4,1188046873,1188046873,1,2,0
9772804@N05,4949,15,1188046896,1188046896,1,2,0
9772804@N05,4950,9,1188612905,1188612905,1,2,0
9772804@N05,4950,17,1188612931,1188612931,1,2,0
97768382@N00,4951,1,1188091296,1188107108,11,7,15812
97768382@N00,4951,2,1188112533,1188112731,3,7,198
97768382@N00,4951,4,1188112796,1188113086,5,7,290
97768382@N00,4951,8,1188085271,1188085271,1,7,0
97768382@N00,4951,9,1188089986,1188090725,5,7,739
97768382@N00,4951,23,1188109983,1188109983,1,7,0
97768382@N00,4951,29,1188091134,1188104980,5,7,13846
9788232@N03,4952,1,1316475628,1316479585,28,3,3957
9788232@N03,4952,8,1316482067,1316500218,8,3,18151
9788232@N03,4952,19,1316481672,1316481931,2,3,259
97945464@N00,4953,19,1323666438,1323666438,1,1,0
97945464@N00,4954,28,1325811589,1325811589,1,1,0
9813542@N08,4955,1,1189832189,1189832189,1,6,0
9813542@N08,4955,8,1189827565,1189828211,4,6,646
9813542@N08,4955,9,1189833421,1189834287,3,6,866
9813542@N08,4955,15,1189828557,1189828709,3,6,152
9813542@N08,4955,16,1189828199,1189828199,1,6,0
9813542@N08,4955,19,1189826325,1189826564,2,6,239
98137912@N00,4956,21,1313911689,1313911693,2,1,4
98219249@N00,4957,9,1184397598,1184397689,2,1,91
9828412@N05,4958,9,1375147386,1375147386,1,2,0
9828412@N05,4958,29,1375131498,1375154555,8,2,23057
9828412@N05,4959,18,1375743817,1375743817,1,1,0
98509073@N00,4960,9,1348710741,1348710741,1,1,0
98523633@N00,4961,29,1199331983,1199334503,5,1,2520
98523633@N00,4962,29,1206752335,1206763728,6,1,11393
98523633@N00,4963,29,1302571684,1302574523,2,1,2839
98523633@N00,4964,29,1302832746,1302849465,16,1,16719
98523633@N00,4965,29,1313813547,1313828052,4,1,14505
98594684@N00,4966,12,1286646663,1286684813,348,1,38150
98683612@N00,4967,1,1330151373,1330151373,1,1,0
98718564@N00,4968,23,1252814476,1252816181,2,1,1705
9878315@N04,4969,9,1247975152,1247975152,1,3,0
9878315@N04,4969,20,1247987959,1247991484,9,3,3525
9878315@N04,4969,24,1247978290,1247978290,1,3,0
9878315@N04,4970,15,1248147596,1248151945,3,2,4349
9878315@N04,4970,28,1248161974,1248161974,1,2,0
98826199@N00,4971,29,998699711,998699711,1,1,0
98826199@N00,4972,29,1143332121,1143332121,1,1,0
98826199@N00,4973,29,1149968630,1149968630,1,1,0
98833136@N00,4974,1,1157014977,1157017373,9,2,2396
98833136@N00,4974,12,1157015307,1157015714,3,2,407
98833136@N00,4975,3,1236401737,1236401737,1,2,0
98833136@N00,4975,28,1236400138,1236400676,2,2,538
98833136@N00,4976,22,1262324171,1262324171,1,1,0
98833136@N00,4977,18,1274408876,1274408876,1,1,0
98833136@N00,4978,13,1281092791,1281093398,2,1,607
98833136@N00,4979,17,1282046792,1282048337,2,1,1545
98833136@N00,4980,19,1285156310,1285156310,1,1,0
98833136@N00,4981,12,1287201194,1287201194,1,1,0
98833136@N00,4982,18,1289543011,1289543011,1,1,0
98833136@N00,4983,18,1290993348,1290993348,1,1,0
98833136@N00,4984,18,1291191990,1291191990,1,1,0
98833136@N00,4985,18,1291333399,1291333399,1,1,0
98833136@N00,4986,1,1291862502,1291862502,1,1,0
98833136@N00,4987,20,1292735422,1292735612,3,1,190
98833136@N00,4988,18,1293582732,1293582732,1,1,0
98833136@N00,4989,9,1293699470,1293699470,1,3,0
98833136@N00,4989,10,1293703422,1293703422,1,3,0
98833136@N00,4989,11,1293702331,1293703066,3,3,735
98833136@N00,4990,29,1300850334,1300850334,1,1,0
98833136@N00,4991,28,1310789812,1310789985,2,1,173
98833136@N00,4992,17,1313322317,1313322317,1,1,0
98833136@N00,4993,18,1350511676,1350511676,1,1,0
98833136@N00,4994,3,1350644748,1350644748,1,1,0
98999190@N00,4995,10,1324810017,1324811327,20,1,1310
99047728@N00,4996,10,1339612356,1339612356,1,1,0
99047728@N00,4997,16,1339965315,1339965315,1,1,0
99109486@N00,4998,27,1381530594,1381530594,1,2,0
99109486@N00,4998,29,1381513142,1381513142,1,2,0
99109486@N00,4999,19,1381605566,1381605566,1,1,0
99152538@N00,5000,15,1157535588,1157536493,4,2,905
99152538@N00,5000,16,1157534674,1157534720,5,2,46
99185699@N00,5001,8,1380068837,1380068837,1,3,0
99185699@N00,5001,16,1380069217,1380069217,1,3,0
99185699@N00,5001,29,1380068668,1380068668,1,3,0
99456529@N00,5002,8,1324694798,1324698152,2,2,3354
99456529@N00,5002,15,1324705954,1324705993,2,2,39
99535234@N00,5003,22,1289655243,1289657280,2,1,2037
99538783@N00,5004,19,1253934928,1253934928,1,1,0
99547538@N00,5005,9,1232511065,1232511065,1,1,0
99564668@N00,5006,17,1238287283,1238287283,1,2,0
99564668@N00,5006,29,1238287803,1238287803,1,2,0
99599444@N00,5007,29,1258774368,1258776834,4,1,2466
99599444@N00,5008,29,1258855320,1258855320,1,1,0
9960405@N04,5009,8,1241184757,1241184757,1,1,0
99646216@N00,5010,9,1154752401,1154753247,6,1,846
99646216@N00,5011,8,1154833649,1154833649,1,2,0
99646216@N00,5011,19,1154836871,1154839485,5,2,2614
99646216@N00,5012,6,1157854829,1157854829,1,1,0
99646216@N00,5013,20,1187333398,1187334265,3,1,867
99646216@N00,5014,27,1212218567,1212218567,1,1,0
99646216@N00,5015,18,1230865147,1230871104,2,1,5957
99646216@N00,5016,2,1275536072,1275536072,1,3,0
99646216@N00,5016,4,1275535862,1275535862,1,3,0
99646216@N00,5016,24,1275536406,1275536406,1,3,0
99646216@N00,5017,4,1292815941,1292816240,2,3,299
99646216@N00,5017,8,1292811775,1292811775,1,3,0
99646216@N00,5017,15,1292810988,1292811154,2,3,166
99646216@N00,5018,2,1313124258,1313124258,1,1,0
99646216@N00,5019,2,1313206513,1313206814,2,1,301
99646216@N00,5020,20,1333163486,1333166137,9,1,2651
99646216@N00,5021,3,1334203070,1334203070,1,1,0
99646216@N00,5022,19,1344249305,1344249662,3,1,357
99646216@N00,5023,9,1345703637,1345703637,1,1,0
99646216@N00,5024,8,1354789820,1354790080,2,1,260
99646216@N00,5025,10,1356860436,1356862565,2,2,2129
99646216@N00,5025,28,1356855647,1356855647,1,2,0
99785739@N00,5026,11,1211110678,1211111027,4,1,349
99962592@N00,5027,1,1157168096,1157178098,15,3,10002
99962592@N00,5027,8,1157156461,1157156733,2,3,272
99962592@N00,5027,15,1157156688,1157157143,5,3,455
99962592@N00,5028,8,1157276851,1157278846,2,1,1995
