userID,trajID,poiID,startTime,endTime,#photo,trajLen,poiDuration
1,1,2,1333843415,1333843848,0,4,433
1,1,3,1333843848,1333847880,0,4,4032
1,1,4,1333847880,1333847901,0,4,21
1,1,3,1333847901,1333847961,0,4,60
1,2,2,1333867267,1333868132,0,9,865
1,2,5,1333868132,1333871166,0,9,3034
1,2,6,1333871166,1333875482,0,9,4316
1,2,7,1333875482,1333876893,0,9,1411
1,2,8,1333876893,1333879555,0,9,2662
1,2,9,1333879555,1333881908,0,9,2353
1,2,10,1333881908,1333887480,0,9,5572
1,2,5,1333887480,1333887893,0,9,413
1,2,11,1333887893,1333887953,0,9,60
1,3,12,1336251805,1336252988,0,4,1183
1,3,13,1336252988,1336253001,0,4,13
1,3,14,1336253001,1336253781,0,4,780
1,3,15,1336253781,1336253841,0,4,60
1,4,5,1337376343,1337389354,0,2,13011
1,4,16,1337389354,1337389414,0,2,60
1,5,17,1337405329,1337406462,0,10,1133
1,5,18,1337406462,1337406908,0,10,446
1,5,5,1337406908,1337407884,0,10,976
1,5,16,1337407884,1337408077,0,10,193
1,5,19,1337408077,1337411116,0,10,3039
1,5,16,1337411116,1337413634,0,10,2518
1,5,20,1337413634,1337414570,0,10,936
1,5,9,1337414570,1337424215,0,10,9645
1,5,5,1337424215,1337424667,0,10,452
1,5,11,1337424667,1337424727,0,10,60
1,6,21,1337460350,1337461618,0,4,1268
1,6,22,1337461618,1337461973,0,4,355
1,6,23,1337461973,1337462765,0,4,792
1,6,24,1337462765,1337462825,0,4,60
1,7,11,1341640118,1341640574,0,12,456
1,7,5,1341640574,1341641765,0,12,1191
1,7,20,1341641765,1341643189,0,12,1424
1,7,8,1341643189,1341646462,0,12,3273
1,7,25,1341646462,1341646857,0,12,395
1,7,26,1341646857,1341647791,0,12,934
1,7,8,1341647791,1341648380,0,12,589
1,7,10,1341648380,1341652002,0,12,3622
1,7,20,1341652002,1341652161,0,12,159
1,7,27,1341652161,1341654168,0,12,2007
1,7,5,1341654168,1341654634,0,12,466
1,7,11,1341654634,1341654694,0,12,60
1,8,28,1341704718,1341718846,0,5,14128
1,8,7,1341718846,1341720040,0,5,1194
1,8,8,1341720040,1341721461,0,5,1421
1,8,29,1341721461,1341722189,0,5,728
1,8,10,1341722189,1341722249,0,5,60
1,9,30,1341736461,1341736968,0,2,507
1,9,5,1341736968,1341737028,0,2,60
1,10,31,1342913117,1342913177,0,1,60
1,11,5,1344542423,1344542483,0,1,60
1,12,15,1344573767,1344579091,0,4,5324
1,12,32,1344579091,1344581312,0,4,2221
1,12,33,1344581312,1344582610,0,4,1298
1,12,21,1344582610,1344582670,0,4,60
1,13,28,1344595662,1344596366,0,4,704
1,13,21,1344596366,1344597454,0,4,1088
1,13,34,1344597454,1344608673,0,4,11219
1,13,35,1344608673,1344608733,0,4,60
1,14,5,1351331861,1351335786,0,7,3925
1,14,20,1351335786,1351336748,0,7,962
1,14,8,1351336748,1351337983,0,7,1235
1,14,26,1351337983,1351338621,0,7,638
1,14,8,1351338621,1351344321,0,7,5700
1,14,5,1351344321,1351344956,0,7,635
1,14,11,1351344956,1351345016,0,7,60
1,15,36,1353640871,1353640890,0,5,19
1,15,37,1353640890,1353641576,0,5,686
1,15,38,1353641576,1353643050,0,5,1474
1,15,39,1353643050,1353661287,0,5,18237
1,15,11,1353661287,1353661347,0,5,60
1,16,11,1353757254,1353757998,0,3,744
1,16,40,1353757998,1353764975,0,3,6977
1,16,21,1353764975,1353765035,0,3,60
1,17,11,1354925822,1354926073,0,7,251
1,17,5,1354926073,1354926408,0,7,335
1,17,41,1354926408,1354932307,0,7,5899
1,17,42,1354932307,1354946194,0,7,13887
1,17,43,1354946194,1354946705,0,7,511
1,17,44,1354946705,1354947019,0,7,314
1,17,5,1354947019,1354947079,0,7,60
1,18,45,1354948354,1354948414,0,1,60
1,19,12,1355010977,1355011037,0,1,60
1,20,14,1355045198,1355045701,0,2,503
1,20,12,1355045701,1355045761,0,2,60
1,21,28,1355480652,1355481227,0,4,575
1,21,46,1355481227,1355482036,0,4,809
1,21,41,1355482036,1355482083,0,4,47
1,21,42,1355482083,1355482143,0,4,60
1,22,15,1356686969,1356687029,0,1,60
1,23,15,1356728208,1356728268,0,1,60
1,24,15,1356836476,1356849575,0,2,13099
1,24,15,1356849575,1356849635,0,2,60
1,25,15,1356900288,1356900348,0,1,60
1,26,12,1356964569,1356964629,0,1,60
1,27,47,1357095557,1357111528,0,2,15971
1,27,48,1357111528,1357111588,0,2,60
1,28,49,1357131712,1357135470,0,3,3758
1,28,50,1357135470,1357136212,0,3,742
1,28,51,1357136212,1357136272,0,3,60
1,29,5,1358036659,1358036870,0,3,211
1,29,20,1358036870,1358051962,0,3,15092
1,29,52,1358051962,1358052022,0,3,60
1,30,53,1358058545,1358060416,0,3,1871
1,30,54,1358060416,1358077859,0,3,17443
1,30,55,1358077859,1358077919,0,3,60
2,31,11,1359204282,1359204342,0,1,60
2,32,56,1333496857,1333511052,0,3,14195
2,32,57,1333511052,1333514821,0,3,3769
2,32,58,1333514821,1333514881,0,3,60
2,33,59,1333535844,1333535904,0,1,60
2,34,58,1333585359,1333585419,0,1,60
2,35,58,1334017644,1334030493,0,2,12849
2,35,60,1334030493,1334030553,0,2,60
2,36,61,1334102463,1334107082,0,3,4619
2,36,58,1334107082,1334117086,0,3,10004
2,36,62,1334117086,1334117146,0,3,60
2,37,56,1334188300,1334202159,0,2,13859
2,37,63,1334202159,1334202219,0,2,60
2,38,58,1334276981,1334277041,0,1,60
2,39,59,1334315016,1334315076,0,1,60
2,40,59,1334482778,1334482838,0,1,60
2,41,59,1334581591,1334581651,0,1,60
2,42,59,1334665512,1334665572,0,1,60
2,43,56,1334706762,1334708681,0,2,1919
2,43,58,1334708681,1334708741,0,2,60
2,44,58,1334795219,1334813942,0,2,18723
2,44,64,1334813942,1334814002,0,2,60
2,45,65,1334829565,1334840842,0,3,11277
2,45,66,1334840842,1334841493,0,3,651
2,45,59,1334841493,1334841553,0,3,60
2,46,56,1334879700,1334881560,0,2,1860
2,46,58,1334881560,1334881620,0,2,60
2,47,67,1334916779,1334916839,0,1,60
2,48,56,1334993169,1334995621,0,2,2452
2,48,68,1334995621,1334995681,0,2,60
2,49,58,1335141661,1335153124,0,2,11463
2,49,69,1335153124,1335153184,0,2,60
2,50,66,1335180967,1335186751,0,2,5784
2,50,59,1335186751,1335186811,0,2,60
2,51,56,1335223886,1335226596,0,3,2710
2,51,58,1335226596,1335241558,0,3,14962
2,51,70,1335241558,1335241618,0,3,60
2,52,66,1335272051,1335272111,0,1,60
2,53,56,1335311642,1335311702,0,1,60
2,54,71,1335359515,1335359575,0,1,60
2,55,56,1335397851,1335400654,0,2,2803
2,55,58,1335400654,1335400714,0,2,60
2,56,65,1335438019,1335438079,0,1,60
2,57,72,1335523190,1335523250,0,1,60
2,58,73,1335586333,1335586393,0,1,60
2,59,59,1335616185,1335616245,0,1,60
2,60,58,1335918429,1335918489,0,1,60
2,61,58,1336351070,1336363306,0,2,12236
2,61,74,1336363306,1336363366,0,2,60
2,62,66,1336475390,1336482074,0,2,6684
2,62,59,1336482074,1336482134,0,2,60
2,63,56,1336521234,1336523329,0,2,2095
2,63,58,1336523329,1336523389,0,2,60
2,64,59,1336564384,1336564444,0,1,60
2,65,56,1336607292,1336609694,0,2,2402
2,65,58,1336609694,1336609754,0,2,60
2,66,75,1336708205,1336708265,0,1,60
2,67,76,1336731213,1336750804,0,2,19591
2,67,77,1336750804,1336750864,0,2,60
2,68,78,1336953248,1336955236,0,3,1988
2,68,58,1336955236,1336969579,0,3,14343
2,68,60,1336969579,1336969639,0,3,60
2,69,66,1336992114,1336998727,0,2,6613
2,69,59,1336998727,1336998787,0,2,60
2,70,58,1337041721,1337055445,0,2,13724
2,70,62,1337055445,1337055505,0,2,60
2,71,58,1337128630,1337142761,0,2,14131
2,71,79,1337142761,1337142821,0,2,60
2,72,59,1337174542,1337174602,0,1,60
2,73,56,1337212182,1337214537,0,2,2355
2,73,58,1337214537,1337214597,0,2,60
2,74,80,1337396916,1337396976,0,1,60
2,75,73,1337430521,1337430581,0,1,60
2,76,78,1337644471,1337646209,0,2,1738
2,76,58,1337646209,1337646269,0,2,60
2,77,66,1337684995,1337691425,0,2,6430
2,77,59,1337691425,1337691485,0,2,60
2,78,56,1337817153,1337819076,0,3,1923
2,78,58,1337819076,1337832783,0,3,13707
2,78,60,1337832783,1337832843,0,3,60
2,79,65,1337853402,1337853462,0,1,60
2,80,81,1338001726,1338007000,0,2,5274
2,80,82,1338007000,1338007060,0,2,60
2,81,74,1338176343,1338176403,0,1,60
2,82,72,1338200407,1338200467,0,1,60
2,83,56,1338249007,1338251321,0,2,2314
2,83,58,1338251321,1338251381,0,2,60
2,84,66,1338290782,1338296714,0,2,5932
2,84,59,1338296714,1338296774,0,2,60
2,85,56,1338335046,1338337677,0,2,2631
2,85,58,1338337677,1338337737,0,2,60
2,86,83,1338712088,1338712148,0,1,60
2,87,58,1338769614,1338783997,0,2,14383
2,87,74,1338783997,1338784057,0,2,60
2,88,66,1338807827,1338807887,0,1,60
2,89,56,1338850517,1338853726,0,2,3209
2,89,58,1338853726,1338853786,0,2,60
2,90,59,1338894650,1338894710,0,1,60
2,91,84,1338979793,1338979853,0,1,60
2,92,56,1339026714,1339026774,0,1,60
2,93,21,1339059321,1339059381,0,1,60
2,94,58,1339115295,1339115355,0,1,60
2,95,56,1339224952,1339225012,0,1,60
2,96,58,1339374387,1339374447,0,1,60
2,97,58,1339461561,1339461621,0,1,60
2,98,58,1339547236,1339547296,0,1,60
2,99,59,1340102126,1340102186,0,1,60
2,100,56,1340236150,1340238498,0,3,2348
2,100,58,1340238498,1340250214,0,3,11716
2,100,85,1340250214,1340250274,0,3,60
2,101,65,1340272677,1340272737,0,1,60
2,102,56,1340754847,1340756590,0,2,1743
2,102,58,1340756590,1340756650,0,2,60
2,103,72,1341225178,1341228782,0,3,3604
2,103,66,1341228782,1341234795,0,3,6013
2,103,59,1341234795,1341234855,0,3,60
2,104,58,1341275034,1341275094,0,1,60
2,105,58,1341361286,1341374255,0,2,12969
2,105,60,1341374255,1341374315,0,2,60
2,106,66,1341399892,1341405535,0,2,5643
2,106,59,1341405535,1341405595,0,2,60
2,107,56,1341446000,1341446060,0,1,60
2,108,59,1341485993,1341486053,0,1,60
2,109,69,1341548165,1341554735,0,2,6570
2,109,15,1341554735,1341554795,0,2,60
2,110,86,1341577324,1341577944,0,2,620
2,110,81,1341577944,1341578004,0,2,60
2,111,58,1341636705,1341641407,0,3,4702
2,111,87,1341641407,1341652518,0,3,11111
2,111,88,1341652518,1341652578,0,3,60
2,112,58,1341794761,1341794821,0,1,60
2,113,58,1342139202,1342154278,0,2,15076
2,113,85,1342154278,1342154338,0,2,60
2,114,72,1342523548,1342523608,0,1,60
2,115,58,1342570929,1342570989,0,1,60
2,116,59,1342616381,1342616441,0,1,60
2,117,58,1342657505,1342657565,0,1,60
2,118,56,1342833998,1342834058,0,1,60
2,119,56,1343442954,1343443014,0,1,60
2,120,56,1343605837,1343605897,0,1,60
2,121,59,1343644398,1343644458,0,1,60
2,122,72,1344247399,1344247459,0,1,60
2,123,59,1344508116,1344508176,0,1,60
2,124,58,1344558338,1344558398,0,1,60
2,125,58,1344817724,1344817784,0,1,60
2,126,89,1344942143,1344942203,0,1,60
2,127,78,1344988707,1344988767,0,1,60
2,128,81,1345274132,1345274192,0,1,60
2,129,56,1345420167,1345422539,0,2,2372
2,129,58,1345422539,1345422599,0,2,60
2,130,58,1347236718,1347236778,0,1,60
2,131,59,1347534228,1347534288,0,1,60
2,132,58,1350606431,1350606491,0,1,60
2,133,58,1350952113,1350952173,0,1,60
2,134,58,1351038341,1351038401,0,1,60
2,135,58,1351124757,1351124817,0,1,60
2,136,58,1351470455,1351482455,0,2,12000
2,136,85,1351482455,1351482515,0,2,60
2,137,56,1351727571,1351727631,0,1,60
2,138,58,1352681067,1352691689,0,2,10622
2,138,90,1352691689,1352691749,0,2,60
2,139,58,1352766486,1352766546,0,1,60
2,140,91,1352808287,1352808347,0,1,60
2,141,58,1353025635,1353025695,0,1,60
2,142,72,1353062293,1353062353,0,1,60
2,143,92,1353470588,1353470648,0,1,60
2,144,59,1353494409,1353495793,0,2,1384
2,144,91,1353495793,1353495853,0,2,60
2,145,93,1353553284,1353556691,0,2,3407
2,145,58,1353556691,1353556751,0,2,60
2,146,65,1353578235,1353578295,0,1,60
2,147,94,1353663790,1353663850,0,1,60
2,148,95,1353729761,1353729821,0,1,60
2,149,58,1353976960,1353977020,0,1,60
2,150,58,1354062287,1354062347,0,1,60
2,151,59,1354444600,1354444660,0,1,60
2,152,93,1354613073,1354613133,0,1,60
2,153,58,1354753761,1354753821,0,1,60
2,154,86,1354886291,1354886351,0,1,60
2,155,75,1355025187,1355025247,0,1,60
2,156,59,1355048762,1355048822,0,1,60
2,157,58,1355099196,1355099256,0,1,60
2,158,58,1355185541,1355204967,0,2,19426
2,158,96,1355204967,1355205027,0,2,60
2,159,72,1355220410,1355220470,0,1,60
2,160,58,1355619517,1355619577,0,1,60
2,161,59,1355830260,1355830320,0,1,60
2,162,84,1355919745,1355919805,0,1,60
2,163,58,1356050367,1356050427,0,1,60
2,164,86,1356226753,1356226813,0,1,60
2,165,58,1356742780,1356742840,0,1,60
2,166,97,1356777920,1356777980,0,1,60
2,167,98,1356969268,1356969328,0,1,60
2,168,99,1357009709,1357009769,0,1,60
2,169,58,1357604992,1357605052,0,1,60
2,170,56,1357775454,1357776800,0,3,1346
2,170,100,1357776800,1357777790,0,3,990
2,170,58,1357777790,1357777850,0,3,60
2,171,58,1357864152,1357864212,0,1,60
2,172,93,1357899116,1357902174,0,2,3058
2,172,59,1357902174,1357902234,0,2,60
2,173,58,1358468950,1358469010,0,1,60
2,174,58,1359073433,1359073493,0,1,60
2,175,58,1359678508,1359678568,0,1,60
2,176,101,1359784777,1359784837,0,1,60
2,177,58,1360715024,1360715084,0,1,60
3,178,58,1360801544,1360801604,0,1,60
3,179,102,1333492443,1333493152,0,3,709
3,179,103,1333493152,1333493936,0,3,784
3,179,104,1333493936,1333493996,0,3,60
3,180,105,1333519609,1333523413,0,2,3804
3,180,106,1333523413,1333523473,0,2,60
3,181,107,1333579624,1333580290,0,3,666
3,181,108,1333580290,1333581361,0,3,1071
3,181,109,1333581361,1333581421,0,3,60
3,182,102,1333626807,1333626867,0,1,60
3,183,110,1333874455,1333874515,0,1,60
3,184,111,1334126809,1334126869,0,1,60
3,185,112,1334181475,1334182490,0,7,1015
3,185,113,1334182490,1334183757,0,7,1267
3,185,114,1334183757,1334186197,0,7,2440
3,185,108,1334186197,1334187052,0,7,855
3,185,109,1334187052,1334199179,0,7,12127
3,185,115,1334199179,1334200886,0,7,1707
3,185,102,1334200886,1334200946,0,7,60
3,186,103,1334282304,1334283876,0,6,1572
3,186,116,1334283876,1334285142,0,6,1266
3,186,117,1334285142,1334288758,0,6,3616
3,186,118,1334288758,1334296311,0,6,7553
3,186,119,1334296311,1334301995,0,6,5684
3,186,115,1334301995,1334302055,0,6,60
3,187,120,1334784767,1334788015,0,5,3248
3,187,114,1334788015,1334789335,0,5,1320
3,187,107,1334789335,1334797292,0,5,7957
3,187,121,1334797292,1334798701,0,5,1409
3,187,102,1334798701,1334798761,0,5,60
3,188,122,1334885890,1334896555,0,6,10665
3,188,123,1334896555,1334897224,0,6,669
3,188,124,1334897224,1334898465,0,6,1241
3,188,125,1334898465,1334898726,0,6,261
3,188,126,1334898726,1334900738,0,6,2012
3,188,125,1334900738,1334900798,0,6,60
3,189,127,1334910875,1334910935,0,1,60
3,190,128,1334997983,1334999245,0,3,1262
3,190,129,1334999245,1335002143,0,3,2898
3,190,102,1335002143,1335002203,0,3,60
3,191,102,1335053408,1335053782,0,2,374
3,191,103,1335053782,1335053842,0,2,60
3,192,102,1335248554,1335248614,0,1,60
3,193,102,1335392601,1335392791,0,4,190
3,193,103,1335392791,1335394596,0,4,1805
3,193,121,1335394596,1335395535,0,4,939
3,193,109,1335395535,1335395595,0,4,60
3,194,130,1336040371,1336041675,0,2,1304
3,194,102,1336041675,1336041735,0,2,60
3,195,103,1336202515,1336203991,0,14,1476
3,195,131,1336203991,1336204533,0,14,542
3,195,132,1336204533,1336204734,0,14,201
3,195,133,1336204734,1336205804,0,14,1070
3,195,134,1336205804,1336211095,0,14,5291
3,195,135,1336211095,1336212368,0,14,1273
3,195,136,1336212368,1336212849,0,14,481
3,195,137,1336212849,1336213247,0,14,398
3,195,138,1336213247,1336214186,0,14,939
3,195,139,1336214186,1336214386,0,14,200
3,195,140,1336214386,1336215197,0,14,811
3,195,141,1336215197,1336216139,0,14,942
3,195,142,1336216139,1336216977,0,14,838
3,195,143,1336216977,1336217037,0,14,60
3,196,122,1336387617,1336389025,0,2,1408
3,196,102,1336389025,1336389085,0,2,60
3,197,144,1336532142,1336535140,0,4,2998
3,197,145,1336535140,1336536292,0,4,1152
3,197,146,1336536292,1336537309,0,4,1017
3,197,102,1336537309,1336537369,0,4,60
3,198,147,1336601260,1336604007,0,3,2747
3,198,107,1336604007,1336605380,0,3,1373
3,198,109,1336605380,1336605440,0,3,60
3,199,102,1336727253,1336727745,0,2,492
3,199,148,1336727745,1336727805,0,2,60
3,200,124,1336811581,1336812769,0,4,1188
3,200,125,1336812769,1336814512,0,4,1743
3,200,149,1336814512,1336818560,0,4,4048
3,200,150,1336818560,1336818620,0,4,60
3,201,102,1336896089,1336896615,0,2,526
3,201,151,1336896615,1336896675,0,2,60
3,202,143,1336984178,1336985839,0,11,1661
3,202,112,1336985839,1336986690,0,11,851
3,202,113,1336986690,1336987979,0,11,1289
3,202,114,1336987979,1336988169,0,11,190
3,202,152,1336988169,1336990308,0,11,2139
3,202,107,1336990308,1336990992,0,11,684
3,202,108,1336990992,1336991713,0,11,721
3,202,109,1336991713,1336992771,0,11,1058
3,202,153,1336992771,1337000533,0,11,7762
3,202,121,1337000533,1337002617,0,11,2084
3,202,102,1337002617,1337002677,0,11,60
3,203,154,1337045334,1337046285,0,4,951
3,203,155,1337046285,1337046853,0,4,568
3,203,156,1337046853,1337048691,0,4,1838
3,203,157,1337048691,1337048751,0,4,60
3,204,102,1337131859,1337151839,0,2,19980
3,204,102,1337151839,1337151899,0,2,60
3,205,158,1337224983,1337226867,0,4,1884
3,205,159,1337226867,1337228801,0,4,1934
3,205,160,1337228801,1337234083,0,4,5282
3,205,102,1337234083,1337234143,0,4,60
3,206,102,1338252269,1338254160,0,5,1891
3,206,154,1338254160,1338254997,0,5,837
3,206,155,1338254997,1338256871,0,5,1874
3,206,157,1338256871,1338257753,0,5,882
3,206,161,1338257753,1338257813,0,5,60
3,207,148,1338717535,1338718489,0,2,954
3,207,102,1338718489,1338718549,0,2,60
3,208,162,1338861354,1338865250,0,4,3896
3,208,163,1338865250,1338868476,0,4,3226
3,208,164,1338868476,1338875042,0,4,6566
3,208,165,1338875042,1338875102,0,4,60
3,209,155,1339465381,1339466265,0,3,884
3,209,102,1339466265,1339467346,0,3,1081
3,209,157,1339467346,1339467406,0,3,60
3,210,102,1339923734,1339923794,0,1,60
3,211,144,1339984602,1339989449,0,2,4847
3,211,102,1339989449,1339989509,0,2,60
3,212,166,1341801273,1341802641,0,7,1368
3,212,167,1341802641,1341804834,0,7,2193
3,212,168,1341804834,1341810957,0,7,6123
3,212,169,1341810957,1341812730,0,7,1773
3,212,170,1341812730,1341813114,0,7,384
3,212,171,1341813114,1341815398,0,7,2284
3,212,102,1341815398,1341815458,0,7,60
3,213,172,1342152760,1342154958,0,7,2198
3,213,173,1342154958,1342158355,0,7,3397
3,213,174,1342158355,1342159877,0,7,1522
3,213,175,1342159877,1342161761,0,7,1884
3,213,176,1342161761,1342163835,0,7,2074
3,213,177,1342163835,1342165519,0,7,1684
3,213,178,1342165519,1342165579,0,7,60
3,214,102,1342245127,1342245187,0,1,60
3,215,127,1342340260,1342340320,0,1,60
3,216,102,1342429500,1342429775,0,2,275
3,216,179,1342429775,1342429835,0,2,60
3,217,180,1344154212,1344155732,0,2,1520
3,217,181,1344155732,1344155792,0,2,60
3,218,102,1344237999,1344238059,0,1,60
3,219,182,1344577923,1344579513,0,5,1590
3,219,159,1344579513,1344580557,0,5,1044
3,219,160,1344580557,1344586091,0,5,5534
3,219,183,1344586091,1344586887,0,5,796
3,219,102,1344586887,1344586947,0,5,60
3,220,102,1344746754,1344746814,0,1,60
3,221,184,1344835384,1344836664,0,3,1280
3,221,185,1344836664,1344837703,0,3,1039
3,221,186,1344837703,1344837763,0,3,60
3,222,102,1344930803,1344931929,0,2,1126
3,222,187,1344931929,1344931989,0,2,60
3,223,102,1345390554,1345391079,0,2,525
3,223,122,1345391079,1345391139,0,2,60
3,224,144,1345431194,1345433995,0,9,2801
3,224,141,1345433995,1345435124,0,9,1129
3,224,139,1345435124,1345436315,0,9,1191
3,224,188,1345436315,1345440272,0,9,3957
3,224,189,1345440272,1345446930,0,9,6658
3,224,115,1345446930,1345447122,0,9,192
3,224,121,1345447122,1345449048,0,9,1926
3,224,102,1345449048,1345450514,0,9,1466
3,224,190,1345450514,1345450574,0,9,60
3,225,130,1345464517,1345466407,0,2,1890
3,225,102,1345466407,1345466467,0,2,60
3,226,191,1346900626,1346905707,0,3,5081
3,226,102,1346905707,1346905936,0,3,229
3,226,151,1346905936,1346905996,0,3,60
3,227,192,1347230819,1347231479,0,4,660
3,227,107,1347231479,1347233501,0,4,2022
3,227,109,1347233501,1347243800,0,4,10299
3,227,112,1347243800,1347243860,0,4,60
3,228,193,1347762741,1347762801,0,1,60
3,229,127,1350113494,1350113554,0,1,60
3,230,157,1350614137,1350614197,0,1,60
3,231,102,1350969103,1350970794,0,3,1691
3,231,121,1350970794,1350977441,0,3,6647
3,231,102,1350977441,1350977501,0,3,60
3,232,102,1351487319,1351494198,0,2,6879
3,232,102,1351494198,1351494258,0,2,60
3,233,107,1351722951,1351724377,0,2,1426
3,233,194,1351724377,1351724437,0,2,60
3,234,103,1351832339,1351844717,0,2,12378
3,234,102,1351844717,1351844777,0,2,60
3,235,102,1352115921,1352115981,0,1,60
3,236,157,1352186238,1352188431,0,2,2193
3,236,144,1352188431,1352188491,0,2,60
3,237,154,1352770319,1352771466,0,3,1147
3,237,155,1352771466,1352771957,0,3,491
3,237,102,1352771957,1352772017,0,3,60
3,238,102,1353213465,1353214929,0,4,1464
3,238,195,1353214929,1353215918,0,4,989
3,238,196,1353215918,1353216553,0,4,635
3,238,127,1353216553,1353216613,0,4,60
3,239,197,1353479182,1353479242,0,1,60
3,240,144,1353552953,1353557333,0,3,4380
3,240,129,1353557333,1353568560,0,3,11227
3,240,102,1353568560,1353568620,0,3,60
3,241,151,1353825728,1353825788,0,1,60
3,242,198,1354162666,1354165651,0,3,2985
3,242,133,1354165651,1354172480,0,3,6829
3,242,121,1354172480,1354172540,0,3,60
3,243,102,1354362253,1354362313,0,1,60
3,244,107,1354489375,1354490937,0,2,1562
3,244,194,1354490937,1354490997,0,2,60
3,245,125,1354545555,1354545615,0,1,60
3,246,155,1354605321,1354606087,0,2,766
3,246,122,1354606087,1354606147,0,2,60
3,247,199,1354698971,1354699031,0,1,60
3,248,200,1354761175,1354761833,0,6,658
3,248,102,1354761833,1354762122,0,6,289
3,248,201,1354762122,1354769299,0,6,7177
3,248,126,1354769299,1354773639,0,6,4340
3,248,202,1354773639,1354775418,0,6,1779
3,248,203,1354775418,1354775478,0,6,60
3,249,103,1354858259,1354858319,0,1,60
3,250,204,1355037103,1355042096,0,2,4993
3,250,205,1355042096,1355042156,0,2,60
3,251,154,1355189469,1355191108,0,2,1639
3,251,102,1355191108,1355191168,0,2,60
3,252,206,1355348177,1355352488,0,4,4311
3,252,107,1355352488,1355359997,0,4,7509
3,252,121,1355359997,1355362112,0,4,2115
3,252,155,1355362112,1355362172,0,4,60
3,253,112,1355972045,1355983401,0,4,11356
3,253,115,1355983401,1355983806,0,4,405
3,253,121,1355983806,1355985606,0,4,1800
3,253,102,1355985606,1355985666,0,4,60
3,254,102,1356255263,1356255323,0,1,60
3,255,144,1356661260,1356661320,0,1,60
3,256,207,1356845603,1356845663,0,1,60
3,257,102,1356937560,1356937620,0,1,60
3,258,208,1356984539,1356985109,0,6,570
3,258,120,1356985109,1356985601,0,6,492
3,258,209,1356985601,1356986172,0,6,571
3,258,112,1356986172,1356992124,0,6,5952
3,258,210,1356992124,1356995155,0,6,3031
3,258,211,1356995155,1356995215,0,6,60
3,259,102,1357198159,1357198219,0,1,60
3,260,212,1357274433,1357274493,0,1,60
3,261,102,1357465820,1357465880,0,1,60
3,262,102,1357888044,1357888104,0,1,60
3,263,155,1358214727,1358216794,0,3,2067
3,263,213,1358216794,1358224632,0,3,7838
3,263,102,1358224632,1358224692,0,3,60
3,264,102,1359194844,1359194904,0,1,60
3,265,102,1359364252,1359364312,0,1,60
3,266,102,1359791971,1359792031,0,1,60
3,267,103,1359874503,1359884813,0,2,10310
3,267,102,1359884813,1359884873,0,2,60
3,268,214,1359977727,1359979023,0,4,1296
3,268,215,1359979023,1359980140,0,4,1117
3,268,216,1359980140,1359984292,0,4,4152
3,268,217,1359984292,1359984352,0,4,60
3,269,102,1360051080,1360051140,0,1,60
3,270,218,1360214835,1360223437,0,2,8602
3,270,102,1360223437,1360223497,0,2,60
3,271,219,1360319002,1360320708,0,2,1706
3,271,102,1360320708,1360320768,0,2,60
3,272,157,1360718790,1360718850,0,1,60
3,273,107,1360795343,1360805979,0,3,10636
3,273,121,1360805979,1360807274,0,3,1295
3,273,155,1360807274,1360807334,0,3,60
4,274,102,1360836079,1360836139,0,1,60
4,275,220,1333618624,1333618684,0,1,60
4,276,220,1333870623,1333870683,0,1,60
4,277,220,1334050677,1334050737,0,1,60
4,278,220,1334138445,1334138505,0,1,60
4,279,220,1334232530,1334232590,0,1,60
4,280,220,1334312321,1334312381,0,1,60
4,281,220,1334402693,1334402753,0,1,60
4,282,220,1334570671,1334570731,0,1,60
4,283,220,1334670017,1334670077,0,1,60
4,284,220,1334827625,1334827685,0,1,60
4,285,220,1334930271,1334930331,0,1,60
4,286,221,1334989981,1334992285,0,2,2304
4,286,220,1334992285,1334992345,0,2,60
4,287,222,1335076238,1335078418,0,2,2180
4,287,220,1335078418,1335078478,0,2,60
4,288,220,1335172962,1335173022,0,1,60
4,289,220,1335260518,1335260578,0,1,60
4,290,220,1335357544,1335357604,0,1,60
4,291,220,1335443568,1335443628,0,1,60
4,292,220,1335535553,1335535613,0,1,60
4,293,223,1335595174,1335598879,0,2,3705
4,293,220,1335598879,1335598939,0,2,60
4,294,223,1335685705,1335688884,0,2,3179
4,294,220,1335688884,1335688944,0,2,60
4,295,220,1335945451,1335945511,0,1,60
4,296,220,1336035312,1336035372,0,1,60
4,297,222,1336118459,1336120855,0,2,2396
4,297,220,1336120855,1336120915,0,2,60
4,298,222,1336201204,1336202501,0,2,1297
4,298,220,1336202501,1336202561,0,2,60
4,299,220,1336382471,1336382531,0,1,60
4,300,220,1336558658,1336558718,0,1,60
4,301,220,1336727462,1336727522,0,1,60
4,302,222,1336802828,1336805029,0,2,2201
4,302,220,1336805029,1336805089,0,2,60
4,303,222,1336895103,1336896148,0,2,1045
4,303,220,1336896148,1336896208,0,2,60
4,304,220,1336987185,1336987245,0,1,60
4,305,222,1337072807,1337072867,0,1,60
4,306,220,1337167049,1337167109,0,1,60
4,307,222,1337246312,1337250757,0,2,4445
4,307,220,1337250757,1337250817,0,2,60
4,308,220,1337401368,1337401428,0,1,60
4,309,220,1337594140,1337594200,0,1,60
4,310,220,1337702268,1337702328,0,1,60
4,311,222,1337851729,1337851789,0,1,60
4,312,220,1337952845,1337952905,0,1,60
4,313,220,1338000804,1338000864,0,1,60
4,314,222,1338100636,1338103799,0,2,3163
4,314,220,1338103799,1338103859,0,2,60
4,315,220,1338197129,1338197189,0,1,60
4,316,220,1338284400,1338284460,0,1,60
4,317,220,1338550797,1338550857,0,1,60
4,318,220,1338714032,1338714092,0,1,60
4,319,220,1338805794,1338805854,0,1,60
4,320,220,1338902389,1338902449,0,1,60
4,321,220,1338981626,1338981686,0,1,60
4,322,220,1339069254,1339069314,0,1,60
4,323,220,1339155550,1339155610,0,1,60
4,324,222,1339226013,1339228978,0,2,2965
4,324,220,1339228978,1339229038,0,2,60
4,325,220,1339314713,1339314773,0,1,60
4,326,220,1339416585,1339416645,0,1,60
4,327,220,1339498395,1339498455,0,1,60
4,328,220,1339594088,1339594148,0,1,60
4,329,224,1339916678,1339919054,0,2,2376
4,329,220,1339919054,1339919114,0,2,60
4,330,220,1340020763,1340020823,0,1,60
4,331,220,1340097643,1340097703,0,1,60
4,332,220,1340281908,1340281968,0,1,60
4,333,220,1340618711,1340618771,0,1,60
4,334,220,1340723997,1340724057,0,1,60
4,335,220,1340799612,1340799672,0,1,60
4,336,220,1341122488,1341122548,0,1,60
4,337,220,1341225035,1341225095,0,1,60
4,338,220,1341312837,1341312897,0,1,60
4,339,220,1341401503,1341401563,0,1,60
4,340,220,1341490779,1341490839,0,1,60
4,341,220,1341575467,1341575527,0,1,60
4,342,222,1341726927,1341729385,0,2,2458
4,342,220,1341729385,1341729445,0,2,60
4,343,222,1341817777,1341820686,0,2,2909
4,343,220,1341820686,1341820746,0,2,60
4,344,220,1342002565,1342002625,0,1,60
4,345,220,1342092259,1342092319,0,1,60
4,346,224,1342174286,1342176977,0,2,2691
4,346,220,1342176977,1342177037,0,2,60
4,347,220,1342246905,1342246965,0,1,60
4,348,5,1342341819,1342344624,0,2,2805
4,348,220,1342344624,1342344684,0,2,60
4,349,5,1342408782,1342413003,0,3,4221
4,349,220,1342413003,1342419724,0,3,6721
4,349,222,1342419724,1342419784,0,3,60
4,350,220,1342515436,1342515496,0,1,60
4,351,220,1343131575,1343131635,0,1,60
4,352,5,1343434929,1343440207,0,4,5278
4,352,225,1343440207,1343441462,0,4,1255
4,352,226,1343441462,1343443870,0,4,2408
4,352,220,1343443870,1343443930,0,4,60
4,353,222,1343541772,1343543989,0,2,2217
4,353,220,1343543989,1343544049,0,2,60
4,354,220,1343649681,1343649741,0,1,60
4,355,222,1344152890,1344152950,0,1,60
4,356,220,1344246921,1344246981,0,1,60
4,357,220,1344505045,1344505105,0,1,60
4,358,220,1344593241,1344593301,0,1,60
4,359,220,1344763616,1344763676,0,1,60
4,360,220,1344872236,1344872296,0,1,60
4,361,220,1345282927,1345282987,0,1,60
4,362,222,1345441900,1345444671,0,2,2771
4,362,220,1345444671,1345444731,0,2,60
4,363,220,1346839670,1346839730,0,1,60
4,364,220,1347545322,1347545382,0,1,60
4,365,222,1347699303,1347702794,0,2,3491
4,365,220,1347702794,1347702854,0,2,60
4,366,220,1350036616,1350036676,0,1,60
4,367,220,1350131748,1350131808,0,1,60
4,368,220,1350381178,1350381238,0,1,60
4,369,220,1350984999,1350985059,0,1,60
4,370,220,1351072012,1351072072,0,1,60
4,371,220,1351250019,1351250079,0,1,60
4,372,220,1351328462,1351328522,0,1,60
4,373,222,1351407018,1351408854,0,2,1836
4,373,220,1351408854,1351408914,0,2,60
4,374,220,1351503740,1351503800,0,1,60
4,375,220,1351677568,1351677628,0,1,60
4,376,220,1351763380,1351763440,0,1,60
4,377,220,1352109034,1352109094,0,1,60
4,378,220,1352194495,1352194555,0,1,60
4,379,220,1352282368,1352282428,0,1,60
4,380,220,1352368534,1352368594,0,1,60
4,381,220,1352456282,1352456342,0,1,60
4,382,222,1352613335,1352620780,0,2,7445
4,382,220,1352620780,1352620840,0,2,60
4,383,220,1352714010,1352714070,0,1,60
4,384,220,1353059751,1353059811,0,1,60
4,385,220,1353127440,1353127500,0,1,60
4,386,220,1353225375,1353225435,0,1,60
4,387,220,1353490274,1353490334,0,1,60
4,388,220,1353589194,1353589254,0,1,60
4,389,222,1353659132,1353664623,0,2,5491
4,389,220,1353664623,1353664683,0,2,60
4,390,222,1353827451,1353830263,0,2,2812
4,390,220,1353830263,1353830323,0,2,60
4,391,220,1353927962,1353928022,0,1,60
4,392,220,1354009854,1354009914,0,1,60
4,393,220,1354163345,1354163405,0,1,60
4,394,220,1354363533,1354363593,0,1,60
4,395,220,1354449808,1354449868,0,1,60
4,396,220,1354616007,1354616067,0,1,60
4,397,220,1354701890,1354701950,0,1,60
4,398,220,1354790052,1354790112,0,1,60
4,399,220,1354887706,1354887766,0,1,60
4,400,227,1354931110,1354938882,0,2,7772
4,400,220,1354938882,1354938942,0,2,60
4,401,228,1355033136,1355033196,0,1,60
4,402,220,1355219644,1355219704,0,1,60
4,403,222,1355556090,1355558099,0,2,2009
4,403,220,1355558099,1355558159,0,2,60
4,404,220,1355824354,1355824414,0,1,60
4,405,220,1355911483,1355911543,0,1,60
4,406,220,1356083110,1356083170,0,1,60
4,407,220,1356142050,1356142110,0,1,60
4,408,222,1356251776,1356251836,0,1,60
4,409,220,1356688179,1356688239,0,1,60
4,410,222,1356760979,1356764473,0,3,3494
4,410,220,1356764473,1356777728,0,3,13255
4,410,220,1356777728,1356777788,0,3,60
4,411,222,1356853988,1356856076,0,2,2088
4,411,220,1356856076,1356856136,0,2,60
4,412,220,1356936922,1356936982,0,1,60
4,413,220,1357020770,1357020830,0,1,60
4,414,220,1357122194,1357122254,0,1,60
4,415,220,1357189071,1357189131,0,1,60
4,416,222,1357281866,1357286148,0,2,4282
4,416,220,1357286148,1357286208,0,2,60
4,417,222,1357368836,1357372355,0,2,3519
4,417,220,1357372355,1357372415,0,2,60
4,418,222,1357453582,1357453642,0,1,60
4,419,228,1357529802,1357529862,0,1,60
4,420,220,1357640036,1357640096,0,1,60
4,421,220,1358243650,1358243710,0,1,60
4,422,220,1358330005,1358330065,0,1,60
4,423,220,1358417410,1358417470,0,1,60
4,424,220,1358502466,1358502526,0,1,60
4,425,220,1358847689,1358847749,0,1,60
4,426,220,1359106948,1359107008,0,1,60
4,427,222,1359270582,1359272191,0,2,1609
4,427,220,1359272191,1359272251,0,2,60
4,428,220,1359538986,1359539046,0,1,60
4,429,220,1359625745,1359625805,0,1,60
4,430,222,1359774977,1359775037,0,1,60
4,431,220,1359870871,1359870931,0,1,60
4,432,220,1360057212,1360057272,0,1,60
4,433,220,1360229710,1360229770,0,1,60
4,434,220,1360317221,1360317281,0,1,60
4,435,220,1360573067,1360573127,0,1,60
4,436,220,1360662297,1360662357,0,1,60
4,437,220,1360748668,1360748728,0,1,60
5,438,220,1360835276,1360835336,0,1,60
5,439,229,1337846883,1337848118,0,3,1235
5,439,230,1337848118,1337853747,0,3,5629
5,439,231,1337853747,1337853807,0,3,60
5,440,232,1337937932,1337949241,0,2,11309
5,440,233,1337949241,1337949301,0,2,60
5,441,234,1338005154,1338005530,0,8,376
5,441,5,1338005530,1338006696,0,8,1166
5,441,235,1338006696,1338010854,0,8,4158
5,441,236,1338010854,1338012958,0,8,2104
5,441,232,1338012958,1338014814,0,8,1856
5,441,237,1338014814,1338022829,0,8,8015
5,441,5,1338022829,1338023370,0,8,541
5,441,234,1338023370,1338023430,0,8,60
5,442,234,1338176388,1338189244,0,2,12856
5,442,238,1338189244,1338189304,0,2,60
5,443,234,1338285511,1338285691,0,2,180
5,443,239,1338285691,1338285751,0,2,60
5,444,240,1338542978,1338551200,0,2,8222
5,444,241,1338551200,1338551260,0,2,60
5,445,5,1338688292,1338689489,0,7,1197
5,445,230,1338689489,1338692525,0,7,3036
5,445,237,1338692525,1338692984,0,7,459
5,445,235,1338692984,1338695657,0,7,2673
5,445,242,1338695657,1338700137,0,7,4480
5,445,230,1338700137,1338703107,0,7,2970
5,445,242,1338703107,1338703167,0,7,60
5,446,5,1338711524,1338712154,0,3,630
5,446,234,1338712154,1338718374,0,3,6220
5,446,231,1338718374,1338718434,0,3,60
5,447,243,1338868381,1338869907,0,6,1526
5,447,244,1338869907,1338871584,0,6,1677
5,447,245,1338871584,1338872008,0,6,424
5,447,230,1338872008,1338877942,0,6,5934
5,447,242,1338877942,1338878286,0,6,344
5,447,237,1338878286,1338878346,0,6,60
5,448,231,1338890055,1338892150,0,2,2095
5,448,246,1338892150,1338892210,0,2,60
5,449,231,1339065008,1339065650,0,3,642
5,449,73,1339065650,1339070945,0,3,5295
5,449,73,1339070945,1339071005,0,3,60
5,450,241,1339216139,1339217321,0,9,1182
5,450,5,1339217321,1339217843,0,9,522
5,450,247,1339217843,1339218747,0,9,904
5,450,242,1339218747,1339220415,0,9,1668
5,450,230,1339220415,1339223939,0,9,3524
5,450,237,1339223939,1339227137,0,9,3198
5,450,248,1339227137,1339229238,0,9,2101
5,450,5,1339229238,1339231361,0,9,2123
5,450,231,1339231361,1339231421,0,9,60
5,451,234,1339291823,1339292229,0,3,406
5,451,5,1339292229,1339311092,0,3,18863
5,451,5,1339311092,1339311152,0,3,60
5,452,249,1339477110,1339498633,0,2,21523
5,452,230,1339498633,1339498693,0,2,60
5,453,244,1339505772,1339507580,0,2,1808
5,453,250,1339507580,1339507640,0,2,60
5,454,251,1339561736,1339562738,0,6,1002
5,454,231,1339562738,1339563666,0,6,928
5,454,5,1339563666,1339570689,0,6,7023
5,454,237,1339570689,1339580855,0,6,10166
5,454,5,1339580855,1339581957,0,6,1102
5,454,231,1339581957,1339582017,0,6,60
5,455,252,1339652130,1339652190,0,1,60
5,456,230,1339753497,1339754595,0,3,1098
5,456,237,1339754595,1339760186,0,3,5591
5,456,245,1339760186,1339760246,0,3,60
5,457,5,1339910835,1339914416,0,9,3581
5,457,245,1339914416,1339915059,0,9,643
5,457,237,1339915059,1339915634,0,9,575
5,457,242,1339915634,1339918138,0,9,2504
5,457,232,1339918138,1339920379,0,9,2241
5,457,5,1339920379,1339921789,0,9,1410
5,457,253,1339921789,1339922103,0,9,314
5,457,254,1339922103,1339926224,0,9,4121
5,457,255,1339926224,1339926284,0,9,60
5,458,253,1339939225,1339940679,0,2,1454
5,458,231,1339940679,1339940739,0,2,60
5,459,256,1340014163,1340015530,0,4,1367
5,459,35,1340015530,1340015816,0,4,286
5,459,257,1340015816,1340018470,0,4,2654
5,459,258,1340018470,1340018530,0,4,60
5,460,259,1340241978,1340249176,0,5,7198
5,460,233,1340249176,1340249699,0,5,523
5,460,245,1340249699,1340254769,0,5,5070
5,460,229,1340254769,1340256856,0,5,2087
5,460,242,1340256856,1340256916,0,5,60
5,461,248,1340263633,1340263693,0,1,60
5,462,260,1341994244,1341994637,0,7,393
5,462,261,1341994637,1341995448,0,7,811
5,462,262,1341995448,1341996784,0,7,1336
5,462,261,1341996784,1341997074,0,7,290
5,462,263,1341997074,1341997254,0,7,180
5,462,264,1341997254,1341998011,0,7,757
5,462,265,1341998011,1341998071,0,7,60
5,463,233,1342074427,1342075314,0,5,887
5,463,245,1342075314,1342080308,0,5,4994
5,463,242,1342080308,1342084993,0,5,4685
5,463,5,1342084993,1342086165,0,5,1172
5,463,35,1342086165,1342086225,0,5,60
5,464,266,1342239541,1342251476,0,7,11935
5,464,5,1342251476,1342252997,0,7,1521
5,464,267,1342252997,1342253609,0,7,612
5,464,268,1342253609,1342253949,0,7,340
5,464,258,1342253949,1342254352,0,7,403
5,464,269,1342254352,1342259540,0,7,5188
5,464,254,1342259540,1342259600,0,7,60
5,465,255,1342263647,1342263707,0,1,60
5,466,71,1342341023,1342342388,0,4,1365
5,466,270,1342342388,1342342553,0,4,165
5,466,271,1342342553,1342353966,0,4,11413
5,466,272,1342353966,1342354026,0,4,60
5,467,233,1342407888,1342408537,0,4,649
5,467,247,1342408537,1342413830,0,4,5293
5,467,5,1342413830,1342414335,0,4,505
5,467,234,1342414335,1342414395,0,4,60
5,468,50,1343128149,1343128209,0,1,60
5,469,273,1343449103,1343452856,0,3,3753
5,469,274,1343452856,1343457990,0,3,5134
5,469,275,1343457990,1343458050,0,3,60
5,470,50,1344504043,1344504647,0,4,604
5,470,5,1344504647,1344509643,0,4,4996
5,470,237,1344509643,1344511009,0,4,1366
5,470,276,1344511009,1344511069,0,4,60
5,471,5,1344676512,1344676910,0,3,398
5,471,242,1344676910,1344687080,0,3,10170
5,471,247,1344687080,1344687140,0,3,60
5,472,15,1344714555,1344714615,0,1,60
5,473,5,1344767056,1344767116,0,1,60
5,474,233,1344834012,1344834562,0,3,550
5,474,277,1344834562,1344836204,0,3,1642
5,474,237,1344836204,1344836264,0,3,60
5,475,5,1344919388,1344919607,0,3,219
5,475,242,1344919607,1344923930,0,3,4323
5,475,278,1344923930,1344923990,0,3,60
5,476,231,1345345587,1345346281,0,3,694
5,476,5,1345346281,1345351145,0,3,4864
5,476,237,1345351145,1345351205,0,3,60
5,477,279,1346842073,1346842133,0,1,60
5,478,5,1347686199,1347690565,0,7,4366
5,478,242,1347690565,1347691537,0,7,972
5,478,5,1347691537,1347692463,0,7,926
5,478,73,1347692463,1347698952,0,7,6489
5,478,5,1347698952,1347699538,0,7,586
5,478,280,1347699538,1347701514,0,7,1976
5,478,245,1347701514,1347701574,0,7,60
5,479,233,1350012031,1350013936,0,2,1905
5,479,242,1350013936,1350013996,0,2,60
5,480,231,1350102876,1350103823,0,5,947
5,480,281,1350103823,1350108154,0,5,4331
5,480,5,1350108154,1350108713,0,5,559
5,480,242,1350108713,1350110077,0,5,1364
5,480,282,1350110077,1350110137,0,5,60
5,481,281,1350963675,1350979153,0,2,15478
5,481,26,1350979153,1350979213,0,2,60
5,482,239,1351074664,1351074724,0,1,60
5,483,283,1351311204,1351316601,0,4,5397
5,483,282,1351316601,1351316991,0,4,390
5,483,236,1351316991,1351321473,0,4,4482
5,483,242,1351321473,1351321533,0,4,60
5,484,284,1351376661,1351377734,0,2,1073
5,484,285,1351377734,1351377794,0,2,60
5,485,286,1351398352,1351398412,0,1,60
5,486,5,1351490585,1351498982,0,3,8397
5,486,25,1351498982,1351499838,0,3,856
5,486,52,1351499838,1351499898,0,3,60
5,487,282,1351650529,1351656963,0,3,6434
5,487,242,1351656963,1351659226,0,3,2263
5,487,229,1351659226,1351659286,0,3,60
5,488,231,1351739646,1351739991,0,5,345
5,488,258,1351739991,1351740080,0,5,89
5,488,269,1351740080,1351750171,0,5,10091
5,488,268,1351750171,1351750859,0,5,688
5,488,231,1351750859,1351750919,0,5,60
5,489,8,1352373000,1352373060,0,1,60
5,490,287,1352512691,1352514813,0,2,2122
5,490,266,1352514813,1352514873,0,2,60
5,491,5,1353039124,1353039588,0,2,464
5,491,43,1353039588,1353039648,0,2,60
5,492,288,1353143467,1353143527,0,1,60
5,493,5,1353209726,1353209786,0,1,60
5,494,5,1353814403,1353822104,0,2,7701
5,494,20,1353822104,1353822164,0,2,60
5,495,253,1353837620,1353837680,0,1,60
5,496,233,1354429834,1354431044,0,3,1210
5,496,5,1354431044,1354436586,0,3,5542
5,496,244,1354436586,1354436646,0,3,60
5,497,5,1355116431,1355116491,0,1,60
5,498,285,1355532451,1355534523,0,3,2072
5,498,288,1355534523,1355549518,0,3,14995
5,498,5,1355549518,1355549578,0,3,60
5,499,284,1355560909,1355560969,0,1,60
5,500,5,1355818345,1355818405,0,1,60
5,501,289,1356608045,1356608105,0,1,60
5,502,290,1356659991,1356668009,0,2,8018
5,502,291,1356668009,1356668069,0,2,60
5,503,292,1356947307,1356947367,0,1,60
5,504,5,1357032347,1357032407,0,1,60
5,505,237,1357182329,1357187390,0,4,5061
5,505,293,1357187390,1357195129,0,4,7739
5,505,294,1357195129,1357200822,0,4,5693
5,505,47,1357200822,1357200882,0,4,60
5,506,230,1357368285,1357371495,0,2,3210
5,506,245,1357371495,1357371555,0,2,60
5,507,5,1357535092,1357535410,0,4,318
5,507,52,1357535410,1357535984,0,4,574
5,507,291,1357535984,1357536663,0,4,679
5,507,235,1357536663,1357536723,0,4,60
5,508,5,1358227432,1358228961,0,2,1529
5,508,282,1358228961,1358229021,0,2,60
5,509,258,1358483189,1358489803,0,3,6614
5,509,5,1358489803,1358490201,0,3,398
5,509,282,1358490201,1358490261,0,3,60
5,510,245,1358508241,1358508301,0,1,60
5,511,281,1358846933,1358846993,0,1,60
5,512,237,1359087011,1359101287,0,3,14276
5,512,260,1359101287,1359101586,0,3,299
5,512,295,1359101586,1359101646,0,3,60
5,513,239,1359508860,1359527139,0,2,18279
5,513,296,1359527139,1359527199,0,2,60
5,514,297,1359690478,1359691993,0,2,1515
5,514,298,1359691993,1359692053,0,2,60
5,515,5,1360146853,1360148168,0,2,1315
5,515,235,1360148168,1360148228,0,2,60
5,516,73,1360297662,1360297821,0,4,159
5,516,239,1360297821,1360308347,0,4,10526
5,516,5,1360308347,1360314633,0,4,6286
5,516,299,1360314633,1360314693,0,4,60
5,517,300,1360322000,1360324014,0,2,2014
5,517,235,1360324014,1360324074,0,2,60
5,518,284,1360544249,1360544253,0,4,4
5,518,235,1360544253,1360545338,0,4,1085
5,518,285,1360545338,1360551922,0,4,6584
5,518,301,1360551922,1360551982,0,4,60
5,519,5,1360817147,1360817207,0,1,60
6,520,302,1360844627,1360844687,0,1,60
6,521,303,1333490309,1333490369,0,1,60
6,522,304,1333532595,1333532655,0,1,60
6,523,303,1333574927,1333574987,0,1,60
6,524,305,1333862457,1333863791,0,4,1334
6,524,306,1333863791,1333868813,0,4,5022
6,524,307,1333868813,1333870134,0,4,1321
6,524,308,1333870134,1333870194,0,4,60
6,525,303,1333920970,1333921030,0,1,60
6,526,303,1334527629,1334527689,0,1,60
6,527,309,1334572159,1334577413,0,2,5254
6,527,310,1334577413,1334577473,0,2,60
6,528,303,1334612188,1334612248,0,1,60
6,529,303,1334698054,1334698114,0,1,60
6,530,303,1334784732,1334784792,0,1,60
6,531,303,1334871195,1334871255,0,1,60
6,532,311,1335054317,1335054377,0,1,60
6,533,306,1335093756,1335093816,0,1,60
6,534,303,1335132815,1335132875,0,1,60
6,535,303,1335218883,1335218943,0,1,60
6,536,312,1335269425,1335269485,0,1,60
6,537,303,1335564709,1335564769,0,1,60
6,538,313,1335586972,1335587955,0,2,983
6,538,314,1335587955,1335588015,0,2,60
6,539,303,1335680445,1335682687,0,4,2242
6,539,315,1335682687,1335683682,0,4,995
6,539,316,1335683682,1335694767,0,4,11085
6,539,317,1335694767,1335694827,0,4,60
6,540,303,1335918675,1335927273,0,2,8598
6,540,318,1335927273,1335927333,0,2,60
6,541,319,1335942271,1335942331,0,1,60
6,542,320,1336361188,1336361248,0,1,60
6,543,321,1336393026,1336393086,0,1,60
6,544,303,1336427607,1336427667,0,1,60
6,545,321,1336476258,1336476318,0,1,60
6,546,303,1336514094,1336514154,0,1,60
6,547,322,1336560957,1336569035,0,2,8078
6,547,306,1336569035,1336569095,0,2,60
6,548,303,1336686005,1336686065,0,1,60
6,549,303,1336771875,1336771935,0,1,60
6,550,323,1336893416,1336894329,0,2,913
6,550,324,1336894329,1336894389,0,2,60
6,551,303,1336946333,1336946393,0,1,60
6,552,303,1337032959,1337033019,0,1,60
6,553,303,1337118588,1337118648,0,1,60
6,554,303,1337205453,1337205513,0,1,60
6,555,303,1337291928,1337291988,0,1,60
6,556,284,1337375694,1337375754,0,1,60
6,557,325,1337603275,1337603335,0,1,60
6,558,303,1337636188,1337636248,0,1,60
6,559,326,1337699465,1337699525,0,1,60
6,560,303,1337810035,1337810095,0,1,60
6,561,303,1338240856,1338240916,0,1,60
6,562,303,1338328209,1338328269,0,1,60
6,563,303,1338501111,1338501171,0,1,60
6,564,260,1338549453,1338551922,0,3,2469
6,564,327,1338551922,1338556145,0,3,4223
6,564,328,1338556145,1338556205,0,3,60
6,565,303,1338680924,1338683466,0,2,2542
6,565,329,1338683466,1338683526,0,2,60
6,566,100,1338715601,1338717509,0,2,1908
6,566,330,1338717509,1338717569,0,2,60
6,567,331,1338780913,1338780973,0,1,60
6,568,321,1338808543,1338808603,0,1,60
6,569,303,1338847675,1338847735,0,1,60
6,570,332,1338898864,1338898924,0,1,60
6,571,321,1338984579,1338984639,0,1,60
6,572,303,1339020310,1339020370,0,1,60
6,573,303,1339105957,1339106017,0,1,60
6,574,333,1339157504,1339157564,0,1,60
6,575,334,1339246041,1339246101,0,1,60
6,576,335,1339498040,1339507052,0,2,9012
6,576,336,1339507052,1339507112,0,2,60
6,577,303,1339538208,1339538268,0,1,60
6,578,303,1339969795,1339969855,0,1,60
6,579,333,1340100781,1340101482,0,2,701
6,579,337,1340101482,1340101542,0,2,60
6,580,303,1340228937,1340228997,0,1,60
6,581,303,1341265903,1341286846,0,2,20943
6,581,338,1341286846,1341286906,0,2,60
6,582,339,1341320624,1341320684,0,1,60
6,583,303,1341352584,1341352644,0,1,60
6,584,340,1341409734,1341409794,0,1,60
6,585,303,1341438906,1341438966,0,1,60
6,586,321,1341491658,1341491718,0,1,60
6,587,303,1341525415,1341525475,0,1,60
6,588,341,1341611916,1341611976,0,1,60
6,589,303,1341721411,1341727665,0,3,6254
6,589,342,1341727665,1341731288,0,3,3623
6,589,343,1341731288,1341731348,0,3,60
6,590,303,1341782667,1341782727,0,1,60
6,591,303,1341870997,1341871057,0,1,60
6,592,306,1342102933,1342102993,0,1,60
6,593,303,1342130245,1342130305,0,1,60
6,594,344,1342182090,1342182150,0,1,60
6,595,345,1342244537,1342244597,0,1,60
6,596,306,1342358065,1342358125,0,1,60
6,597,303,1342562322,1342562382,0,1,60
6,598,306,1342619762,1342619822,0,1,60
6,599,303,1342648698,1342648758,0,1,60
6,600,346,1342791007,1342791067,0,1,60
6,601,303,1342828139,1342828199,0,1,60
6,602,303,1343339882,1343339942,0,1,60
6,603,303,1343546203,1343550723,0,3,4520
6,603,347,1343550723,1343553992,0,3,3269
6,603,348,1343553992,1343554052,0,3,60
6,604,303,1343685447,1343685507,0,1,60
6,605,303,1344203081,1344203141,0,1,60
6,606,349,1344569989,1344570049,0,1,60
6,607,346,1344606750,1344606810,0,1,60
6,608,303,1344675020,1344678128,0,2,3108
6,608,350,1344678128,1344678188,0,2,60
6,609,331,1344915523,1344915583,0,1,60
6,610,303,1345245971,1345246031,0,1,60
6,611,351,1345380457,1345380517,0,1,60
6,612,303,1347227736,1347227796,0,1,60
6,613,303,1347665093,1347665153,0,1,60
6,614,303,1349733599,1349733659,0,1,60
6,615,303,1350597403,1350597463,0,1,60
6,616,303,1350943436,1350943496,0,1,60
6,617,303,1351029661,1351029721,0,1,60
6,618,306,1351079913,1351086101,0,2,6188
6,618,352,1351086101,1351086161,0,2,60
6,619,303,1351200285,1351200345,0,1,60
6,620,303,1351287651,1351287711,0,1,60
6,621,303,1351459889,1351459949,0,1,60
6,622,303,1352152728,1352152788,0,1,60
6,623,303,1352239152,1352239212,0,1,60
6,624,306,1352288008,1352288068,0,1,60
6,625,303,1353102697,1353102757,0,1,60
6,626,35,1353127357,1353127417,0,1,60
6,627,303,1353362430,1353362490,0,1,60
6,628,303,1353448667,1353468755,0,2,20088
6,628,260,1353468755,1353468815,0,2,60
6,629,303,1353627959,1353628019,0,1,60
6,630,343,1353654378,1353654438,0,1,60
6,631,303,1353708340,1353708400,0,1,60
6,632,303,1354140024,1354140084,0,1,60
6,633,303,1354224231,1354224291,0,1,60
6,634,353,1354431093,1354431153,0,1,60
6,635,303,1354481030,1354481090,0,1,60
6,636,303,1354829797,1354829857,0,1,60
6,637,303,1354917340,1354917400,0,1,60
6,638,354,1355040170,1355040230,0,1,60
6,639,303,1355086526,1355086586,0,1,60
6,640,303,1355263210,1355263270,0,1,60
6,641,303,1355348314,1355348374,0,1,60
6,642,303,1355563298,1355563358,0,1,60
6,643,303,1355866970,1355867030,0,1,60
6,644,355,1356610852,1356610912,0,1,60
6,645,303,1357109580,1357119943,0,2,10363
6,645,356,1357119943,1357120003,0,2,60
6,646,303,1357335581,1357335641,0,1,60
6,647,303,1357767715,1357767775,0,1,60
6,648,331,1357875585,1357875645,0,1,60
6,649,303,1358459802,1358459862,0,1,60
6,650,303,1358804146,1358804206,0,1,60
6,651,303,1359150081,1359150141,0,1,60
6,652,357,1359285966,1359286026,0,1,60
6,653,355,1359460816,1359460876,0,1,60
6,654,322,1359538208,1359538268,0,1,60
6,655,303,1359756062,1359756122,0,1,60
6,656,358,1359884033,1359884394,0,2,361
6,656,357,1359884394,1359884454,0,2,60
6,657,303,1359927376,1359927436,0,1,60
6,658,303,1360188059,1360188119,0,1,60
6,659,303,1360532082,1360532142,0,1,60
6,660,357,1360579652,1360579712,0,1,60
7,661,303,1360706223,1360706283,0,1,60
7,662,359,1333724605,1333724665,0,1,60
7,663,360,1333927160,1333927220,0,1,60
7,664,361,1334286580,1334286640,0,1,60
7,665,5,1334314700,1334318426,0,2,3726
7,665,362,1334318426,1334318486,0,2,60
7,666,363,1334376169,1334376229,0,1,60
7,667,364,1334408214,1334408274,0,1,60
7,668,365,1334466404,1334466464,0,1,60
7,669,366,1334564378,1334569512,0,3,5134
7,669,367,1334569512,1334581829,0,3,12317
7,669,253,1334581829,1334581889,0,3,60
7,670,368,1334896868,1334896928,0,1,60
7,671,369,1335009821,1335009881,0,1,60
7,672,366,1335176916,1335187734,0,2,10818
7,672,370,1335187734,1335187794,0,2,60
7,673,371,1335273302,1335273362,0,1,60
7,674,366,1335415120,1335415180,0,1,60
7,675,360,1335535115,1335535175,0,1,60
7,676,372,1335683953,1335684013,0,1,60
7,677,361,1335935347,1335935407,0,1,60
7,678,284,1336098944,1336102212,0,2,3268
7,678,11,1336102212,1336102272,0,2,60
7,679,373,1336204126,1336205994,0,2,1868
7,679,284,1336205994,1336206054,0,2,60
7,680,374,1336228601,1336228661,0,1,60
7,681,375,1336349513,1336349573,0,1,60
7,682,376,1336570038,1336570098,0,1,60
7,683,372,1336795114,1336796016,0,3,902
7,683,284,1336796016,1336802361,0,3,6345
7,683,377,1336802361,1336802421,0,3,60
7,684,284,1336882860,1336886464,0,3,3604
7,684,378,1336886464,1336902088,0,3,15624
7,684,379,1336902088,1336902148,0,3,60
7,685,377,1336904921,1336906191,0,2,1270
7,685,380,1336906191,1336906251,0,2,60
7,686,361,1336964478,1336964538,0,1,60
7,687,381,1337258882,1337258942,0,1,60
7,688,284,1337351447,1337351507,0,1,60
7,689,369,1337426239,1337426299,0,1,60
7,690,371,1337692413,1337692473,0,1,60
7,691,382,1338097844,1338097904,0,1,60
7,692,383,1338474407,1338474467,0,1,60
7,693,371,1338815636,1338815696,0,1,60
7,694,371,1338992162,1338994287,0,2,2125
7,694,384,1338994287,1338994347,0,2,60
7,695,385,1339041577,1339041637,0,1,60
7,696,386,1339156291,1339156351,0,1,60
7,697,369,1339244703,1339244763,0,1,60
7,698,387,1339301796,1339301856,0,1,60
7,699,388,1339581296,1339581356,0,1,60
7,700,360,1339768927,1339768987,0,1,60
7,701,284,1339891729,1339892966,0,2,1237
7,701,389,1339892966,1339893026,0,2,60
7,702,5,1339915228,1339935378,0,2,20150
7,702,390,1339935378,1339935438,0,2,60
7,703,371,1340026582,1340026642,0,1,60
7,704,391,1340247508,1340247568,0,1,60
7,705,392,1341284278,1341284338,0,1,60
7,706,372,1341320341,1341320401,0,1,60
7,707,368,1341372256,1341372316,0,1,60
7,708,372,1341493456,1341493516,0,1,60
7,709,393,1341546834,1341546894,0,1,60
7,710,394,1341629044,1341636242,0,3,7198
7,710,395,1341636242,1341639315,0,3,3073
7,710,298,1341639315,1341639375,0,3,60
7,711,396,1341814607,1341814667,0,1,60
7,712,360,1341876464,1341876524,0,1,60
7,713,366,1342147168,1342147228,0,1,60
7,714,371,1342169800,1342169860,0,1,60
7,715,284,1342340224,1342340284,0,1,60
7,716,284,1342428778,1342430859,0,2,2081
7,716,397,1342430859,1342430919,0,2,60
7,717,398,1342502588,1342502648,0,1,60
7,718,35,1343438500,1343440317,0,4,1817
7,718,399,1343440317,1343449224,0,4,8907
7,718,400,1343449224,1343458196,0,4,8972
7,718,378,1343458196,1343458256,0,4,60
7,719,401,1344511230,1344511290,0,1,60
7,720,361,1344571398,1344571458,0,1,60
7,721,402,1344643399,1344644686,0,2,1287
7,721,403,1344644686,1344644746,0,2,60
7,722,404,1344692652,1344697483,0,2,4831
7,722,405,1344697483,1344697543,0,2,60
7,723,360,1344815175,1344815235,0,1,60
7,724,399,1345253719,1345264062,0,2,10343
7,724,406,1345264062,1345264122,0,2,60
7,725,407,1345292369,1345292429,0,1,60
7,726,361,1345435608,1345435668,0,1,60
7,727,408,1350397283,1350397343,0,1,60
7,728,371,1351074762,1351074822,0,1,60
7,729,35,1351325922,1351325982,0,1,60
7,730,366,1351482086,1351482146,0,1,60
7,731,384,1352205786,1352205846,0,1,60
7,732,360,1352287641,1352287701,0,1,60
7,733,409,1352373749,1352373809,0,1,60
7,734,371,1352469396,1352469456,0,1,60
7,735,410,1352626024,1352626980,0,2,956
7,735,410,1352626980,1352627040,0,2,60
7,736,284,1353146740,1353154919,0,2,8179
7,736,369,1353154919,1353154979,0,2,60
7,737,378,1353228937,1353228997,0,1,60
7,738,411,1353393100,1353404515,0,2,11415
7,738,388,1353404515,1353404575,0,2,60
7,739,371,1353544653,1353544713,0,1,60
7,740,284,1353583931,1353588852,0,2,4921
7,740,377,1353588852,1353588912,0,2,60
7,741,360,1355097612,1355108955,0,2,11343
7,741,366,1355108955,1355109015,0,2,60
7,742,359,1355231560,1355231620,0,1,60
7,743,375,1355494164,1355494224,0,1,60
7,744,412,1355644635,1355644695,0,1,60
7,745,413,1355739401,1355739461,0,1,60
7,746,414,1355923889,1355923949,0,1,60
7,747,371,1355962639,1355962699,0,1,60
7,748,415,1356168450,1356168510,0,1,60
7,749,415,1356259739,1356259799,0,1,60
7,750,24,1356686704,1356686764,0,1,60
7,751,416,1356844603,1356844663,0,1,60
7,752,399,1357348938,1357360315,0,2,11377
7,752,417,1357360315,1357360375,0,2,60
7,753,418,1357386112,1357386172,0,1,60
7,754,419,1357529002,1357529062,0,1,60
7,755,378,1359182908,1359182968,0,1,60
7,756,420,1359286500,1359286560,0,1,60
7,757,360,1359676930,1359676990,0,1,60
7,758,375,1360109374,1360109434,0,1,60
7,759,421,1360644619,1360644679,0,1,60
7,760,371,1360753901,1360753961,0,1,60
7,761,422,1360803117,1360803177,0,1,60
8,762,423,1360840051,1360840111,0,1,60
8,763,77,1333503390,1333503450,0,1,60
8,764,21,1333537045,1333538751,0,2,1706
8,764,77,1333538751,1333538811,0,2,60
8,765,77,1333850015,1333850310,0,3,295
8,765,424,1333850310,1333866850,0,3,16540
8,765,425,1333866850,1333866910,0,3,60
8,766,284,1333871775,1333874023,0,3,2248
8,766,425,1333874023,1333874500,0,3,477
8,766,426,1333874500,1333874560,0,3,60
8,767,21,1333970210,1333971435,0,3,1225
8,767,77,1333971435,1333974401,0,3,2966
8,767,427,1333974401,1333974461,0,3,60
8,768,77,1334108476,1334109976,0,2,1500
8,768,21,1334109976,1334110036,0,2,60
8,769,21,1334141247,1334142483,0,2,1236
8,769,77,1334142483,1334142543,0,2,60
8,770,21,1334197064,1334197124,0,1,60
8,771,21,1334229681,1334231344,0,2,1663
8,771,77,1334231344,1334231404,0,2,60
8,772,77,1334281616,1334282247,0,3,631
8,772,428,1334282247,1334283256,0,3,1009
8,772,21,1334283256,1334283316,0,3,60
8,773,21,1334315912,1334317160,0,3,1248
8,773,77,1334317160,1334317179,0,3,19
8,773,429,1334317179,1334317239,0,3,60
8,774,77,1334367462,1334370144,0,2,2682
8,774,21,1334370144,1334370204,0,2,60
8,775,430,1334408851,1334408911,0,1,60
8,776,21,1334487121,1334488665,0,3,1544
8,776,77,1334488665,1334489892,0,3,1227
8,776,431,1334489892,1334489952,0,3,60
8,777,431,1334575645,1334575705,0,1,60
8,778,21,1334659303,1334660831,0,2,1528
8,778,77,1334660831,1334660891,0,2,60
8,779,77,1334799350,1334800754,0,2,1404
8,779,21,1334800754,1334800814,0,2,60
8,780,432,1334833424,1334838837,0,3,5413
8,780,21,1334838837,1334840308,0,3,1471
8,780,77,1334840308,1334840368,0,3,60
8,781,21,1334888340,1334888400,0,1,60
8,782,433,1334920254,1334923200,0,2,2946
8,782,77,1334923200,1334923260,0,2,60
8,783,77,1334972505,1334973364,0,2,859
8,783,428,1334973364,1334973424,0,2,60
8,784,77,1335009472,1335009532,0,1,60
8,785,21,1335147371,1335147431,0,1,60
8,786,21,1335179513,1335179573,0,1,60
8,787,77,1335404216,1335404276,0,1,60
8,788,21,1335523665,1335524039,0,5,374
8,788,5,1335524039,1335524761,0,5,722
8,788,6,1335524761,1335526998,0,5,2237
8,788,434,1335526998,1335529493,0,5,2495
8,788,77,1335529493,1335529553,0,5,60
8,789,21,1335578196,1335578256,0,1,60
8,790,77,1335605197,1335605257,0,1,60
8,791,21,1335924244,1335924304,0,1,60
8,792,21,1335958786,1335960467,0,2,1681
8,792,77,1335960467,1335960527,0,2,60
8,793,77,1336354387,1336354447,0,1,60
8,794,77,1336390695,1336390755,0,1,60
8,795,435,1336473903,1336473963,0,1,60
8,796,77,1336527978,1336529823,0,2,1845
8,796,21,1336529823,1336529883,0,2,60
8,797,21,1336562026,1336562765,0,2,739
8,797,77,1336562765,1336562825,0,2,60
8,798,21,1336732788,1336733889,0,2,1101
8,798,11,1336733889,1336733949,0,2,60
8,799,77,1336787041,1336788763,0,2,1722
8,799,21,1336788763,1336788823,0,2,60
8,800,21,1336819750,1336820688,0,3,938
8,800,77,1336820688,1336827984,0,3,7296
8,800,436,1336827984,1336828044,0,3,60
8,801,437,1336871499,1336872385,0,3,886
8,801,297,1336872385,1336873391,0,3,1006
8,801,438,1336873391,1336873451,0,3,60
8,802,21,1336906495,1336907875,0,2,1380
8,802,77,1336907875,1336907935,0,2,60
8,803,77,1336966967,1336968817,0,4,1850
8,803,21,1336968817,1336971534,0,4,2717
8,803,439,1336971534,1336981201,0,4,9667
8,803,440,1336981201,1336981261,0,4,60
8,804,77,1337219180,1337219240,0,1,60
8,805,21,1337254053,1337254113,0,1,60
8,806,77,1337391784,1337393792,0,2,2008
8,806,21,1337393792,1337393852,0,2,60
8,807,21,1337426805,1337428081,0,2,1276
8,807,77,1337428081,1337428141,0,2,60
8,808,21,1337683937,1337683997,0,1,60
8,809,77,1337823975,1337825788,0,2,1813
8,809,21,1337825788,1337825848,0,2,60
8,810,21,1337944296,1337944649,0,2,353
8,810,77,1337944649,1337944709,0,2,60
8,811,77,1338126569,1338128917,0,3,2348
8,811,441,1338128917,1338128952,0,3,35
8,811,442,1338128952,1338129012,0,3,60
8,812,77,1338168659,1338170404,0,2,1745
8,812,21,1338170404,1338170464,0,2,60
8,813,77,1338203731,1338203791,0,1,60
8,814,77,1338255938,1338255998,0,1,60
8,815,77,1338342204,1338342264,0,1,60
8,816,77,1338723958,1338724018,0,1,60
8,817,77,1338770793,1338772230,0,2,1437
8,817,21,1338772230,1338772290,0,2,60
8,818,77,1338860154,1338860214,0,1,60
8,819,21,1338896313,1338896373,0,1,60
8,820,21,1338981248,1338982179,0,2,931
8,820,77,1338982179,1338982239,0,2,60
8,821,77,1339031535,1339032606,0,2,1071
8,821,443,1339032606,1339032666,0,2,60
8,822,21,1339065696,1339069187,0,4,3491
8,822,443,1339069187,1339069550,0,4,363
8,822,77,1339069550,1339071018,0,4,1468
8,822,431,1339071018,1339071078,0,4,60
8,823,443,1339206742,1339207001,0,3,259
8,823,428,1339207001,1339208108,0,3,1107
8,823,21,1339208108,1339208168,0,3,60
8,824,21,1339240151,1339241170,0,4,1019
8,824,443,1339241170,1339241476,0,4,306
8,824,77,1339241476,1339245078,0,4,3602
8,824,444,1339245078,1339245138,0,4,60
8,825,21,1339293561,1339293621,0,1,60
8,826,21,1339326302,1339326362,0,1,60
8,827,260,1339379447,1339380048,0,2,601
8,827,21,1339380048,1339380108,0,2,60
8,828,5,1339414733,1339417896,0,3,3163
8,828,445,1339417896,1339417911,0,3,15
8,828,431,1339417911,1339417971,0,3,60
8,829,21,1339467386,1339467446,0,1,60
8,830,21,1339499059,1339499119,0,1,60
8,831,77,1339549512,1339550697,0,2,1185
8,831,21,1339550697,1339550757,0,2,60
8,832,21,1339584948,1339585008,0,1,60
8,833,445,1339658104,1339658124,0,2,20
8,833,431,1339658124,1339658184,0,2,60
8,834,431,1339757238,1339757298,0,1,60
8,835,77,1339897316,1339897376,0,1,60
8,836,445,1339936109,1339936128,0,2,19
8,836,431,1339936128,1339936188,0,2,60
8,837,77,1339983310,1339984630,0,2,1320
8,837,21,1339984630,1339984690,0,2,60
8,838,443,1340017976,1340020666,0,2,2690
8,838,431,1340020666,1340020726,0,2,60
8,839,77,1340269284,1340269481,0,5,197
8,839,443,1340269481,1340270524,0,5,1043
8,839,21,1340270524,1340271027,0,5,503
8,839,5,1340271027,1340281089,0,5,10062
8,839,21,1340281089,1340281149,0,5,60
8,840,443,1341108130,1341109164,0,2,1034
8,840,21,1341109164,1341109224,0,2,60
8,841,446,1341296714,1341296774,0,1,60
8,842,447,1341450439,1341452577,0,3,2138
8,842,77,1341452577,1341454734,0,3,2157
8,842,21,1341454734,1341454794,0,3,60
8,843,21,1341485579,1341486712,0,2,1133
8,843,443,1341486712,1341486772,0,2,60
8,844,21,1341571648,1341572521,0,3,873
8,844,448,1341572521,1341572757,0,3,236
8,844,443,1341572757,1341572817,0,3,60
8,845,77,1341625002,1341626765,0,2,1763
8,845,21,1341626765,1341626825,0,2,60
8,846,21,1341658680,1341660209,0,3,1529
8,846,449,1341660209,1341660987,0,3,778
8,846,450,1341660987,1341661047,0,3,60
8,847,451,1341739579,1341739622,0,2,43
8,847,452,1341739622,1341739682,0,2,60
8,848,443,1341971995,1341972303,0,2,308
8,848,260,1341972303,1341972363,0,2,60
8,849,21,1342008150,1342009020,0,3,870
8,849,443,1342009020,1342009993,0,3,973
8,849,453,1342009993,1342010053,0,3,60
8,850,77,1342057736,1342057796,0,1,60
8,851,21,1342092247,1342093929,0,2,1682
8,851,443,1342093929,1342093989,0,2,60
8,852,443,1342144468,1342144528,0,1,60
8,853,454,1342179490,1342179550,0,1,60
8,854,442,1342229309,1342231961,0,3,2652
8,854,443,1342231961,1342232706,0,3,745
8,854,21,1342232706,1342232766,0,3,60
8,855,21,1342263329,1342263389,0,1,60
8,856,447,1342487383,1342489620,0,3,2237
8,856,77,1342489620,1342489901,0,3,281
8,856,443,1342489901,1342489961,0,3,60
8,857,21,1342523833,1342525191,0,2,1358
8,857,77,1342525191,1342525251,0,2,60
8,858,447,1342656179,1342656239,0,1,60
8,859,21,1343127045,1343127723,0,2,678
8,859,443,1343127723,1343127783,0,2,60
8,860,442,1343452020,1343469170,0,2,17150
8,860,455,1343469170,1343469230,0,2,60
8,861,77,1343612228,1343614630,0,2,2402
8,861,21,1343614630,1343614690,0,2,60
8,862,21,1343645879,1343646715,0,2,836
8,862,443,1343646715,1343646775,0,2,60
8,863,77,1344217681,1344217946,0,2,265
8,863,443,1344217946,1344218006,0,2,60
8,864,21,1344249819,1344249879,0,1,60
8,865,21,1344510484,1344510544,0,1,60
8,866,21,1344572256,1344572316,0,1,60
8,867,21,1344595654,1344597196,0,2,1542
8,867,449,1344597196,1344597256,0,2,60
8,868,456,1344685924,1344685984,0,1,60
8,869,77,1344822205,1344822265,0,1,60
8,870,77,1344908696,1344909113,0,3,417
8,870,443,1344909113,1344910634,0,3,1521
8,870,21,1344910634,1344910694,0,3,60
8,871,428,1344947264,1344947637,0,2,373
8,871,443,1344947637,1344947697,0,2,60
8,872,77,1345168556,1345168763,0,2,207
8,872,443,1345168763,1345168823,0,2,60
8,873,77,1345239330,1345239390,0,1,60
8,874,457,1345386121,1345386181,0,1,60
8,875,458,1345468220,1345468280,0,1,60
8,876,21,1346844721,1346844781,0,1,60
8,877,77,1346895861,1346898805,0,2,2944
8,877,21,1346898805,1346898865,0,2,60
8,878,443,1347241869,1347241929,0,1,60
8,879,21,1349696413,1349696473,0,1,60
8,880,428,1350007190,1350007250,0,1,60
8,881,21,1350041311,1350043275,0,2,1964
8,881,459,1350043275,1350043335,0,2,60
8,882,77,1350092945,1350095095,0,2,2150
8,882,21,1350095095,1350095155,0,2,60
8,883,21,1350128428,1350128488,0,1,60
8,884,430,1350382167,1350382227,0,1,60
8,885,460,1350467048,1350467108,0,1,60
8,886,21,1350613077,1350613137,0,1,60
8,887,21,1350904067,1350904127,0,1,60
8,888,77,1350960133,1350963227,0,5,3094
8,888,461,1350963227,1350967325,0,5,4098
8,888,284,1350967325,1350975480,0,5,8155
8,888,462,1350975480,1350978563,0,5,3083
8,888,5,1350978563,1350978623,0,5,60
8,889,463,1351084724,1351084784,0,1,60
8,890,21,1351131978,1351132038,0,1,60
8,891,21,1351163103,1351163693,0,3,590
8,891,5,1351163693,1351165203,0,3,1510
8,891,16,1351165203,1351165263,0,3,60
8,892,21,1351213388,1351213448,0,1,60
8,893,464,1351251745,1351251805,0,1,60
8,894,465,1351308264,1351314782,0,4,6518
8,894,466,1351314782,1351317517,0,4,2735
8,894,77,1351317517,1351326134,0,4,8617
8,894,430,1351326134,1351326194,0,4,60
8,895,456,1351343589,1351343649,0,1,60
8,896,467,1351410804,1351419099,0,2,8295
8,896,468,1351419099,1351419159,0,2,60
8,897,447,1351645869,1351649927,0,2,4058
8,897,21,1351649927,1351649987,0,2,60
8,898,459,1351685060,1351685120,0,1,60
8,899,21,1351736334,1351736394,0,1,60
8,900,469,1351767729,1351767789,0,1,60
8,901,443,1351857720,1351858072,0,2,352
8,901,443,1351858072,1351858132,0,2,60
8,902,21,1352114881,1352115247,0,2,366
8,902,443,1352115247,1352115307,0,2,60
8,903,21,1352201081,1352201141,0,1,60
8,904,77,1352252741,1352252801,0,1,60
8,905,21,1352291449,1352291509,0,1,60
8,906,470,1352379103,1352379163,0,1,60
8,907,77,1352684995,1352685055,0,1,60
8,908,21,1352720521,1352720581,0,1,60
8,909,447,1352768823,1352772749,0,2,3926
8,909,21,1352772749,1352772809,0,2,60
8,910,77,1353029742,1353032355,0,2,2613
8,910,21,1353032355,1353032415,0,2,60
8,911,471,1353065373,1353065433,0,1,60
8,912,77,1353203587,1353204927,0,2,1340
8,912,21,1353204927,1353204987,0,2,60
8,913,21,1353238400,1353240704,0,2,2304
8,913,472,1353240704,1353240764,0,2,60
8,914,447,1353373985,1353378161,0,2,4176
8,914,21,1353378161,1353378221,0,2,60
8,915,447,1353460216,1353462124,0,2,1908
8,915,77,1353462124,1353462184,0,2,60
8,916,473,1353584736,1353584796,0,1,60
8,917,21,1353723511,1353723571,0,1,60
8,918,454,1353755131,1353755191,0,1,60
8,919,21,1353810032,1353810092,0,1,60
8,920,77,1353981108,1353981168,0,1,60
8,921,458,1354293494,1354293554,0,1,60
8,922,77,1354499582,1354500982,0,2,1400
8,922,21,1354500982,1354501042,0,2,60
8,923,21,1354532874,1354532934,0,1,60
8,924,21,1354587544,1354587604,0,1,60
8,925,21,1354620192,1354620252,0,1,60
8,926,474,1354661536,1354664739,0,2,3203
8,926,11,1354664739,1354664799,0,2,60
8,927,21,1354760377,1354760437,0,1,60
8,928,475,1354879655,1354880921,0,2,1266
8,928,476,1354880921,1354880981,0,2,60
8,929,77,1354931329,1354933239,0,2,1910
8,929,21,1354933239,1354933299,0,2,60
8,930,21,1354965045,1354965105,0,1,60
8,931,77,1355017983,1355019660,0,2,1677
8,931,21,1355019660,1355019720,0,2,60
8,932,430,1355055248,1355057217,0,2,1969
8,932,477,1355057217,1355057277,0,2,60
8,933,77,1355103720,1355103780,0,1,60
8,934,77,1355190522,1355190582,0,1,60
8,935,77,1355362636,1355365491,0,2,2855
8,935,21,1355365491,1355365551,0,2,60
8,936,21,1355398031,1355401136,0,2,3105
8,936,477,1355401136,1355401196,0,2,60
8,937,77,1355622537,1355622597,0,1,60
8,938,478,1355659398,1355659458,0,1,60
8,939,430,1355706539,1355706599,0,1,60
8,940,21,1355741680,1355745744,0,4,4064
8,940,479,1355745744,1355745754,0,4,10
8,940,6,1355745754,1355749242,0,4,3488
8,940,232,1355749242,1355749302,0,4,60
8,941,452,1355821429,1355821489,0,1,60
8,942,77,1355968221,1355969891,0,2,1670
8,942,21,1355969891,1355969951,0,2,60
8,943,21,1356089767,1356090450,0,2,683
8,943,480,1356090450,1356090510,0,2,60
8,944,5,1356138045,1356138105,0,1,60
8,945,21,1356174478,1356174538,0,1,60
8,946,21,1356606542,1356606602,0,1,60
8,947,21,1356693782,1356693842,0,1,60
8,948,21,1356747366,1356747426,0,1,60
8,949,21,1356779234,1356780506,0,2,1272
8,949,443,1356780506,1356780566,0,2,60
8,950,21,1356865601,1356866534,0,4,933
8,950,449,1356866534,1356866551,0,4,17
8,950,451,1356866551,1356871970,0,4,5419
8,950,447,1356871970,1356872030,0,4,60
8,951,15,1356913464,1356913524,0,1,60
8,952,15,1356938460,1356938515,0,2,55
8,952,481,1356938515,1356938575,0,2,60
8,953,21,1357210475,1357210535,0,1,60
8,954,77,1357261897,1357261957,0,1,60
8,955,5,1357296799,1357296859,0,1,60
8,956,77,1357350559,1357350619,0,1,60
8,957,21,1357384276,1357384336,0,1,60
8,958,21,1357438643,1357438703,0,1,60
8,959,77,1357471844,1357471904,0,1,60
8,960,21,1357525112,1357525172,0,1,60
8,961,476,1357558548,1357558608,0,1,60
8,962,430,1357727282,1357727342,0,1,60
8,963,21,1357814722,1357817560,0,2,2838
8,963,430,1357817560,1357817620,0,2,60
8,964,21,1357901214,1357901274,0,1,60
8,965,434,1358074982,1358075000,0,2,18
8,965,482,1358075000,1358075060,0,2,60
8,966,77,1358128131,1358128191,0,1,60
8,967,483,1358423330,1358423390,0,1,60
8,968,21,1358765765,1358765825,0,1,60
8,969,21,1359080517,1359080577,0,1,60
8,970,77,1359165495,1359165555,0,1,60
8,971,484,1359279292,1359283471,0,2,4179
8,971,485,1359283471,1359283531,0,2,60
8,972,447,1359301124,1359311692,0,3,10568
8,972,486,1359311692,1359316322,0,3,4630
8,972,487,1359316322,1359316382,0,3,60
8,973,314,1359371070,1359372394,0,2,1324
8,973,5,1359372394,1359372454,0,2,60
8,974,21,1359409812,1359409872,0,1,60
8,975,449,1359585838,1359587718,0,2,1880
8,975,488,1359587718,1359587778,0,2,60
8,976,77,1359683524,1359683584,0,1,60
8,977,77,1360288423,1360288483,0,1,60
8,978,434,1360582598,1360582658,0,1,60
8,979,77,1360719928,1360721764,0,2,1836
8,979,21,1360721764,1360721824,0,2,60
8,980,21,1360753087,1360756709,0,2,3622
8,980,430,1360756709,1360756769,0,2,60
9,981,77,1360979172,1360979232,0,1,60
9,982,489,1333490068,1333493767,0,2,3699
9,982,86,1333493767,1333493827,0,2,60
9,983,428,1333530641,1333530837,0,7,196
9,983,490,1333530837,1333534691,0,7,3854
9,983,491,1333534691,1333541510,0,7,6819
9,983,260,1333541510,1333542149,0,7,639
9,983,86,1333542149,1333542322,0,7,173
9,983,264,1333542322,1333551385,0,7,9063
9,983,492,1333551385,1333551445,0,7,60
9,984,493,1333623194,1333623762,0,4,568
9,984,494,1333623762,1333623762,0,4,0
9,984,494,1333623762,1333624083,0,4,321
9,984,264,1333624083,1333624143,0,4,60
9,985,492,1333726527,1333726587,0,1,60
9,986,495,1333803570,1333816220,0,2,12650
9,986,496,1333816220,1333816280,0,2,60
9,987,264,1333850190,1333851910,0,12,1720
9,987,86,1333851910,1333853535,0,12,1625
9,987,5,1333853535,1333858351,0,12,4816
9,987,497,1333858351,1333859129,0,12,778
9,987,498,1333859129,1333859302,0,12,173
9,987,499,1333859302,1333859660,0,12,358
9,987,500,1333859660,1333860750,0,12,1090
9,987,501,1333860750,1333861252,0,12,502
9,987,502,1333861252,1333864030,0,12,2778
9,987,503,1333864030,1333870357,0,12,6327
9,987,5,1333870357,1333870961,0,12,604
9,987,21,1333870961,1333871021,0,12,60
9,988,504,1333876825,1333877425,0,4,600
9,988,505,1333877425,1333891742,0,4,14317
9,988,492,1333891742,1333892132,0,4,390
9,988,506,1333892132,1333892192,0,4,60
9,989,489,1333922246,1333925753,0,2,3507
9,989,86,1333925753,1333925813,0,2,60
9,990,489,1333971663,1333983888,0,2,12225
9,990,492,1333983888,1333983948,0,2,60
9,991,507,1334012096,1334012671,0,2,575
9,991,86,1334012671,1334012731,0,2,60
9,992,86,1334056737,1334056902,0,2,165
9,992,264,1334056902,1334056962,0,2,60
9,993,489,1334097324,1334097384,0,1,60
9,994,86,1334143167,1334143227,0,1,60
9,995,507,1334184740,1334185473,0,2,733
9,995,86,1334185473,1334185533,0,2,60
9,996,86,1334227738,1334228168,0,4,430
9,996,493,1334228168,1334228692,0,4,524
9,996,508,1334228692,1334229598,0,4,906
9,996,264,1334229598,1334229658,0,4,60
9,997,86,1334271498,1334271558,0,1,60
9,998,86,1334319550,1334320171,0,4,621
9,998,264,1334320171,1334328916,0,4,8745
9,998,492,1334328916,1334329836,0,4,920
9,998,506,1334329836,1334329896,0,4,60
9,999,86,1334373903,1334374196,0,3,293
9,999,264,1334374196,1334379282,0,3,5086
9,999,489,1334379282,1334379342,0,3,60
9,1000,494,1334453225,1334453386,0,9,161
9,1000,508,1334453386,1334454419,0,9,1033
9,1000,489,1334454419,1334457189,0,9,2770
9,1000,264,1334457189,1334459250,0,9,2061
9,1000,509,1334459250,1334463087,0,9,3837
9,1000,86,1334463087,1334464215,0,9,1128
9,1000,297,1334464215,1334464290,0,9,75
9,1000,71,1334464290,1334466192,0,9,1902
9,1000,510,1334466192,1334466252,0,9,60
9,1001,511,1334484754,1334492417,0,3,7663
9,1001,86,1334492417,1334492630,0,3,213
9,1001,492,1334492630,1334492690,0,3,60
9,1002,489,1334525924,1334525984,0,1,60
9,1003,86,1334572337,1334572539,0,5,202
9,1003,493,1334572539,1334573201,0,5,662
9,1003,508,1334573201,1334574226,0,5,1025
9,1003,264,1334574226,1334578199,0,5,3973
9,1003,492,1334578199,1334578259,0,5,60
9,1004,496,1334665387,1334665447,0,1,60
9,1005,86,1334703419,1334703479,0,1,60
9,1006,86,1334789867,1334789927,0,1,60
9,1007,449,1334828668,1334829065,0,6,397
9,1007,86,1334829065,1334829287,0,6,222
9,1007,489,1334829287,1334833880,0,6,4593
9,1007,264,1334833880,1334837818,0,6,3938
9,1007,509,1334837818,1334838197,0,6,379
9,1007,492,1334838197,1334838257,0,6,60
9,1008,507,1334875957,1334876454,0,2,497
9,1008,86,1334876454,1334876514,0,2,60
9,1009,86,1334933268,1334933292,0,4,24
9,1009,264,1334933292,1334933292,0,4,0
9,1009,264,1334933292,1334936625,0,4,3333
9,1009,492,1334936625,1334936685,0,4,60
9,1010,86,1335002503,1335002614,0,4,111
9,1010,509,1335002614,1335002865,0,4,251
9,1010,264,1335002865,1335008327,0,4,5462
9,1010,512,1335008327,1335008387,0,4,60
9,1011,86,1335055151,1335055313,0,14,162
9,1011,489,1335055313,1335063981,0,14,8668
9,1011,507,1335063981,1335064369,0,14,388
9,1011,509,1335064369,1335065602,0,14,1233
9,1011,513,1335065602,1335065624,0,14,22
9,1011,493,1335065624,1335065659,0,14,35
9,1011,514,1335065659,1335067129,0,14,1470
9,1011,515,1335067129,1335067815,0,14,686
9,1011,298,1335067815,1335071515,0,14,3700
9,1011,260,1335071515,1335072022,0,14,507
9,1011,516,1335072022,1335072631,0,14,609
9,1011,86,1335072631,1335073627,0,14,996
9,1011,264,1335073627,1335075804,0,14,2177
9,1011,492,1335075804,1335075864,0,14,60
9,1012,496,1335087037,1335087097,0,1,60
9,1013,86,1335130987,1335131008,0,2,21
9,1013,489,1335131008,1335131068,0,2,60
9,1014,86,1335171602,1335171803,0,2,201
9,1014,264,1335171803,1335171863,0,2,60
9,1015,489,1335218233,1335221804,0,2,3571
9,1015,86,1335221804,1335221864,0,2,60
9,1016,86,1335264537,1335264814,0,5,277
9,1016,264,1335264814,1335268001,0,5,3187
9,1016,509,1335268001,1335270449,0,5,2448
9,1016,492,1335270449,1335271719,0,5,1270
9,1016,517,1335271719,1335271779,0,5,60
9,1017,507,1335308104,1335308804,0,2,700
9,1017,86,1335308804,1335308864,0,2,60
9,1018,86,1335354629,1335354753,0,3,124
9,1018,264,1335354753,1335357920,0,3,3167
9,1018,492,1335357920,1335357980,0,3,60
9,1019,86,1335437728,1335437861,0,4,133
9,1019,264,1335437861,1335441372,0,4,3511
9,1019,489,1335441372,1335446450,0,4,5078
9,1019,492,1335446450,1335446510,0,4,60
9,1020,264,1335521148,1335525206,0,2,4058
9,1020,489,1335525206,1335525266,0,2,60
9,1021,493,1335607744,1335608289,0,5,545
9,1021,86,1335608289,1335608416,0,5,127
9,1021,509,1335608416,1335608810,0,5,394
9,1021,264,1335608810,1335617427,0,5,8617
9,1021,496,1335617427,1335617487,0,5,60
9,1022,264,1335678069,1335680081,0,5,2012
9,1022,86,1335680081,1335680303,0,5,222
9,1022,493,1335680303,1335681379,0,5,1076
9,1022,518,1335681379,1335688276,0,5,6897
9,1022,492,1335688276,1335688336,0,5,60
9,1023,86,1335947727,1335955850,0,2,8123
9,1023,489,1335955850,1335955910,0,2,60
9,1024,519,1336042387,1336042447,0,1,60
9,1025,86,1336105793,1336107367,0,13,1574
9,1025,5,1336107367,1336107763,0,13,396
9,1025,520,1336107763,1336109570,0,13,1807
9,1025,521,1336109570,1336113566,0,13,3996
9,1025,505,1336113566,1336116363,0,13,2797
9,1025,522,1336116363,1336116473,0,13,110
9,1025,235,1336116473,1336118216,0,13,1743
9,1025,523,1336118216,1336119210,0,13,994
9,1025,524,1336119210,1336119333,0,13,123
9,1025,501,1336119333,1336120455,0,13,1122
9,1025,499,1336120455,1336121010,0,13,555
9,1025,525,1336121010,1336122031,0,13,1021
9,1025,9,1336122031,1336122091,0,13,60
9,1026,5,1336128860,1336129163,0,6,303
9,1026,520,1336129163,1336129995,0,6,832
9,1026,526,1336129995,1336134995,0,6,5000
9,1026,86,1336134995,1336135106,0,6,111
9,1026,264,1336135106,1336141276,0,6,6170
9,1026,492,1336141276,1336141336,0,6,60
9,1027,489,1336179251,1336190219,0,9,10968
9,1027,264,1336190219,1336191983,0,9,1764
9,1027,5,1336191983,1336192603,0,9,620
9,1027,527,1336192603,1336195862,0,9,3259
9,1027,523,1336195862,1336195907,0,9,45
9,1027,226,1336195907,1336196292,0,9,385
9,1027,528,1336196292,1336196871,0,9,579
9,1027,236,1336196871,1336199268,0,9,2397
9,1027,9,1336199268,1336199328,0,9,60
9,1028,5,1336210121,1336211887,0,4,1766
9,1028,86,1336211887,1336212109,0,4,222
9,1028,492,1336212109,1336223664,0,4,11555
9,1028,495,1336223664,1336223724,0,4,60
9,1029,86,1336386165,1336386298,0,3,133
9,1029,264,1336386298,1336397994,0,3,11696
9,1029,492,1336397994,1336398054,0,3,60
9,1030,489,1336427899,1336427959,0,1,60
9,1031,86,1336477142,1336477392,0,5,250
9,1031,493,1336477392,1336477862,0,5,470
9,1031,508,1336477862,1336485332,0,5,7470
9,1031,492,1336485332,1336485719,0,5,387
9,1031,506,1336485719,1336485779,0,5,60
9,1032,507,1336518402,1336518413,0,2,11
9,1032,86,1336518413,1336518473,0,2,60
9,1033,529,1336555484,1336555624,0,7,140
9,1033,490,1336555624,1336557868,0,7,2244
9,1033,428,1336557868,1336558845,0,7,977
9,1033,86,1336558845,1336559077,0,7,232
9,1033,530,1336559077,1336559715,0,7,638
9,1033,509,1336559715,1336560319,0,7,604
9,1033,492,1336560319,1336560379,0,7,60
9,1034,86,1336604121,1336604181,0,1,60
9,1035,489,1336686463,1336686523,0,1,60
9,1036,86,1336734577,1336734798,0,4,221
9,1036,493,1336734798,1336736475,0,4,1677
9,1036,489,1336736475,1336747701,0,4,11226
9,1036,492,1336747701,1336747761,0,4,60
9,1037,531,1336814561,1336814589,0,5,28
9,1037,532,1336814589,1336816409,0,5,1820
9,1037,533,1336816409,1336816887,0,5,478
9,1037,86,1336816887,1336827517,0,5,10630
9,1037,496,1336827517,1336827577,0,5,60
9,1038,507,1336864480,1336865745,0,3,1265
9,1038,86,1336865745,1336866846,0,3,1101
9,1038,260,1336866846,1336866906,0,3,60
9,1039,260,1336908876,1336910029,0,5,1153
9,1039,86,1336910029,1336910251,0,5,222
9,1039,534,1336910251,1336913285,0,5,3034
9,1039,492,1336913285,1336913800,0,5,515
9,1039,517,1336913800,1336913860,0,5,60
9,1040,86,1336949653,1336949713,0,1,60
9,1041,86,1336997369,1336998457,0,3,1088
9,1041,509,1336998457,1336999022,0,3,565
9,1041,492,1336999022,1336999082,0,3,60
9,1042,489,1337033144,1337036217,0,2,3073
9,1042,86,1337036217,1337036277,0,2,60
9,1043,86,1337073818,1337074809,0,4,991
9,1043,489,1337074809,1337079752,0,4,4943
9,1043,535,1337079752,1337081144,0,4,1392
9,1043,492,1337081144,1337081204,0,4,60
9,1044,489,1337119025,1337122595,0,2,3570
9,1044,86,1337122595,1337122655,0,2,60
9,1045,536,1337158087,1337158101,0,9,14
9,1045,537,1337158101,1337160606,0,9,2505
9,1045,424,1337160606,1337161603,0,9,997
9,1045,538,1337161603,1337161749,0,9,146
9,1045,493,1337161749,1337163183,0,9,1434
9,1045,494,1337163183,1337163696,0,9,513
9,1045,518,1337163696,1337169424,0,9,5728
9,1045,509,1337169424,1337170662,0,9,1238
9,1045,492,1337170662,1337170722,0,9,60
9,1046,86,1337205036,1337205050,0,2,14
9,1046,489,1337205050,1337205110,0,2,60
9,1047,86,1337254426,1337255020,0,3,594
9,1047,493,1337255020,1337257340,0,3,2320
9,1047,492,1337257340,1337257400,0,3,60
9,1048,86,1337295094,1337295154,0,1,60
9,1049,86,1337347765,1337347802,0,3,37
9,1049,264,1337347802,1337349553,0,3,1751
9,1049,492,1337349553,1337349613,0,3,60
9,1050,489,1337396729,1337406473,0,2,9744
9,1050,518,1337406473,1337406533,0,2,60
9,1051,509,1337419005,1337419292,0,3,287
9,1051,492,1337419292,1337430442,0,3,11150
9,1051,496,1337430442,1337430502,0,3,60
9,1052,86,1337636485,1337636504,0,2,19
9,1052,489,1337636504,1337636564,0,2,60
9,1053,253,1337677245,1337677825,0,6,580
9,1053,258,1337677825,1337678355,0,6,530
9,1053,241,1337678355,1337688581,0,6,10226
9,1053,5,1337688581,1337690144,0,6,1563
9,1053,86,1337690144,1337693082,0,6,2938
9,1053,492,1337693082,1337693142,0,6,60
9,1054,86,1337813778,1337813838,0,1,60
9,1055,449,1337851714,1337852584,0,3,870
9,1055,86,1337852584,1337852816,0,3,232
9,1055,539,1337852816,1337852876,0,3,60
9,1056,86,1337952375,1337952532,0,3,157
9,1056,264,1337952532,1337958086,0,3,5554
9,1056,492,1337958086,1337958146,0,3,60
9,1057,11,1338090682,1338090966,0,13,284
9,1057,5,1338090966,1338091577,0,13,611
9,1057,505,1338091577,1338095503,0,13,3926
9,1057,540,1338095503,1338096856,0,13,1353
9,1057,541,1338096856,1338098702,0,13,1846
9,1057,71,1338098702,1338098914,0,13,212
9,1057,297,1338098914,1338100816,0,13,1902
9,1057,298,1338100816,1338107942,0,13,7126
9,1057,297,1338107942,1338108696,0,13,754
9,1057,260,1338108696,1338109956,0,13,1260
9,1057,542,1338109956,1338110394,0,13,438
9,1057,543,1338110394,1338110424,0,13,30
9,1057,544,1338110424,1338110484,0,13,60
9,1058,545,1338114294,1338120423,0,5,6129
9,1058,86,1338120423,1338121537,0,5,1114
9,1058,509,1338121537,1338121945,0,5,408
9,1058,530,1338121945,1338122964,0,5,1019
9,1058,546,1338122964,1338123024,0,5,60
9,1059,507,1338159564,1338159581,0,2,17
9,1059,86,1338159581,1338159641,0,2,60
9,1060,86,1338200154,1338200364,0,5,210
9,1060,493,1338200364,1338203288,0,5,2924
9,1060,509,1338203288,1338203779,0,5,491
9,1060,492,1338203779,1338204421,0,5,642
9,1060,506,1338204421,1338204481,0,5,60
9,1061,489,1338242084,1338245798,0,2,3714
9,1061,86,1338245798,1338245858,0,2,60
9,1062,86,1338282360,1338282566,0,3,206
9,1062,492,1338282566,1338283104,0,3,538
9,1062,517,1338283104,1338283164,0,3,60
9,1063,86,1338332746,1338332806,0,1,60
9,1064,86,1338544024,1338544310,0,6,286
9,1064,493,1338544310,1338544993,0,6,683
9,1064,509,1338544993,1338545246,0,6,253
9,1064,264,1338545246,1338547298,0,6,2052
9,1064,489,1338547298,1338560563,0,6,13265
9,1064,492,1338560563,1338560623,0,6,60
9,1065,86,1338706677,1338712459,0,4,5782
9,1065,547,1338712459,1338712747,0,4,288
9,1065,492,1338712747,1338713372,0,4,625
9,1065,496,1338713372,1338713432,0,4,60
9,1066,517,1338729668,1338729728,0,1,60
9,1067,86,1338811745,1338812681,0,3,936
9,1067,509,1338812681,1338813183,0,3,502
9,1067,492,1338813183,1338813243,0,3,60
9,1068,489,1338846598,1338850558,0,2,3960
9,1068,86,1338850558,1338850618,0,2,60
9,1069,86,1338893041,1338893257,0,4,216
9,1069,493,1338893257,1338895010,0,4,1753
9,1069,492,1338895010,1338895530,0,4,520
9,1069,548,1338895530,1338895590,0,4,60
9,1070,428,1338973862,1338974004,0,7,142
9,1070,490,1338974004,1338976305,0,7,2301
9,1070,529,1338976305,1338976721,0,7,416
9,1070,260,1338976721,1338977576,0,7,855
9,1070,86,1338977576,1338977698,0,7,122
9,1070,534,1338977698,1338986384,0,7,8686
9,1070,492,1338986384,1338986444,0,7,60
9,1071,489,1339020628,1339023387,0,2,2759
9,1071,86,1339023387,1339023447,0,2,60
9,1072,86,1339063616,1339063827,0,4,211
9,1072,493,1339063827,1339065237,0,4,1410
9,1072,509,1339065237,1339065806,0,4,569
9,1072,492,1339065806,1339065866,0,4,60
9,1073,489,1339107288,1339109847,0,2,2559
9,1073,86,1339109847,1339109907,0,2,60
9,1074,492,1339159577,1339159637,0,1,60
9,1075,546,1339229385,1339229400,0,4,15
9,1075,86,1339229400,1339229422,0,4,22
9,1075,489,1339229422,1339249295,0,4,19873
9,1075,517,1339249295,1339249355,0,4,60
9,1076,5,1339290430,1339290953,0,4,523
9,1076,549,1339290953,1339295928,0,4,4975
9,1076,505,1339295928,1339297911,0,4,1983
9,1076,550,1339297911,1339297971,0,4,60
9,1077,551,1339314950,1339319236,0,3,4286
9,1077,86,1339319236,1339323007,0,3,3771
9,1077,492,1339323007,1339323067,0,3,60
9,1078,489,1339390778,1339390811,0,4,33
9,1078,86,1339390811,1339403079,0,4,12268
9,1078,492,1339403079,1339403604,0,4,525
9,1078,517,1339403604,1339403664,0,4,60
9,1079,489,1339454797,1339455493,0,2,696
9,1079,86,1339455493,1339455553,0,2,60
9,1080,492,1339505452,1339505512,0,1,60
9,1081,507,1339542519,1339542531,0,2,12
9,1081,86,1339542531,1339542591,0,2,60
9,1082,86,1339590470,1339590487,0,2,17
9,1082,509,1339590487,1339590547,0,2,60
9,1083,507,1339628716,1339628728,0,2,12
9,1083,86,1339628728,1339628788,0,2,60
9,1084,86,1339672566,1339672626,0,1,60
9,1085,489,1339753866,1339760939,0,4,7073
9,1085,509,1339760939,1339761351,0,4,412
9,1085,492,1339761351,1339761627,0,4,276
9,1085,552,1339761627,1339761687,0,4,60
9,1086,86,1339880366,1339880426,0,1,60
9,1087,509,1339921886,1339933125,0,3,11239
9,1087,489,1339933125,1339933149,0,3,24
9,1087,492,1339933149,1339933209,0,3,60
9,1088,489,1339973855,1339973867,0,2,12
9,1088,86,1339973867,1339973927,0,2,60
10,1089,86,1340029817,1340029877,0,1,60
10,1090,553,1338543158,1338543218,0,1,60
10,1091,554,1339207267,1339216861,0,2,9594
10,1091,555,1339216861,1339216921,0,2,60
10,1092,556,1339301380,1339301440,0,1,60
10,1093,557,1339397952,1339402465,0,2,4513
10,1093,556,1339402465,1339402525,0,2,60
10,1094,558,1340246553,1340246613,0,1,60
10,1095,559,1341993240,1341993300,0,1,60
10,1096,560,1344205069,1344205129,0,1,60
10,1097,327,1344244318,1344244378,0,1,60
10,1098,284,1344688170,1344688465,0,2,295
10,1098,380,1344688465,1344688525,0,2,60
10,1099,561,1346884001,1346884891,0,2,890
10,1099,562,1346884891,1346884951,0,2,60
10,1100,563,1346914943,1346915003,0,1,60
10,1101,284,1347228485,1347229880,0,2,1395
10,1101,564,1347229880,1347229940,0,2,60
10,1102,284,1347660629,1347660689,0,1,60
10,1103,284,1347703023,1347705728,0,2,2705
10,1103,560,1347705728,1347705788,0,2,60
10,1104,565,1347741543,1347743150,0,4,1607
10,1104,566,1347743150,1347756461,0,4,13311
10,1104,567,1347756461,1347756673,0,4,212
10,1104,568,1347756673,1347756733,0,4,60
10,1105,569,1349995722,1349996732,0,2,1010
10,1105,570,1349996732,1349996792,0,2,60
10,1106,561,1350036230,1350036290,0,1,60
10,1107,380,1350117557,1350119570,0,2,2013
10,1107,284,1350119570,1350119630,0,2,60
10,1108,5,1350891737,1350892204,0,3,467
10,1108,47,1350892204,1350894037,0,3,1833
10,1108,555,1350894037,1350894097,0,3,60
10,1109,569,1350945752,1350945812,0,1,60
10,1110,562,1350976729,1350976789,0,1,60
10,1111,569,1351030371,1351051904,0,2,21533
10,1111,571,1351051904,1351051964,0,2,60
10,1112,572,1351053511,1351056558,0,8,3047
10,1112,253,1351056558,1351058894,0,8,2336
10,1112,23,1351058894,1351059569,0,8,675
10,1112,573,1351059569,1351060724,0,8,1155
10,1112,5,1351060724,1351062473,0,8,1749
10,1112,574,1351062473,1351065271,0,8,2798
10,1112,8,1351065271,1351068126,0,8,2855
10,1112,11,1351068126,1351068186,0,8,60
10,1113,561,1351203323,1351204132,0,3,809
10,1113,562,1351204132,1351204400,0,3,268
10,1113,569,1351204400,1351204460,0,3,60
10,1114,351,1351346887,1351348809,0,2,1922
10,1114,258,1351348809,1351348869,0,2,60
10,1115,575,1351369129,1351369634,0,5,505
10,1115,35,1351369634,1351369822,0,5,188
10,1115,121,1351369822,1351372807,0,5,2985
10,1115,576,1351372807,1351373244,0,5,437
10,1115,577,1351373244,1351373304,0,5,60
10,1116,578,1351399687,1351410380,0,3,10693
10,1116,579,1351410380,1351413291,0,3,2911
10,1116,55,1351413291,1351413351,0,3,60
10,1117,572,1351461890,1351461950,0,1,60
10,1118,562,1351502004,1351502938,0,2,934
10,1118,580,1351502938,1351502998,0,2,60
10,1119,569,1351634687,1351635247,0,2,560
10,1119,572,1351635247,1351635307,0,2,60
10,1120,562,1351675089,1351676379,0,2,1290
10,1120,580,1351676379,1351676439,0,2,60
10,1121,561,1351720650,1351721727,0,2,1077
10,1121,569,1351721727,1351721787,0,2,60
10,1122,572,1351750105,1351750678,0,2,573
10,1122,562,1351750678,1351750738,0,2,60
10,1123,581,1351807700,1351817128,0,3,9428
10,1123,55,1351817128,1351817866,0,3,738
10,1123,582,1351817866,1351817926,0,3,60
10,1124,55,1352109735,1352109795,0,1,60
10,1125,581,1352177780,1352184820,0,6,7040
10,1125,5,1352184820,1352187334,0,6,2514
10,1125,574,1352187334,1352189395,0,6,2061
10,1125,583,1352189395,1352190452,0,6,1057
10,1125,11,1352190452,1352190776,0,6,324
10,1125,584,1352190776,1352190836,0,6,60
10,1126,585,1352281478,1352281777,0,4,299
10,1126,586,1352281777,1352282422,0,4,645
10,1126,35,1352282422,1352282662,0,4,240
10,1126,587,1352282662,1352282722,0,4,60
10,1127,588,1352499569,1352500481,0,2,912
10,1127,589,1352500481,1352500541,0,2,60
10,1128,284,1352582474,1352583982,0,2,1508
10,1128,590,1352583982,1352584042,0,2,60
10,1129,587,1352627593,1352627653,0,1,60
10,1130,591,1353054858,1353055149,0,5,291
10,1130,284,1353055149,1353057297,0,5,2148
10,1130,5,1353057297,1353060767,0,5,3470
10,1130,574,1353060767,1353061864,0,5,1097
10,1130,583,1353061864,1353061924,0,5,60
10,1131,579,1353110185,1353110881,0,2,696
10,1131,578,1353110881,1353110941,0,2,60
10,1132,592,1353137896,1353140297,0,3,2401
10,1132,593,1353140297,1353140392,0,3,95
10,1132,594,1353140392,1353140452,0,3,60
10,1133,561,1353625599,1353625659,0,1,60
10,1134,380,1353655710,1353656185,0,2,475
10,1134,595,1353656185,1353656245,0,2,60
10,1135,35,1353768205,1353789031,0,3,20826
10,1135,35,1353789031,1353789130,0,3,99
10,1135,121,1353789130,1353789190,0,3,60
10,1136,596,1353818251,1353827672,0,4,9421
10,1136,578,1353827672,1353835110,0,4,7438
10,1136,579,1353835110,1353837416,0,4,2306
10,1136,561,1353837416,1353837476,0,4,60
10,1137,253,1354412446,1354415453,0,5,3007
10,1137,272,1354415453,1354432654,0,5,17201
10,1137,71,1354432654,1354433657,0,5,1003
10,1137,434,1354433657,1354433898,0,5,241
10,1137,391,1354433898,1354433958,0,5,60
10,1138,597,1354434329,1354434633,0,5,304
10,1138,21,1354434633,1354436146,0,5,1513
10,1138,598,1354436146,1354436666,0,5,520
10,1138,599,1354436666,1354437007,0,5,341
10,1138,584,1354437007,1354437067,0,5,60
10,1139,600,1355120579,1355121766,0,8,1187
10,1139,601,1355121766,1355123210,0,8,1444
10,1139,253,1355123210,1355123467,0,8,257
10,1139,602,1355123467,1355124375,0,8,908
10,1139,603,1355124375,1355124564,0,8,189
10,1139,604,1355124564,1355126245,0,8,1681
10,1139,605,1355126245,1355128121,0,8,1876
10,1139,606,1355128121,1355128181,0,8,60
10,1140,5,1355199224,1355199497,0,5,273
10,1140,299,1355199497,1355209267,0,5,9770
10,1140,574,1355209267,1355211526,0,5,2259
10,1140,607,1355211526,1355211798,0,5,272
10,1140,11,1355211798,1355211858,0,5,60
10,1141,561,1355350711,1355351922,0,2,1211
10,1141,569,1355351922,1355351982,0,2,60
10,1142,562,1355387309,1355387369,0,1,60
10,1143,561,1355626770,1355627620,0,2,850
10,1143,608,1355627620,1355627680,0,2,60
10,1144,561,1355868958,1355869018,0,1,60
10,1145,562,1355905606,1355906336,0,2,730
10,1145,580,1355906336,1355906396,0,2,60
10,1146,434,1355983008,1355983277,0,2,269
10,1146,573,1355983277,1355983337,0,2,60
10,1147,587,1356166736,1356167395,0,5,659
10,1147,35,1356167395,1356168113,0,5,718
10,1147,609,1356168113,1356168450,0,5,337
10,1147,610,1356168450,1356184208,0,5,15758
10,1147,258,1356184208,1356184268,0,5,60
10,1148,258,1356204996,1356205056,0,1,60
10,1149,611,1356252973,1356254399,0,2,1426
10,1149,99,1356254399,1356254459,0,2,60
10,1150,21,1357417506,1357417566,0,1,60
10,1151,569,1357512652,1357512712,0,1,60
10,1152,562,1357633142,1357633202,0,1,60
10,1153,569,1357772953,1357773013,0,1,60
10,1154,562,1357804899,1357805769,0,2,870
10,1154,580,1357805769,1357805829,0,2,60
10,1155,561,1357943286,1357943346,0,1,60
10,1156,562,1357975834,1357976761,0,2,927
10,1156,580,1357976761,1357976821,0,2,60
10,1157,327,1358046478,1358056607,0,3,10129
10,1157,28,1358056607,1358062063,0,3,5456
10,1157,55,1358062063,1358062123,0,3,60
10,1158,561,1358327036,1358327096,0,1,60
10,1159,55,1358373238,1358373298,0,1,60
10,1160,55,1358459073,1358459133,0,1,60
10,1161,351,1358804382,1358805141,0,3,759
10,1161,284,1358805141,1358805337,0,3,196
10,1161,380,1358805337,1358805397,0,3,60
10,1162,612,1358828311,1358829802,0,5,1491
10,1162,253,1358829802,1358834768,0,5,4966
10,1162,613,1358834768,1358846900,0,5,12132
10,1162,11,1358846900,1358847231,0,5,331
10,1162,614,1358847231,1358847291,0,5,60
10,1163,562,1359758198,1359758363,0,2,165
10,1163,569,1359758363,1359758423,0,2,60
10,1164,284,1359788921,1359788981,0,1,60
10,1165,615,1359854845,1359855042,0,3,197
10,1165,616,1359855042,1359856520,0,3,1478
10,1165,617,1359856520,1359856580,0,3,60
10,1166,618,1359878410,1359880776,0,4,2366
10,1166,619,1359880776,1359881592,0,4,816
10,1166,5,1359881592,1359882442,0,4,850
10,1166,614,1359882442,1359882502,0,4,60
10,1167,569,1359932698,1359932758,0,1,60
10,1168,569,1360015972,1360016936,0,2,964
10,1168,563,1360016936,1360016996,0,2,60
10,1169,284,1360107318,1360107679,0,5,361
10,1169,620,1360107679,1360109543,0,5,1864
10,1169,621,1360109543,1360110755,0,5,1212
10,1169,622,1360110755,1360111513,0,5,758
10,1169,613,1360111513,1360111573,0,5,60
10,1170,561,1360189853,1360189913,0,1,60
10,1171,623,1360276841,1360276901,0,1,60
10,1172,580,1360312162,1360312222,0,1,60
10,1173,561,1360535202,1360536047,0,2,845
10,1173,623,1360536047,1360536107,0,2,60
10,1174,462,1360569626,1360569686,0,1,60
10,1175,561,1360622432,1360622492,0,1,60
10,1176,623,1360709586,1360709646,0,1,60
10,1177,55,1360746687,1360746747,0,1,60
11,1178,623,1360796355,1360796415,0,1,60
11,1179,624,1333537401,1333538133,0,3,732
11,1179,625,1333538133,1333540398,0,3,2265
11,1179,626,1333540398,1333540458,0,3,60
11,1180,627,1333624060,1333624120,0,1,60
11,1181,628,1334665207,1334665267,0,1,60
11,1182,629,1335264705,1335264765,0,1,60
11,1183,630,1335440612,1335440672,0,1,60
11,1184,579,1335591830,1335597511,0,3,5681
11,1184,578,1335597511,1335609335,0,3,11824
11,1184,631,1335609335,1335609395,0,3,60
11,1185,627,1336040903,1336043319,0,2,2416
11,1185,632,1336043319,1336043379,0,2,60
11,1186,633,1336195367,1336198705,0,2,3338
11,1186,634,1336198705,1336198765,0,2,60
11,1187,21,1336345402,1336345462,0,1,60
11,1188,635,1336867278,1336867338,0,1,60
11,1189,35,1337251030,1337251090,0,1,60
11,1190,636,1337405862,1337405922,0,1,60
11,1191,630,1337599748,1337600775,0,2,1027
11,1191,627,1337600775,1337600835,0,2,60
11,1192,635,1337670027,1337686747,0,2,16720
11,1192,637,1337686747,1337686807,0,2,60
11,1193,638,1338098640,1338098700,0,1,60
11,1194,630,1338289720,1338289780,0,1,60
11,1195,21,1338725745,1338725805,0,1,60
11,1196,253,1338807086,1338807146,0,1,60
11,1197,639,1339067213,1339067273,0,1,60
11,1198,400,1339154024,1339154084,0,1,60
11,1199,640,1339201236,1339201296,0,1,60
11,1200,638,1339225492,1339225552,0,1,60
11,1201,641,1339247970,1339257389,0,2,9419
11,1201,253,1339257389,1339257449,0,2,60
11,1202,605,1339323107,1339325975,0,2,2868
11,1202,642,1339325975,1339326035,0,2,60
11,1203,637,1339585680,1339585740,0,1,60
11,1204,643,1340018820,1340018880,0,1,60
11,1205,644,1340798021,1340798081,0,1,60
11,1206,645,1341370446,1341370506,0,1,60
11,1207,646,1341394470,1341394530,0,1,60
11,1208,647,1341489272,1341489332,0,1,60
11,1209,648,1341652692,1341654305,0,2,1613
11,1209,630,1341654305,1341654365,0,2,60
11,1210,637,1341739596,1341739656,0,1,60
11,1211,637,1341832252,1341832312,0,1,60
11,1212,649,1342254055,1342254115,0,1,60
11,1213,35,1343629860,1343629920,0,1,60
11,1214,253,1344509575,1344509635,0,1,60
11,1215,627,1344598749,1344600004,0,4,1255
11,1215,630,1344600004,1344601752,0,4,1748
11,1215,650,1344601752,1344604241,0,4,2489
11,1215,643,1344604241,1344604301,0,4,60
11,1216,651,1344664787,1344667218,0,4,2431
11,1216,625,1344667218,1344670028,0,4,2810
11,1216,652,1344670028,1344671579,0,4,1551
11,1216,653,1344671579,1344671639,0,4,60
11,1217,654,1345271957,1345277430,0,2,5473
11,1217,655,1345277430,1345277490,0,2,60
11,1218,630,1345460733,1345461973,0,2,1240
11,1218,627,1345461973,1345462033,0,2,60
11,1219,656,1347682648,1347682708,0,1,60
11,1220,657,1347706724,1347707599,0,4,875
11,1220,626,1347707599,1347711762,0,4,4163
11,1220,658,1347711762,1347713985,0,4,2223
11,1220,659,1347713985,1347714045,0,4,60
11,1221,660,1350101526,1350101586,0,1,60
11,1222,637,1350386151,1350386211,0,1,60
11,1223,657,1350600241,1350600301,0,1,60
11,1224,661,1350648508,1350648568,0,1,60
11,1225,630,1350902371,1350902431,0,1,60
11,1226,637,1350991122,1350994000,0,2,2878
11,1226,662,1350994000,1350994060,0,2,60
11,1227,663,1351330746,1351332493,0,3,1747
11,1227,656,1351332493,1351336528,0,3,4035
11,1227,637,1351336528,1351336588,0,3,60
11,1228,605,1351414795,1351414855,0,1,60
11,1229,657,1351506955,1351507888,0,2,933
11,1229,400,1351507888,1351507948,0,2,60
11,1230,657,1352241385,1352241445,0,1,60
11,1231,664,1352515159,1352515219,0,1,60
11,1232,665,1352619823,1352619883,0,1,60
11,1233,21,1353115063,1353117247,0,2,2184
11,1233,289,1353117247,1353117307,0,2,60
11,1234,637,1353411468,1353411528,0,1,60
11,1235,637,1353584189,1353584249,0,1,60
11,1236,666,1353641107,1353641167,0,1,60
11,1237,221,1353742142,1353742202,0,1,60
11,1238,667,1353824140,1353824200,0,1,60
11,1239,630,1354015133,1354015193,0,1,60
11,1240,636,1354353516,1354353576,0,1,60
11,1241,668,1354535433,1354535493,0,1,60
11,1242,664,1354934257,1354934317,0,1,60
11,1243,400,1355045659,1355045719,0,1,60
11,1244,655,1355559409,1355559469,0,1,60
11,1245,669,1355649353,1355657496,0,2,8143
11,1245,670,1355657496,1355657556,0,2,60
11,1246,671,1355743375,1355743435,0,1,60
11,1247,671,1355829764,1355829936,0,2,172
11,1247,637,1355829936,1355829996,0,2,60
11,1248,658,1356089255,1356089315,0,1,60
11,1249,672,1356167081,1356167141,0,1,60
11,1250,673,1356240352,1356241218,0,2,866
11,1250,47,1356241218,1356241278,0,2,60
11,1251,671,1357197870,1357197930,0,1,60
11,1252,666,1357296552,1357296612,0,1,60
11,1253,674,1357458173,1357462296,0,2,4123
11,1253,675,1357462296,1357462356,0,2,60
11,1254,637,1357642531,1357642591,0,1,60
11,1255,625,1357727314,1357727374,0,1,60
11,1256,658,1357903682,1357907503,0,2,3821
11,1256,626,1357907503,1357907563,0,2,60
11,1257,676,1358836220,1358853386,0,2,17166
11,1257,677,1358853386,1358853446,0,2,60
11,1258,678,1359186108,1359188182,0,2,2074
11,1258,679,1359188182,1359188242,0,2,60
11,1259,680,1359272340,1359272400,0,1,60
11,1260,671,1359458194,1359458254,0,1,60
11,1261,681,1359690850,1359690910,0,1,60
11,1262,651,1359715065,1359720159,0,2,5094
11,1262,682,1359720159,1359720219,0,2,60
11,1263,683,1359774243,1359774303,0,1,60
11,1264,671,1359795962,1359796022,0,1,60
12,1265,668,1359878347,1359884689,0,2,6342
12,1265,359,1359884689,1359884749,0,2,60
12,1266,684,1333866161,1333866174,0,11,13
12,1266,11,1333866174,1333866564,0,11,390
12,1266,5,1333866564,1333867029,0,11,465
12,1266,685,1333867029,1333870178,0,11,3149
12,1266,71,1333870178,1333870194,0,11,16
12,1266,686,1333870194,1333872026,0,11,1832
12,1266,253,1333872026,1333872039,0,11,13
12,1266,687,1333872039,1333872057,0,11,18
12,1266,688,1333872057,1333872614,0,11,557
12,1266,658,1333872614,1333876309,0,11,3695
12,1266,5,1333876309,1333876369,0,11,60
12,1267,689,1336042187,1336042249,0,2,62
12,1267,690,1336042249,1336042309,0,2,60
12,1268,691,1336090086,1336091452,0,4,1366
12,1268,692,1336091452,1336091513,0,4,61
12,1268,693,1336091513,1336093821,0,4,2308
12,1268,694,1336093821,1336093881,0,4,60
12,1269,449,1336120370,1336120430,0,1,60
12,1270,11,1336220622,1336221050,0,3,428
12,1270,5,1336221050,1336221325,0,3,275
12,1270,8,1336221325,1336221385,0,3,60
12,1271,695,1336388944,1336388965,0,6,21
12,1271,696,1336388965,1336395397,0,6,6432
12,1271,697,1336395397,1336395412,0,6,15
12,1271,698,1336395412,1336395447,0,6,35
12,1271,699,1336395447,1336395474,0,6,27
12,1271,700,1336395474,1336395534,0,6,60
12,1272,11,1337397797,1337398146,0,14,349
12,1272,5,1337398146,1337398161,0,14,15
12,1272,8,1337398161,1337398178,0,14,17
12,1272,701,1337398178,1337398707,0,14,529
12,1272,71,1337398707,1337401537,0,14,2830
12,1272,5,1337401537,1337401950,0,14,413
12,1272,26,1337401950,1337402136,0,14,186
12,1272,236,1337402136,1337402164,0,14,28
12,1272,235,1337402164,1337406795,0,14,4631
12,1272,702,1337406795,1337413487,0,14,6692
12,1272,8,1337413487,1337417143,0,14,3656
12,1272,703,1337417143,1337417155,0,14,12
12,1272,704,1337417155,1337417180,0,14,25
12,1272,705,1337417180,1337417240,0,14,60
12,1273,703,1339217651,1339217692,0,9,41
12,1273,5,1339217692,1339218492,0,9,800
12,1273,71,1339218492,1339226505,0,9,8013
12,1273,8,1339226505,1339231703,0,9,5198
12,1273,703,1339231703,1339231811,0,9,108
12,1273,706,1339231811,1339233666,0,9,1855
12,1273,699,1339233666,1339233735,0,9,69
12,1273,707,1339233735,1339233770,0,9,35
12,1273,698,1339233770,1339233830,0,9,60
12,1274,708,1341114948,1341115008,0,1,60
12,1275,5,1341649544,1341650091,0,6,547
12,1275,236,1341650091,1341658748,0,6,8657
12,1275,5,1341658748,1341658765,0,6,17
12,1275,8,1341658765,1341658794,0,6,29
12,1275,709,1341658794,1341669871,0,6,11077
12,1275,5,1341669871,1341669931,0,6,60
12,1276,710,1341671902,1341671962,0,1,60
12,1277,1,1341716177,1341717103,0,5,926
12,1277,5,1341717103,1341717432,0,5,329
12,1277,8,1341717432,1341724146,0,5,6714
12,1277,711,1341724146,1341727008,0,5,2862
12,1277,712,1341727008,1341727068,0,5,60
12,1278,11,1341754744,1341754804,0,1,60
12,1279,698,1342231710,1342231739,0,6,29
12,1279,699,1342231739,1342231781,0,6,42
12,1279,713,1342231781,1342233099,0,6,1318
12,1279,71,1342233099,1342235630,0,6,2531
12,1279,263,1342235630,1342236022,0,6,392
12,1279,714,1342236022,1342236082,0,6,60
12,1280,21,1342255591,1342255853,0,9,262
12,1280,5,1342255853,1342255872,0,9,19
12,1280,8,1342255872,1342255885,0,9,13
12,1280,701,1342255885,1342256289,0,9,404
12,1280,228,1342256289,1342257497,0,9,1208
12,1280,703,1342257497,1342257524,0,9,27
12,1280,706,1342257524,1342260116,0,9,2592
12,1280,715,1342260116,1342260138,0,9,22
12,1280,11,1342260138,1342260198,0,9,60
12,1281,15,1344581703,1344581740,0,4,37
12,1281,716,1344581740,1344581774,0,4,34
12,1281,717,1344581774,1344581787,0,4,13
12,1281,15,1344581787,1344581847,0,4,60
12,1282,14,1344641041,1344641080,0,4,39
12,1282,481,1344641080,1344641110,0,4,30
12,1282,716,1344641110,1344641128,0,4,18
12,1282,15,1344641128,1344641188,0,4,60
12,1283,481,1344725726,1344725786,0,2,60
12,1283,15,1344725786,1344725846,0,2,60
12,1284,718,1345342168,1345342248,0,2,80
12,1284,719,1345342248,1345342308,0,2,60
12,1285,11,1347666823,1347667156,0,5,333
12,1285,5,1347667156,1347667689,0,5,533
12,1285,20,1347667689,1347668112,0,5,423
12,1285,720,1347668112,1347671897,0,5,3785
12,1285,20,1347671897,1347671957,0,5,60
12,1286,6,1347688856,1347688936,0,6,80
12,1286,721,1347688936,1347688970,0,6,34
12,1286,42,1347688970,1347690207,0,6,1237
12,1286,722,1347690207,1347701294,0,6,11087
12,1286,16,1347701294,1347701323,0,6,29
12,1286,42,1347701323,1347701383,0,6,60
12,1287,5,1347714806,1347714828,0,3,22
12,1287,723,1347714828,1347715487,0,3,659
12,1287,11,1347715487,1347715547,0,3,60
12,1288,11,1351059857,1351060148,0,8,291
12,1288,5,1351060148,1351060537,0,8,389
12,1288,480,1351060537,1351060724,0,8,187
12,1288,724,1351060724,1351062418,0,8,1694
12,1288,725,1351062418,1351062444,0,8,26
12,1288,26,1351062444,1351066528,0,8,4084
12,1288,20,1351066528,1351066570,0,8,42
12,1288,726,1351066570,1351066630,0,8,60
12,1289,698,1353585380,1353586448,0,3,1068
12,1289,727,1353586448,1353595739,0,3,9291
12,1289,708,1353595739,1353595799,0,3,60
12,1290,727,1353643772,1353643798,0,10,26
12,1290,728,1353643798,1353644862,0,10,1064
12,1290,5,1353644862,1353648266,0,10,3404
12,1290,8,1353648266,1353653134,0,10,4868
12,1290,729,1353653134,1353653187,0,10,53
12,1290,730,1353653187,1353659024,0,10,5837
12,1290,731,1353659024,1353659186,0,10,162
12,1290,732,1353659186,1353659463,0,10,277
12,1290,733,1353659463,1353661168,0,10,1705
12,1290,734,1353661168,1353661228,0,10,60
12,1291,236,1353743051,1353743065,0,10,14
12,1291,20,1353743065,1353743078,0,10,13
12,1291,5,1353743078,1353744158,0,10,1080
12,1291,730,1353744158,1353747748,0,10,3590
12,1291,731,1353747748,1353747766,0,10,18
12,1291,236,1353747766,1353750526,0,10,2760
12,1291,26,1353750526,1353750543,0,10,17
12,1291,735,1353750543,1353750574,0,10,31
12,1291,736,1353750574,1353752179,0,10,1605
12,1291,28,1353752179,1353752239,0,10,60
12,1292,727,1353821664,1353823798,0,11,2134
12,1292,5,1353823798,1353823820,0,11,22
12,1292,736,1353823820,1353824032,0,11,212
12,1292,737,1353824032,1353824047,0,11,15
12,1292,738,1353824047,1353828850,0,11,4803
12,1292,739,1353828850,1353836694,0,11,7844
12,1292,8,1353836694,1353840010,0,11,3316
12,1292,236,1353840010,1353840026,0,11,16
12,1292,729,1353840026,1353840069,0,11,43
12,1292,730,1353840069,1353840091,0,11,22
12,1292,731,1353840091,1353840151,0,11,60
12,1293,11,1353848497,1353848557,0,1,60
12,1294,740,1353967675,1353967735,0,1,60
12,1295,741,1354332272,1354332302,0,19,30
12,1295,742,1354332302,1354333882,0,19,1580
12,1295,261,1354333882,1354333900,0,19,18
12,1295,743,1354333900,1354340901,0,19,7001
12,1295,261,1354340901,1354342544,0,19,1643
12,1295,71,1354342544,1354342657,0,19,113
12,1295,667,1354342657,1354346325,0,19,3668
12,1295,5,1354346325,1354346353,0,19,28
12,1295,701,1354346353,1354346531,0,19,178
12,1295,20,1354346531,1354346913,0,19,382
12,1295,228,1354346913,1354349346,0,19,2433
12,1295,731,1354349346,1354349367,0,19,21
12,1295,730,1354349367,1354350041,0,19,674
12,1295,736,1354350041,1354350051,0,19,10
12,1295,5,1354350051,1354350909,0,19,858
12,1295,11,1354350909,1354351053,0,19,144
12,1295,706,1354351053,1354352675,0,19,1622
12,1295,11,1354352675,1354352690,0,19,15
12,1295,684,1354352690,1354352750,0,19,60
12,1296,177,1354420962,1354420971,0,3,9
12,1296,744,1354420971,1354436225,0,3,15254
12,1296,745,1354436225,1354436285,0,3,60
12,1297,746,1354445013,1354458746,0,3,13733
12,1297,28,1354458746,1354458758,0,3,12
12,1297,699,1354458758,1354458818,0,3,60
12,1298,11,1354915758,1354916794,0,4,1036
12,1298,720,1354916794,1354925788,0,4,8994
12,1298,726,1354925788,1354927296,0,4,1508
12,1298,727,1354927296,1354927356,0,4,60
12,1299,730,1354949048,1354949066,0,6,18
12,1299,731,1354949066,1354952073,0,6,3007
12,1299,252,1354952073,1354960299,0,6,8226
12,1299,253,1354960299,1354961540,0,6,1241
12,1299,747,1354961540,1354964546,0,6,3006
12,1299,748,1354964546,1354964606,0,6,60
12,1300,749,1355018001,1355018061,0,1,60
12,1301,727,1355495712,1355495772,0,1,60
12,1302,750,1355545360,1355550485,0,7,5125
12,1302,735,1355550485,1355550508,0,7,23
12,1302,5,1355550508,1355550570,0,7,62
12,1302,26,1355550570,1355551424,0,7,854
12,1302,730,1355551424,1355551454,0,7,30
12,1302,731,1355551454,1355561677,0,7,10223
12,1302,236,1355561677,1355561737,0,7,60
12,1303,751,1355637720,1355639108,0,12,1388
12,1303,727,1355639108,1355640274,0,12,1166
12,1303,5,1355640274,1355640413,0,12,139
12,1303,20,1355640413,1355640448,0,12,35
12,1303,735,1355640448,1355640728,0,12,280
12,1303,731,1355640728,1355640739,0,12,11
12,1303,730,1355640739,1355642639,0,12,1900
12,1303,26,1355642639,1355642659,0,12,20
12,1303,736,1355642659,1355654893,0,12,12234
12,1303,5,1355654893,1355654906,0,12,13
12,1303,8,1355654906,1355655587,0,12,681
12,1303,709,1355655587,1355655647,0,12,60
12,1304,5,1356266894,1356266954,0,1,60
12,1305,14,1356837751,1356844011,0,3,6260
12,1305,336,1356844011,1356846241,0,3,2230
12,1305,752,1356846241,1356846301,0,3,60
12,1306,47,1357086673,1357095465,0,2,8792
12,1306,753,1357095465,1357095525,0,2,60
12,1307,754,1357109916,1357109976,0,1,60
12,1308,5,1357136351,1357136909,0,2,558
12,1308,11,1357136909,1357136969,0,2,60
12,1309,11,1357293743,1357294064,0,4,321
12,1309,5,1357294064,1357294742,0,4,678
12,1309,47,1357294742,1357294754,0,4,12
12,1309,48,1357294754,1357294814,0,4,60
12,1310,750,1357460179,1357465833,0,8,5654
12,1310,5,1357465833,1357465867,0,8,34
12,1310,729,1357465867,1357465906,0,8,39
12,1310,730,1357465906,1357468450,0,8,2544
12,1310,755,1357468450,1357468505,0,8,55
12,1310,284,1357468505,1357477587,0,8,9082
12,1310,756,1357477587,1357479745,0,8,2158
12,1310,757,1357479745,1357479805,0,8,60
12,1311,735,1359193875,1359194113,0,2,238
12,1311,20,1359194113,1359194173,0,2,60
12,1312,758,1359294809,1359294869,0,1,60
12,1313,11,1359609133,1359609701,0,15,568
12,1313,5,1359609701,1359610168,0,15,467
12,1313,759,1359610168,1359610206,0,15,38
12,1313,760,1359610206,1359611440,0,15,1234
12,1313,47,1359611440,1359612338,0,15,898
12,1313,20,1359612338,1359613500,0,15,1162
12,1313,761,1359613500,1359616387,0,15,2887
12,1313,730,1359616387,1359616427,0,15,40
12,1313,10,1359616427,1359623220,0,15,6793
12,1313,243,1359623220,1359623703,0,15,483
12,1313,762,1359623703,1359623739,0,15,36
12,1313,35,1359623739,1359624124,0,15,385
12,1313,585,1359624124,1359626086,0,15,1962
12,1313,763,1359626086,1359630156,0,15,4070
12,1313,764,1359630156,1359630216,0,15,60
12,1314,28,1359726618,1359726678,0,1,60
12,1315,5,1359777032,1359777855,0,11,823
12,1315,765,1359777855,1359783111,0,11,5256
12,1315,5,1359783111,1359783143,0,11,32
12,1315,730,1359783143,1359785343,0,11,2200
12,1315,236,1359785343,1359785423,0,11,80
12,1315,228,1359785423,1359785502,0,11,79
12,1315,766,1359785502,1359787689,0,11,2187
12,1315,767,1359787689,1359790170,0,11,2481
12,1315,768,1359790170,1359790233,0,11,63
12,1315,769,1359790233,1359793037,0,11,2804
12,1315,770,1359793037,1359793097,0,11,60
12,1316,553,1359806098,1359810130,0,2,4032
12,1316,439,1359810130,1359810190,0,2,60
12,1317,5,1359852561,1359853045,0,5,484
12,1317,21,1359853045,1359853432,0,5,387
12,1317,765,1359853432,1359854082,0,5,650
12,1317,263,1359854082,1359854357,0,5,275
12,1317,449,1359854357,1359854417,0,5,60
12,1318,771,1359875040,1359894890,0,2,19850
12,1318,21,1359894890,1359894950,0,2,60
12,1319,772,1360555306,1360555366,0,1,60
13,1320,11,1360822051,1360822085,0,12,34
13,1320,684,1360822085,1360822095,0,12,10
13,1320,741,1360822095,1360822105,0,12,10
13,1320,742,1360822105,1360822148,0,12,43
13,1320,773,1360822148,1360824449,0,12,2301
13,1320,5,1360824449,1360824466,0,12,17
13,1320,731,1360824466,1360824480,0,12,14
13,1320,730,1360824480,1360827055,0,12,2575
13,1320,729,1360827055,1360827138,0,12,83
13,1320,774,1360827138,1360828967,0,12,1829
13,1320,5,1360828967,1360831019,0,12,2052
13,1320,720,1360831019,1360831079,0,12,60
13,1321,775,1333490039,1333490198,0,3,159
13,1321,776,1333490198,1333490676,0,3,478
13,1321,777,1333490676,1333490736,0,3,60
13,1322,778,1333512609,1333513417,0,4,808
13,1322,779,1333513417,1333515272,0,4,1855
13,1322,780,1333515272,1333533926,0,4,18654
13,1322,640,1333533926,1333533986,0,4,60
13,1323,35,1333534500,1333535551,0,5,1051
13,1323,781,1333535551,1333538877,0,5,3326
13,1323,35,1333538877,1333539202,0,5,325
13,1323,640,1333539202,1333549266,0,5,10064
13,1323,782,1333549266,1333549326,0,5,60
13,1324,783,1333579463,1333579689,0,2,226
13,1324,777,1333579689,1333579749,0,2,60
13,1325,776,1333626451,1333626734,0,2,283
13,1325,784,1333626734,1333626794,0,2,60
13,1326,785,1333801865,1333801925,0,1,60
13,1327,775,1333835948,1333836160,0,4,212
13,1327,786,1333836160,1333837086,0,4,926
13,1327,787,1333837086,1333855954,0,4,18868
13,1327,788,1333855954,1333856014,0,4,60
13,1328,776,1333872601,1333872828,0,11,227
13,1328,782,1333872828,1333876083,0,11,3255
13,1328,603,1333876083,1333876832,0,11,749
13,1328,35,1333876832,1333877013,0,11,181
13,1328,789,1333877013,1333878648,0,11,1635
13,1328,790,1333878648,1333879464,0,11,816
13,1328,791,1333879464,1333883600,0,11,4136
13,1328,790,1333883600,1333885178,0,11,1578
13,1328,35,1333885178,1333885662,0,11,484
13,1328,603,1333885662,1333887045,0,11,1383
13,1328,792,1333887045,1333887105,0,11,60
13,1329,793,1333928605,1333928665,0,1,60
13,1330,782,1334008381,1334008578,0,4,197
13,1330,775,1334008578,1334008795,0,4,217
13,1330,786,1334008795,1334009183,0,4,388
13,1330,777,1334009183,1334009243,0,4,60
13,1331,779,1334033163,1334033223,0,1,60
13,1332,794,1334058137,1334058197,0,1,60
13,1333,795,1334093891,1334095155,0,3,1264
13,1333,640,1334095155,1334095480,0,3,325
13,1333,796,1334095480,1334095540,0,3,60
13,1334,779,1334118242,1334118963,0,10,721
13,1334,780,1334118963,1334120613,0,10,1650
13,1334,797,1334120613,1334127180,0,10,6567
13,1334,640,1334127180,1334127857,0,10,677
13,1334,591,1334127857,1334128763,0,10,906
13,1334,798,1334128763,1334135708,0,10,6945
13,1334,798,1334135708,1334137172,0,10,1464
13,1334,591,1334137172,1334138475,0,10,1303
13,1334,640,1334138475,1334139706,0,10,1231
13,1334,799,1334139706,1334139766,0,10,60
13,1335,640,1334152859,1334157278,0,2,4419
13,1335,800,1334157278,1334157338,0,2,60
13,1336,800,1334181355,1334182073,0,6,718
13,1336,786,1334182073,1334182457,0,6,384
13,1336,777,1334182457,1334202668,0,6,20211
13,1336,801,1334202668,1334202742,0,6,74
13,1336,640,1334202742,1334202891,0,6,149
13,1336,585,1334202891,1334202951,0,6,60
13,1337,802,1334203325,1334204388,0,6,1063
13,1337,803,1334204388,1334204551,0,6,163
13,1337,793,1334204551,1334205033,0,6,482
13,1337,791,1334205033,1334207157,0,6,2124
13,1337,585,1334207157,1334207858,0,6,701
13,1337,640,1334207858,1334207918,0,6,60
13,1338,797,1334231027,1334232884,0,3,1857
13,1338,776,1334232884,1334233231,0,3,347
13,1338,804,1334233231,1334233291,0,3,60
13,1339,800,1334267893,1334267921,0,6,28
13,1339,795,1334267921,1334268577,0,6,656
13,1339,782,1334268577,1334268738,0,6,161
13,1339,775,1334268738,1334268938,0,6,200
13,1339,786,1334268938,1334269295,0,6,357
13,1339,777,1334269295,1334269355,0,6,60
13,1340,779,1334290562,1334291438,0,2,876
13,1340,780,1334291438,1334291498,0,2,60
13,1341,640,1334314995,1334315516,0,2,521
13,1341,603,1334315516,1334315576,0,2,60
13,1342,800,1334353321,1334353344,0,6,23
13,1342,795,1334353344,1334354498,0,6,1154
13,1342,603,1334354498,1334354815,0,6,317
13,1342,640,1334354815,1334355069,0,6,254
13,1342,796,1334355069,1334374403,0,6,19334
13,1342,779,1334374403,1334374463,0,6,60
13,1343,805,1334402648,1334403441,0,3,793
13,1343,806,1334403441,1334407135,0,3,3694
13,1343,807,1334407135,1334407195,0,3,60
13,1344,800,1334442932,1334442947,0,10,15
13,1344,795,1334442947,1334444294,0,10,1347
13,1344,808,1334444294,1334444643,0,10,349
13,1344,809,1334444643,1334451048,0,10,6405
13,1344,810,1334451048,1334452318,0,10,1270
13,1344,789,1334452318,1334454139,0,10,1821
13,1344,811,1334454139,1334454824,0,10,685
13,1344,812,1334454824,1334456160,0,10,1336
13,1344,813,1334456160,1334463214,0,10,7054
13,1344,814,1334463214,1334463274,0,10,60
13,1345,815,1334466247,1334466307,0,1,60
13,1346,800,1334525337,1334526472,0,4,1135
13,1346,603,1334526472,1334527177,0,4,705
13,1346,640,1334527177,1334527425,0,4,248
13,1346,796,1334527425,1334527485,0,4,60
13,1347,603,1334563898,1334564397,0,3,499
13,1347,640,1334564397,1334564630,0,3,233
13,1347,801,1334564630,1334564690,0,3,60
13,1348,795,1334612148,1334612907,0,4,759
13,1348,603,1334612907,1334613565,0,4,658
13,1348,640,1334613565,1334613793,0,4,228
13,1348,796,1334613793,1334613853,0,4,60
13,1349,787,1334659334,1334659415,0,8,81
13,1349,777,1334659415,1334660429,0,8,1014
13,1349,776,1334660429,1334660940,0,8,511
13,1349,775,1334660940,1334661035,0,8,95
13,1349,816,1334661035,1334661363,0,8,328
13,1349,782,1334661363,1334661939,0,8,576
13,1349,800,1334661939,1334665997,0,8,4058
13,1349,785,1334665997,1334666057,0,8,60
13,1350,800,1334696082,1334696690,0,4,608
13,1350,782,1334696690,1334696863,0,4,173
13,1350,775,1334696863,1334697181,0,4,318
13,1350,776,1334697181,1334697241,0,4,60
13,1351,793,1334760008,1334760720,0,3,712
13,1351,817,1334760720,1334761025,0,3,305
13,1351,818,1334761025,1334761085,0,3,60
13,1352,800,1334786775,1334786823,0,7,48
13,1352,795,1334786823,1334787545,0,7,722
13,1352,603,1334787545,1334788042,0,7,497
13,1352,640,1334788042,1334788173,0,7,131
13,1352,796,1334788173,1334802314,0,7,14141
13,1352,640,1334802314,1334802550,0,7,236
13,1352,585,1334802550,1334802610,0,7,60
13,1353,793,1334812924,1334813970,0,8,1046
13,1353,585,1334813970,1334814490,0,8,520
13,1353,640,1334814490,1334833146,0,8,18656
13,1353,777,1334833146,1334833499,0,8,353
13,1353,776,1334833499,1334833676,0,8,177
13,1353,775,1334833676,1334833690,0,8,14
13,1353,816,1334833690,1334833836,0,8,146
13,1353,782,1334833836,1334833896,0,8,60
13,1354,785,1334842994,1334843054,0,1,60
13,1355,775,1334872461,1334872733,0,3,272
13,1355,786,1334872733,1334873091,0,3,358
13,1355,777,1334873091,1334873151,0,3,60
13,1356,819,1334895399,1334895636,0,8,237
13,1356,779,1334895636,1334896916,0,8,1280
13,1356,780,1334896916,1334904128,0,8,7212
13,1356,640,1334904128,1334904753,0,8,625
13,1356,35,1334904753,1334904971,0,8,218
13,1356,820,1334904971,1334905832,0,8,861
13,1356,821,1334905832,1334907977,0,8,2145
13,1356,822,1334907977,1334908037,0,8,60
13,1357,803,1334917044,1334917302,0,8,258
13,1357,802,1334917302,1334918196,0,8,894
13,1357,823,1334918196,1334930326,0,8,12130
13,1357,824,1334930326,1334935644,0,8,5318
13,1357,35,1334935644,1334936427,0,8,783
13,1357,603,1334936427,1334936747,0,8,320
13,1357,825,1334936747,1334937398,0,8,651
13,1357,800,1334937398,1334937458,0,8,60
13,1358,826,1334993627,1334994015,0,6,388
13,1358,827,1334994015,1334996274,0,6,2259
13,1358,465,1334996274,1335000864,0,6,4590
13,1358,828,1335000864,1335002705,0,6,1841
13,1358,829,1335002705,1335008159,0,6,5454
13,1358,830,1335008159,1335008219,0,6,60
13,1359,831,1335050798,1335051278,0,17,480
13,1359,808,1335051278,1335051290,0,17,12
13,1359,832,1335051290,1335051947,0,17,657
13,1359,809,1335051947,1335056090,0,17,4143
13,1359,833,1335056090,1335056537,0,17,447
13,1359,789,1335056537,1335058125,0,17,1588
13,1359,834,1335058125,1335059294,0,17,1169
13,1359,835,1335059294,1335060754,0,17,1460
13,1359,836,1335060754,1335063205,0,17,2451
13,1359,791,1335063205,1335063376,0,17,171
13,1359,35,1335063376,1335063882,0,17,506
13,1359,603,1335063882,1335065860,0,17,1978
13,1359,814,1335065860,1335066388,0,17,528
13,1359,795,1335066388,1335067061,0,17,673
13,1359,837,1335067061,1335067480,0,17,419
13,1359,800,1335067480,1335067721,0,17,241
13,1359,792,1335067721,1335067781,0,17,60
13,1360,785,1335095648,1335095708,0,1,60
13,1361,603,1335130253,1335130977,0,5,724
13,1361,796,1335130977,1335147543,0,5,16566
13,1361,640,1335147543,1335150751,0,5,3208
13,1361,35,1335150751,1335150861,0,5,110
13,1361,590,1335150861,1335150921,0,5,60
13,1362,838,1335152603,1335155316,0,17,2713
13,1362,590,1335155316,1335155646,0,17,330
13,1362,817,1335155646,1335156270,0,17,624
13,1362,839,1335156270,1335156350,0,17,80
13,1362,840,1335156350,1335158043,0,17,1693
13,1362,839,1335158043,1335158851,0,17,808
13,1362,817,1335158851,1335159252,0,17,401
13,1362,793,1335159252,1335159806,0,17,554
13,1362,121,1335159806,1335160292,0,17,486
13,1362,841,1335160292,1335162163,0,17,1871
13,1362,842,1335162163,1335162657,0,17,494
13,1362,121,1335162657,1335162844,0,17,187
13,1362,35,1335162844,1335163175,0,17,331
13,1362,843,1335163175,1335163718,0,17,543
13,1362,844,1335163718,1335165068,0,17,1350
13,1362,777,1335165068,1335165116,0,17,48
13,1362,787,1335165116,1335165176,0,17,60
13,1363,640,1335175782,1335176262,0,4,480
13,1363,603,1335176262,1335176466,0,4,204
13,1363,604,1335176466,1335193927,0,4,17461
13,1363,845,1335193927,1335193987,0,4,60
13,1364,846,1335204053,1335204548,0,5,495
13,1364,795,1335204548,1335217972,0,5,13424
13,1364,795,1335217972,1335218592,0,5,620
13,1364,603,1335218592,1335219246,0,5,654
13,1364,640,1335219246,1335219306,0,5,60
13,1365,779,1335240739,1335240882,0,3,143
13,1365,780,1335240882,1335242518,0,3,1636
13,1365,847,1335242518,1335242578,0,3,60
13,1366,776,1335267462,1335267609,0,5,147
13,1366,775,1335267609,1335267622,0,5,13
13,1366,816,1335267622,1335267724,0,5,102
13,1366,782,1335267724,1335267887,0,5,163
13,1366,804,1335267887,1335267947,0,5,60
13,1367,800,1335388533,1335389285,0,3,752
13,1367,786,1335389285,1335389692,0,3,407
13,1367,777,1335389692,1335389752,0,3,60
13,1368,779,1335414282,1335420434,0,4,6152
13,1368,35,1335420434,1335421177,0,4,743
13,1368,791,1335421177,1335421551,0,4,374
13,1368,822,1335421551,1335421611,0,4,60
13,1369,848,1335438530,1335450454,0,4,11924
13,1369,35,1335450454,1335451074,0,4,620
13,1369,603,1335451074,1335451405,0,4,331
13,1369,825,1335451405,1335451465,0,4,60
13,1370,849,1335532866,1335538669,0,3,5803
13,1370,640,1335538669,1335539409,0,3,740
13,1370,603,1335539409,1335539469,0,3,60
13,1371,795,1335566198,1335566875,0,6,677
13,1371,825,1335566875,1335569021,0,6,2146
13,1371,746,1335569021,1335569388,0,6,367
13,1371,850,1335569388,1335570248,0,6,860
13,1371,851,1335570248,1335570293,0,6,45
13,1371,852,1335570293,1335570353,0,6,60
13,1372,853,1335615197,1335622382,0,5,7185
13,1372,746,1335622382,1335624759,0,5,2377
13,1372,603,1335624759,1335625012,0,5,253
13,1372,825,1335625012,1335625521,0,5,509
13,1372,785,1335625521,1335625581,0,5,60
13,1373,825,1335656473,1335656671,0,5,198
13,1373,603,1335656671,1335657207,0,5,536
13,1373,35,1335657207,1335658367,0,5,1160
13,1373,253,1335658367,1335658382,0,5,15
13,1373,59,1335658382,1335658442,0,5,60
13,1374,800,1335907853,1335908063,0,4,210
13,1374,785,1335908063,1335908900,0,4,837
13,1374,603,1335908900,1335909818,0,4,918
13,1374,796,1335909818,1335909878,0,4,60
13,1375,787,1335930801,1335931085,0,2,284
13,1375,788,1335931085,1335931145,0,2,60
13,1376,640,1335956808,1335957294,0,4,486
13,1376,603,1335957294,1335957530,0,4,236
13,1376,825,1335957530,1335959549,0,4,2019
13,1376,785,1335959549,1335959609,0,4,60
13,1377,800,1336054292,1336054352,0,2,60
13,1377,785,1336054352,1336054412,0,2,60
13,1378,800,1336093598,1336093770,0,9,172
13,1378,837,1336093770,1336093881,0,9,111
13,1378,795,1336093881,1336108713,0,9,14832
13,1378,818,1336108713,1336109276,0,9,563
13,1378,817,1336109276,1336109757,0,9,481
13,1378,802,1336109757,1336110525,0,9,768
13,1378,854,1336110525,1336112263,0,9,1738
13,1378,791,1336112263,1336114715,0,9,2452
13,1378,813,1336114715,1336114775,0,9,60
13,1379,855,1336120747,1336133500,0,3,12753
13,1379,856,1336133500,1336142176,0,3,8676
13,1379,817,1336142176,1336142236,0,3,60
13,1380,857,1336142704,1336143877,0,2,1173
13,1380,804,1336143877,1336143937,0,2,60
13,1381,800,1336176899,1336177597,0,12,698
13,1381,858,1336177597,1336178616,0,12,1019
13,1381,809,1336178616,1336183687,0,12,5071
13,1381,859,1336183687,1336183852,0,12,165
13,1381,860,1336183852,1336184506,0,12,654
13,1381,861,1336184506,1336185878,0,12,1372
13,1381,862,1336185878,1336186618,0,12,740
13,1381,812,1336186618,1336187011,0,12,393
13,1381,811,1336187011,1336187592,0,12,581
13,1381,789,1336187592,1336190406,0,12,2814
13,1381,813,1336190406,1336195919,0,12,5513
13,1381,863,1336195919,1336195979,0,12,60
13,1382,603,1336205469,1336205957,0,11,488
13,1382,35,1336205957,1336207400,0,11,1443
13,1382,864,1336207400,1336208416,0,11,1016
13,1382,865,1336208416,1336210620,0,11,2204
13,1382,866,1336210620,1336212147,0,11,1527
13,1382,35,1336212147,1336212658,0,11,511
13,1382,603,1336212658,1336212991,0,11,333
13,1382,604,1336212991,1336213986,0,11,995
13,1382,815,1336213986,1336214894,0,11,908
13,1382,825,1336214894,1336215168,0,11,274
13,1382,806,1336215168,1336215228,0,11,60
13,1383,800,1336258016,1336258925,0,6,909
13,1383,818,1336258925,1336259628,0,6,703
13,1383,867,1336259628,1336259934,0,6,306
13,1383,868,1336259934,1336260829,0,6,895
13,1383,833,1336260829,1336264759,0,6,3930
13,1383,809,1336264759,1336264819,0,6,60
13,1384,825,1336341600,1336342083,0,2,483
13,1384,603,1336342083,1336342143,0,2,60
13,1385,603,1336391205,1336391520,0,4,315
13,1385,869,1336391520,1336391912,0,4,392
13,1385,846,1336391912,1336392265,0,4,353
13,1385,795,1336392265,1336392325,0,4,60
13,1386,800,1336426540,1336426955,0,5,415
13,1386,782,1336426955,1336427194,0,5,239
13,1386,786,1336427194,1336427462,0,5,268
13,1386,776,1336427462,1336427816,0,5,354
13,1386,777,1336427816,1336427876,0,5,60
13,1387,870,1336476742,1336490661,0,2,13919
13,1387,782,1336490661,1336490721,0,2,60
13,1388,800,1336513410,1336513974,0,5,564
13,1388,795,1336513974,1336514738,0,5,764
13,1388,603,1336514738,1336515406,0,5,668
13,1388,640,1336515406,1336515725,0,5,319
13,1388,797,1336515725,1336515785,0,5,60
13,1389,801,1336540653,1336541019,0,2,366
13,1389,871,1336541019,1336541079,0,2,60
13,1390,640,1336563482,1336563836,0,3,354
13,1390,603,1336563836,1336564893,0,3,1057
13,1390,785,1336564893,1336564953,0,3,60
13,1391,787,1336600759,1336600819,0,1,60
13,1392,800,1336689162,1336689911,0,4,749
13,1392,603,1336689911,1336691868,0,4,1957
13,1392,21,1336691868,1336692567,0,4,699
13,1392,872,1336692567,1336692627,0,4,60
13,1393,21,1336910541,1336911682,0,3,1141
13,1393,603,1336911682,1336911841,0,3,159
13,1393,825,1336911841,1336911901,0,3,60
13,1394,800,1336944152,1336944805,0,4,653
13,1394,795,1336944805,1336945671,0,4,866
13,1394,603,1336945671,1336946357,0,4,686
13,1394,640,1336946357,1336946417,0,4,60
13,1395,797,1336967675,1336968025,0,7,350
13,1395,779,1336968025,1336968865,0,7,840
13,1395,780,1336968865,1336970027,0,7,1162
13,1395,819,1336970027,1336980821,0,7,10794
13,1395,35,1336980821,1336982537,0,7,1716
13,1395,822,1336982537,1336982537,0,7,0
13,1395,822,1336982537,1336982597,0,7,60
13,1396,793,1336991922,1336993127,0,2,1205
13,1396,818,1336993127,1336993187,0,2,60
13,1397,795,1337030881,1337031718,0,4,837
13,1397,825,1337031718,1337032855,0,4,1137
13,1397,640,1337032855,1337035730,0,4,2875
13,1397,797,1337035730,1337035790,0,4,60
13,1398,779,1337055654,1337056388,0,2,734
13,1398,780,1337056388,1337056448,0,2,60
13,1399,640,1337079551,1337079950,0,3,399
13,1399,603,1337079950,1337080218,0,3,268
13,1399,825,1337080218,1337080278,0,3,60
13,1400,800,1337118704,1337119211,0,3,507
13,1400,776,1337119211,1337119573,0,3,362
13,1400,777,1337119573,1337119633,0,3,60
13,1401,779,1337143017,1337144323,0,7,1306
13,1401,780,1337144323,1337163298,0,7,18975
13,1401,777,1337163298,1337163698,0,7,400
13,1401,776,1337163698,1337163949,0,7,251
13,1401,816,1337163949,1337164074,0,7,125
13,1401,782,1337164074,1337164316,0,7,242
13,1401,792,1337164316,1337164376,0,7,60
13,1402,782,1337205517,1337205677,0,7,160
13,1402,775,1337205677,1337219201,0,7,13524
13,1402,640,1337219201,1337219431,0,7,230
13,1402,585,1337219431,1337219777,0,7,346
13,1402,793,1337219777,1337220922,0,7,1145
13,1402,35,1337220922,1337223855,0,7,2933
13,1402,561,1337223855,1337223915,0,7,60
13,1403,852,1337257417,1337257861,0,5,444
13,1403,873,1337257861,1337262642,0,5,4781
13,1403,746,1337262642,1337264097,0,5,1455
13,1403,603,1337264097,1337264411,0,5,314
13,1403,825,1337264411,1337264471,0,5,60
13,1404,800,1337291449,1337296001,0,3,4552
13,1404,603,1337296001,1337296480,0,3,479
13,1404,640,1337296480,1337296540,0,3,60
13,1405,818,1337347365,1337347673,0,4,308
13,1405,857,1337347673,1337349026,0,4,1353
13,1405,874,1337349026,1337349591,0,4,565
13,1405,800,1337349591,1337349651,0,4,60
13,1406,800,1337380725,1337381592,0,6,867
13,1406,603,1337381592,1337382911,0,6,1319
13,1406,746,1337382911,1337382991,0,6,80
13,1406,850,1337382991,1337384227,0,6,1236
13,1406,851,1337384227,1337384665,0,6,438
13,1406,852,1337384665,1337384725,0,6,60
13,1407,863,1337425197,1337425305,0,2,108
13,1407,782,1337425305,1337425365,0,2,60
13,1408,746,1337464182,1337464325,0,2,143
13,1408,850,1337464325,1337464385,0,2,60
13,1409,640,1337593381,1337594649,0,5,1268
13,1409,875,1337594649,1337596405,0,5,1756
13,1409,876,1337596405,1337606675,0,5,10270
13,1409,875,1337606675,1337607724,0,5,1049
13,1409,603,1337607724,1337607784,0,5,60
13,1410,800,1337635734,1337635836,0,6,102
13,1410,795,1337635836,1337636373,0,6,537
13,1410,825,1337636373,1337636609,0,6,236
13,1410,603,1337636609,1337641258,0,6,4649
13,1410,797,1337641258,1337643366,0,6,2108
13,1410,640,1337643366,1337643426,0,6,60
13,1411,640,1337659627,1337660069,0,9,442
13,1411,585,1337660069,1337660512,0,9,443
13,1411,793,1337660512,1337661381,0,9,869
13,1411,803,1337661381,1337661560,0,9,179
13,1411,802,1337661560,1337662765,0,9,1205
13,1411,791,1337662765,1337664976,0,9,2211
13,1411,877,1337664976,1337665606,0,9,630
13,1411,776,1337665606,1337666203,0,9,597
13,1411,878,1337666203,1337666263,0,9,60
13,1412,785,1337696784,1337696844,0,1,60
13,1413,795,1337822366,1337822443,0,9,77
13,1413,800,1337822443,1337823268,0,9,825
13,1413,818,1337823268,1337823919,0,9,651
13,1413,803,1337823919,1337824314,0,9,395
13,1413,793,1337824314,1337825306,0,9,992
13,1413,879,1337825306,1337827505,0,9,2199
13,1413,585,1337827505,1337827770,0,9,265
13,1413,640,1337827770,1337837393,0,9,9623
13,1413,797,1337837393,1337837453,0,9,60
13,1414,847,1337851643,1337851773,0,3,130
13,1414,640,1337851773,1337852057,0,3,284
13,1414,35,1337852057,1337852117,0,3,60
13,1415,35,1337941183,1337955866,0,2,14683
13,1415,808,1337955866,1337955926,0,2,60
13,1416,878,1337986709,1337987534,0,2,825
13,1416,603,1337987534,1337987594,0,2,60
13,1417,795,1338081511,1338082286,0,4,775
13,1417,880,1338082286,1338084899,0,4,2613
13,1417,881,1338084899,1338093275,0,4,8376
13,1417,882,1338093275,1338093335,0,4,60
13,1418,883,1338185073,1338186800,0,5,1727
13,1418,881,1338186800,1338195970,0,5,9170
13,1418,603,1338195970,1338196845,0,5,875
13,1418,640,1338196845,1338201328,0,5,4483
13,1418,884,1338201328,1338201388,0,5,60
13,1419,640,1338211950,1338212277,0,4,327
13,1419,603,1338212277,1338212663,0,4,386
13,1419,825,1338212663,1338213120,0,4,457
13,1419,785,1338213120,1338213180,0,4,60
13,1420,603,1338242425,1338242811,0,7,386
13,1420,640,1338242811,1338259366,0,7,16555
13,1420,885,1338259366,1338259697,0,7,331
13,1420,886,1338259697,1338260880,0,7,1183
13,1420,887,1338260880,1338262381,0,7,1501
13,1420,585,1338262381,1338262749,0,7,368
13,1420,640,1338262749,1338262809,0,7,60
13,1421,775,1338284463,1338284523,0,1,60
13,1422,800,1338327638,1338327828,0,6,190
13,1422,795,1338327828,1338328303,0,6,475
13,1422,603,1338328303,1338328779,0,6,476
13,1422,640,1338328779,1338328927,0,6,148
13,1422,796,1338328927,1338348612,0,6,19685
13,1422,788,1338348612,1338348672,0,6,60
13,1423,651,1338353259,1338353319,0,1,60
13,1424,603,1338501441,1338502007,0,3,566
13,1424,640,1338502007,1338502270,0,3,263
13,1424,796,1338502270,1338502330,0,3,60
13,1425,640,1338544880,1338545250,0,4,370
13,1425,35,1338545250,1338546140,0,4,890
13,1425,888,1338546140,1338547003,0,4,863
13,1425,889,1338547003,1338547063,0,4,60
13,1426,890,1338573546,1338573606,0,1,60
13,1427,785,1338722627,1338722687,0,1,60
13,1428,795,1338760425,1338761104,0,4,679
13,1428,603,1338761104,1338761696,0,4,592
13,1428,640,1338761696,1338761817,0,4,121
13,1428,796,1338761817,1338761877,0,4,60
13,1429,891,1338782249,1338782309,0,1,60
13,1430,892,1338806318,1338819844,0,3,13526
13,1430,640,1338819844,1338820200,0,3,356
13,1430,603,1338820200,1338820260,0,3,60
13,1431,795,1338847028,1338848022,0,4,994
13,1431,640,1338848022,1338848373,0,4,351
13,1431,801,1338848373,1338867265,0,4,18892
13,1431,788,1338867265,1338867325,0,4,60
13,1432,797,1338879261,1338891831,0,2,12570
13,1432,799,1338891831,1338891891,0,2,60
13,1433,640,1338906834,1338906894,0,1,60
13,1434,893,1338974850,1338977032,0,6,2182
13,1434,35,1338977032,1338987388,0,6,10356
13,1434,894,1338987388,1338987924,0,6,536
13,1434,35,1338987924,1338988609,0,6,685
13,1434,603,1338988609,1338989129,0,6,520
13,1434,795,1338989129,1338989189,0,6,60
13,1435,793,1339038620,1339044837,0,4,6217
13,1435,895,1339044837,1339045716,0,4,879
13,1435,21,1339045716,1339045786,0,4,70
13,1435,99,1339045786,1339045846,0,4,60
13,1436,35,1339408059,1339410239,0,5,2180
13,1436,640,1339410239,1339413664,0,5,3425
13,1436,896,1339413664,1339428281,0,5,14617
13,1436,640,1339428281,1339429411,0,5,1130
13,1436,897,1339429411,1339429471,0,5,60
13,1437,898,1339456748,1339457605,0,9,857
13,1437,803,1339457605,1339457729,0,9,124
13,1437,793,1339457729,1339458470,0,9,741
13,1437,35,1339458470,1339459656,0,9,1186
13,1437,837,1339459656,1339459721,0,9,65
13,1437,795,1339459721,1339459983,0,9,262
13,1437,899,1339459983,1339460467,0,9,484
13,1437,900,1339460467,1339475169,0,9,14702
13,1437,603,1339475169,1339475229,0,9,60
13,1438,21,1339480655,1339482626,0,3,1971
13,1438,35,1339482626,1339482694,0,3,68
13,1438,901,1339482694,1339482754,0,3,60
13,1439,902,1343518228,1343518246,0,5,18
13,1439,21,1343518246,1343521852,0,5,3606
13,1439,480,1343521852,1343522017,0,5,165
13,1439,5,1343522017,1343522758,0,5,741
13,1439,903,1343522758,1343522818,0,5,60
13,1440,903,1343549200,1343550745,0,6,1545
13,1440,35,1343550745,1343551156,0,6,411
13,1440,35,1343551156,1343562039,0,6,10883
13,1440,904,1343562039,1343563023,0,6,984
13,1440,905,1343563023,1343563579,0,6,556
13,1440,906,1343563579,1343563639,0,6,60
13,1441,907,1343571829,1343574212,0,2,2383
13,1441,908,1343574212,1343574272,0,2,60
13,1442,793,1343604980,1343605848,0,5,868
13,1442,905,1343605848,1343609873,0,5,4025
13,1442,909,1343609873,1343614220,0,5,4347
13,1442,21,1343614220,1343615691,0,5,1471
13,1442,872,1343615691,1343615751,0,5,60
13,1443,35,1352766975,1352768647,0,7,1672
13,1443,781,1352768647,1352771575,0,7,2928
13,1443,35,1352771575,1352772265,0,7,690
13,1443,604,1352772265,1352773879,0,7,1614
13,1443,910,1352773879,1352778477,0,7,4598
13,1443,911,1352778477,1352782796,0,7,4319
13,1443,606,1352782796,1352782856,0,7,60
13,1444,603,1352793163,1352793730,0,7,567
13,1444,35,1352793730,1352794093,0,7,363
13,1444,912,1352794093,1352802313,0,7,8220
13,1444,35,1352802313,1352803138,0,7,825
13,1444,177,1352803138,1352803497,0,7,359
13,1444,913,1352803497,1352804198,0,7,701
13,1444,914,1352804198,1352804258,0,7,60
13,1445,177,1352817589,1352817649,0,1,60
13,1446,260,1354323761,1354326054,0,12,2293
13,1446,793,1354326054,1354328066,0,12,2012
13,1446,601,1354328066,1354329853,0,12,1787
13,1446,168,1354329853,1354330449,0,12,596
13,1446,915,1354330449,1354331072,0,12,623
13,1446,253,1354331072,1354331143,0,12,71
13,1446,59,1354331143,1354331575,0,12,432
13,1446,916,1354331575,1354333227,0,12,1652
13,1446,917,1354333227,1354335005,0,12,1778
13,1446,916,1354335005,1354335438,0,12,433
13,1446,253,1354335438,1354337272,0,12,1834
13,1446,813,1354337272,1354337332,0,12,60
13,1447,918,1354346813,1354347988,0,10,1175
13,1447,789,1354347988,1354350828,0,10,2840
13,1447,802,1354350828,1354352172,0,10,1344
13,1447,791,1354352172,1354353374,0,10,1202
13,1447,919,1354353374,1354354627,0,10,1253
13,1447,920,1354354627,1354355292,0,10,665
13,1447,921,1354355292,1354357977,0,10,2685
13,1447,922,1354357977,1354359261,0,10,1284
13,1447,923,1354359261,1354364757,0,10,5496
13,1447,924,1354364757,1354364817,0,10,60
13,1448,923,1354373162,1354373648,0,4,486
13,1448,920,1354373648,1354375253,0,4,1605
13,1448,35,1354375253,1354376090,0,4,837
13,1448,35,1354376090,1354376150,0,4,60
13,1449,918,1354403828,1354404252,0,5,424
13,1449,925,1354404252,1354405225,0,5,973
13,1449,926,1354405225,1354408147,0,5,2922
13,1449,927,1354408147,1354409833,0,5,1686
13,1449,928,1354409833,1354409893,0,5,60
13,1450,241,1354428348,1354428415,0,5,67
13,1450,929,1354428415,1354428935,0,5,520
13,1450,930,1354428935,1354429378,0,5,443
13,1450,931,1354429378,1354430830,0,5,1452
13,1450,932,1354430830,1354430890,0,5,60
13,1451,918,1354484573,1354484633,0,1,60
14,1452,933,1354506979,1354507039,0,1,60
14,1453,524,1333532440,1333545772,0,2,13332
14,1453,934,1333545772,1333545832,0,2,60
14,1454,935,1333805332,1333806903,0,2,1571
14,1454,499,1333806903,1333806963,0,2,60
14,1455,19,1333877227,1333889889,0,3,12662
14,1455,524,1333889889,1333890170,0,3,281
14,1455,5,1333890170,1333890230,0,3,60
14,1456,524,1333976795,1333976855,0,1,60
14,1457,936,1334042855,1334043142,0,2,287
14,1457,937,1334043142,1334043202,0,2,60
14,1458,5,1334065000,1334065060,0,1,60
14,1459,710,1334197128,1334198382,0,7,1254
14,1459,938,1334198382,1334198960,0,7,578
14,1459,1,1334198960,1334200044,0,7,1084
14,1459,939,1334200044,1334200692,0,7,648
14,1459,737,1334200692,1334201012,0,7,320
14,1459,737,1334201012,1334201731,0,7,719
14,1459,524,1334201731,1334201791,0,7,60
14,1460,936,1334225135,1334235653,0,3,10518
14,1460,524,1334235653,1334237815,0,3,2162
14,1460,1,1334237815,1334237875,0,3,60
14,1461,5,1334277135,1334277195,0,1,60
14,1462,5,1334327041,1334328376,0,2,1335
14,1462,1,1334328376,1334328436,0,2,60
14,1463,940,1334408818,1334408982,0,2,164
14,1463,524,1334408982,1334409042,0,2,60
14,1464,936,1334463985,1334464045,0,1,60
14,1465,524,1334494285,1334496694,0,2,2409
14,1465,1,1334496694,1334496754,0,2,60
14,1466,5,1334582146,1334584941,0,2,2795
14,1466,941,1334584941,1334585001,0,2,60
14,1467,524,1334756482,1334761597,0,3,5115
14,1467,524,1334761597,1334763992,0,3,2395
14,1467,942,1334763992,1334764052,0,3,60
14,1468,936,1334909750,1334909810,0,1,60
14,1469,710,1334934060,1334934120,0,1,60
14,1470,19,1335005112,1335005172,0,1,60
14,1471,19,1335087554,1335087614,0,1,60
14,1472,5,1335190704,1335190764,0,1,60
14,1473,524,1335359316,1335359376,0,1,60
14,1474,524,1335539312,1335540009,0,3,697
14,1474,5,1335540009,1335541505,0,3,1496
14,1474,942,1335541505,1335541565,0,3,60
14,1475,524,1335570474,1335570534,0,1,60
14,1476,5,1335708736,1335708796,0,1,60
14,1477,935,1336050137,1336053703,0,2,3566
14,1477,943,1336053703,1336053763,0,2,60
14,1478,1,1336091361,1336092914,0,2,1553
14,1478,524,1336092914,1336092974,0,2,60
14,1479,5,1336137671,1336137731,0,1,60
14,1480,524,1336179311,1336192801,0,2,13490
14,1480,944,1336192801,1336192861,0,2,60
14,1481,524,1336223525,1336223585,0,1,60
14,1482,524,1336351889,1336371200,0,2,19311
14,1482,936,1336371200,1336371260,0,2,60
14,1483,524,1336395702,1336396218,0,3,516
14,1483,940,1336396218,1336397096,0,3,878
14,1483,5,1336397096,1336397156,0,3,60
14,1484,5,1336482944,1336483004,0,1,60
14,1485,524,1336610777,1336610837,0,1,60
14,1486,1,1336695768,1336697222,0,2,1454
14,1486,524,1336697222,1336697282,0,2,60
14,1487,5,1336798050,1336801846,0,3,3796
14,1487,945,1336801846,1336808427,0,3,6581
14,1487,5,1336808427,1336808487,0,3,60
14,1488,524,1336867700,1336867760,0,1,60
14,1489,524,1336914508,1336915592,0,3,1084
14,1489,5,1336915592,1336917809,0,3,2217
14,1489,1,1336917809,1336917869,0,3,60
14,1490,524,1336956059,1336956119,0,1,60
14,1491,946,1336984108,1336985390,0,2,1282
14,1491,947,1336985390,1336985450,0,2,60
14,1492,948,1337041789,1337042332,0,4,543
14,1492,524,1337042332,1337061633,0,4,19301
14,1492,19,1337061633,1337062014,0,4,381
14,1492,19,1337062014,1337062074,0,4,60
14,1493,524,1337086317,1337086377,0,1,60
14,1494,5,1337141255,1337149067,0,5,7812
14,1494,16,1337149067,1337150831,0,5,1764
14,1494,5,1337150831,1337152842,0,5,2011
14,1494,1,1337152842,1337153838,0,5,996
14,1494,949,1337153838,1337153898,0,5,60
14,1495,524,1337346109,1337346169,0,1,60
14,1496,524,1337388596,1337391995,0,2,3399
14,1496,524,1337391995,1337392055,0,2,60
14,1497,524,1337605404,1337607508,0,2,2104
14,1497,942,1337607508,1337607568,0,2,60
14,1498,524,1337647699,1337648295,0,3,596
14,1498,479,1337648295,1337668476,0,3,20181
14,1498,950,1337668476,1337668536,0,3,60
14,1499,5,1337693985,1337694045,0,1,60
14,1500,5,1337837046,1337837106,0,1,60
14,1501,5,1337952684,1337952744,0,1,60
14,1502,524,1337993753,1337995241,0,2,1488
14,1502,524,1337995241,1337995301,0,2,60
14,1503,950,1338022670,1338022730,0,1,60
14,1504,524,1338079697,1338079757,0,1,60
14,1505,19,1338105331,1338124157,0,2,18826
14,1505,5,1338124157,1338124217,0,2,60
14,1506,951,1338189220,1338189431,0,8,211
14,1506,952,1338189431,1338191882,0,8,2451
14,1506,953,1338191882,1338193193,0,8,1311
14,1506,954,1338193193,1338195037,0,8,1844
14,1506,955,1338195037,1338195789,0,8,752
14,1506,956,1338195789,1338197348,0,8,1559
14,1506,954,1338197348,1338206049,0,8,8701
14,1506,194,1338206049,1338206109,0,8,60
14,1507,957,1338299843,1338299903,0,1,60
14,1508,950,1338366483,1338366543,0,1,60
14,1509,524,1338476665,1338479298,0,2,2633
14,1509,1,1338479298,1338479358,0,2,60
14,1510,5,1338685190,1338685670,0,2,480
14,1510,524,1338685670,1338685730,0,2,60
14,1511,950,1338710669,1338727859,0,2,17190
14,1511,524,1338727859,1338727919,0,2,60
14,1512,524,1338771719,1338771779,0,1,60
14,1513,524,1338814106,1338816342,0,2,2236
14,1513,942,1338816342,1338816402,0,2,60
14,1514,673,1339029825,1339030347,0,2,522
14,1514,524,1339030347,1339030407,0,2,60
14,1515,946,1339052819,1339053922,0,3,1103
14,1515,524,1339053922,1339073795,0,3,19873
14,1515,524,1339073795,1339073855,0,3,60
14,1516,940,1339074700,1339074760,0,1,60
14,1517,943,1339115182,1339117592,0,2,2410
14,1517,524,1339117592,1339117652,0,2,60
14,1518,5,1339162549,1339162609,0,1,60
14,1519,524,1339204118,1339204178,0,1,60
14,1520,950,1339226449,1339245176,0,3,18727
14,1520,5,1339245176,1339246778,0,3,1602
14,1520,1,1339246778,1339246838,0,3,60
14,1521,524,1339289585,1339289645,0,1,60
14,1522,950,1339314606,1339333436,0,2,18830
14,1522,524,1339333436,1339333496,0,2,60
14,1523,950,1339474609,1339474669,0,1,60
14,1524,524,1339506319,1339506379,0,1,60
14,1525,524,1339548547,1339569326,0,3,20779
14,1525,936,1339569326,1339570142,0,3,816
14,1525,947,1339570142,1339570202,0,3,60
14,1526,16,1339595014,1339595074,0,1,60
14,1527,524,1339635245,1339655705,0,2,20460
14,1527,946,1339655705,1339655765,0,2,60
14,1528,947,1339656956,1339657016,0,1,60
14,1529,958,1339929818,1339938443,0,3,8625
14,1529,524,1339938443,1339939440,0,3,997
14,1529,5,1339939440,1339939500,0,3,60
14,1530,524,1339980474,1339980534,0,1,60
14,1531,946,1340002101,1340002161,0,1,60
14,1532,946,1340252182,1340252242,0,1,60
14,1533,524,1340284337,1340284397,0,1,60
14,1534,524,1341104070,1341104130,0,1,60
14,1535,959,1341214348,1341214408,0,1,60
14,1536,524,1341277029,1341277089,0,1,60
14,1537,960,1341299253,1341299313,0,1,60
14,1538,5,1341322710,1341322770,0,1,60
14,1539,524,1341363751,1341363811,0,1,60
14,1540,960,1341387047,1341406946,0,2,19899
14,1540,524,1341406946,1341407006,0,2,60
14,1541,961,1341482983,1341495798,0,2,12815
14,1541,1,1341495798,1341495858,0,2,60
14,1542,524,1341622495,1341622555,0,1,60
14,1543,524,1341667098,1341668209,0,2,1111
14,1543,5,1341668209,1341668269,0,2,60
14,1544,524,1341708994,1341709054,0,1,60
14,1545,5,1341753230,1341753290,0,1,60
14,1546,5,1341795169,1341795637,0,3,468
14,1546,20,1341795637,1341796059,0,3,422
14,1546,524,1341796059,1341796119,0,3,60
14,1547,950,1341818478,1341818538,0,1,60
14,1548,5,1341841630,1341843805,0,2,2175
14,1548,710,1341843805,1341843865,0,2,60
14,1549,5,1341998085,1341998145,0,1,60
14,1550,950,1342078784,1342098490,0,3,19706
14,1550,524,1342098490,1342099179,0,3,689
14,1550,5,1342099179,1342099239,0,3,60
14,1551,942,1342100500,1342101497,0,2,997
14,1551,957,1342101497,1342101557,0,2,60
14,1552,954,1342150847,1342160682,0,4,9835
14,1552,955,1342160682,1342165533,0,4,4851
14,1552,5,1342165533,1342166233,0,4,700
14,1552,5,1342166233,1342166293,0,4,60
14,1553,524,1342227399,1342227459,0,1,60
14,1554,944,1342257291,1342257351,0,1,60
14,1555,524,1342358042,1342361064,0,2,3022
14,1555,1,1342361064,1342361124,0,2,60
14,1556,944,1342423719,1342442087,0,2,18368
14,1556,524,1342442087,1342442147,0,2,60
14,1557,524,1342573014,1342573074,0,1,60
14,1558,16,1342616046,1342616106,0,1,60
14,1559,935,1342791800,1342792774,0,2,974
14,1559,5,1342792774,1342792834,0,2,60
14,1560,524,1342961822,1342962320,0,3,498
14,1560,940,1342962320,1342962970,0,3,650
14,1560,5,1342962970,1342963030,0,3,60
14,1561,524,1343135185,1343136563,0,2,1378
14,1561,5,1343136563,1343136623,0,2,60
14,1562,944,1343459441,1343481039,0,2,21598
14,1562,524,1343481039,1343481099,0,2,60
14,1563,710,1343483765,1343483825,0,1,60
14,1564,5,1343523662,1343524101,0,2,439
14,1564,524,1343524101,1343524161,0,2,60
14,1565,944,1343545382,1343547517,0,2,2135
14,1565,950,1343547517,1343547577,0,2,60
14,1566,524,1343567112,1343567172,0,1,60
14,1567,962,1344593562,1344593965,0,5,403
14,1567,1,1344593965,1344595148,0,5,1183
14,1567,5,1344595148,1344595726,0,5,578
14,1567,8,1344595726,1344606189,0,5,10463
14,1567,943,1344606189,1344606249,0,5,60
14,1568,963,1344665680,1344665740,0,1,60
14,1569,524,1344691230,1344692295,0,2,1065
14,1569,934,1344692295,1344692355,0,2,60
14,1570,944,1344751677,1344752716,0,3,1039
14,1570,950,1344752716,1344753612,0,3,896
14,1570,524,1344753612,1344753672,0,3,60
14,1571,524,1344776370,1344776820,0,2,450
14,1571,940,1344776820,1344776880,0,2,60
14,1572,5,1345128749,1345128809,0,1,60
14,1573,950,1345271040,1345271100,0,1,60
14,1574,524,1345294819,1345294879,0,1,60
14,1575,524,1345424425,1345438710,0,2,14285
14,1575,944,1345438710,1345438770,0,2,60
14,1576,524,1345468007,1345468693,0,2,686
14,1576,5,1345468693,1345468753,0,2,60
14,1577,524,1346893901,1346914357,0,2,20456
14,1577,950,1346914357,1346914417,0,2,60
14,1578,964,1347545275,1347545335,0,1,60
14,1579,5,1347695751,1347696505,0,4,754
14,1579,965,1347696505,1347697921,0,4,1416
14,1579,966,1347697921,1347698595,0,4,674
14,1579,959,1347698595,1347698655,0,4,60
14,1580,950,1349686277,1349701005,0,2,14728
14,1580,524,1349701005,1349701065,0,2,60
14,1581,524,1350134405,1350134465,0,1,60
14,1582,20,1350608326,1350608386,0,1,60
14,1583,524,1350652552,1350652612,0,1,60
14,1584,524,1350998729,1350998789,0,1,60
14,1585,524,1351040765,1351058611,0,2,17846
14,1585,950,1351058611,1351058671,0,2,60
14,1586,293,1351137923,1351140457,0,2,2534
14,1586,967,1351140457,1351140517,0,2,60
14,1587,950,1351231589,1351231649,0,1,60
14,1588,960,1351326625,1351326685,0,1,60
14,1589,950,1351404353,1351404413,0,1,60
14,1590,950,1351490592,1351490652,0,1,60
14,1591,950,1351658339,1351658399,0,1,60
14,1592,524,1351731599,1351752832,0,2,21233
14,1592,944,1351752832,1351752892,0,2,60
14,1593,935,1351775860,1351775920,0,1,60
14,1594,524,1352110875,1352121122,0,2,10247
14,1594,20,1352121122,1352121182,0,2,60
14,1595,5,1352250046,1352268282,0,4,18236
14,1595,944,1352268282,1352269195,0,4,913
14,1595,950,1352269195,1352270431,0,4,1236
14,1595,960,1352270431,1352270491,0,4,60
14,1596,16,1352293282,1352293342,0,1,60
14,1597,5,1352508435,1352508495,0,1,60
14,1598,524,1352596159,1352596219,0,1,60
14,1599,950,1352619779,1352639012,0,2,19233
14,1599,934,1352639012,1352639072,0,2,60
14,1600,950,1352701495,1352701555,0,1,60
14,1601,16,1352727192,1352727252,0,1,60
14,1602,524,1353027836,1353027896,0,1,60
14,1603,950,1353050054,1353050114,0,1,60
14,1604,950,1353136924,1353154291,0,2,17367
14,1604,524,1353154291,1353154351,0,2,60
14,1605,943,1353247432,1353247492,0,1,60
14,1606,946,1353393331,1353393391,0,1,60
14,1607,944,1353474971,1353475031,0,1,60
14,1608,16,1353503870,1353503930,0,1,60
14,1609,5,1353575944,1353576342,0,5,398
14,1609,20,1353576342,1353580124,0,5,3782
14,1609,524,1353580124,1353593417,0,5,13293
14,1609,1,1353593417,1353594136,0,5,719
14,1609,942,1353594136,1353594196,0,5,60
14,1610,16,1353677472,1353677532,0,1,60
14,1611,968,1353732136,1353732196,0,1,60
14,1612,524,1353763394,1353763454,0,1,60
14,1613,950,1353919325,1353935408,0,2,16083
14,1613,20,1353935408,1353935468,0,2,60
14,1614,16,1354152162,1354164959,0,2,12797
14,1614,950,1354164959,1354165019,0,2,60
14,1615,950,1354350063,1354369436,0,2,19373
14,1615,5,1354369436,1354369496,0,2,60
14,1616,5,1354495922,1354495982,0,1,60
14,1617,524,1354540351,1354541259,0,2,908
14,1617,5,1354541259,1354541319,0,2,60
14,1618,16,1354583671,1354583731,0,1,60
14,1619,5,1354669428,1354688224,0,2,18796
14,1619,950,1354688224,1354688284,0,2,60
14,1620,944,1354860004,1354862562,0,2,2558
14,1620,950,1354862562,1354862622,0,2,60
14,1621,16,1354887199,1354890181,0,2,2982
14,1621,1,1354890181,1354890241,0,2,60
14,1622,5,1354927777,1354928345,0,4,568
14,1622,524,1354928345,1354946164,0,4,17819
14,1622,969,1354946164,1354947674,0,4,1510
14,1622,960,1354947674,1354947734,0,4,60
14,1623,944,1355041072,1355041132,0,1,60
14,1624,944,1355294912,1355294972,0,1,60
14,1625,524,1355360707,1355373649,0,2,12942
14,1625,950,1355373649,1355373709,0,2,60
14,1626,942,1355488073,1355488646,0,2,573
14,1626,710,1355488646,1355488706,0,2,60
14,1627,524,1355533740,1355555216,0,2,21476
14,1627,944,1355555216,1355555276,0,2,60
14,1628,970,1355746211,1355749079,0,3,2868
14,1628,942,1355749079,1355749120,0,3,41
14,1628,971,1355749120,1355749180,0,3,60
14,1629,16,1355793072,1355793143,0,3,71
14,1629,524,1355793143,1355814228,0,3,21085
14,1629,972,1355814228,1355814288,0,3,60
14,1630,950,1355904913,1355908386,0,2,3473
14,1630,942,1355908386,1355908446,0,2,60
14,1631,5,1355964882,1355977182,0,2,12300
14,1631,950,1355977182,1355977242,0,2,60
14,1632,950,1356052577,1356052637,0,1,60
14,1633,8,1356100256,1356100316,0,1,60
14,1634,950,1356159385,1356159445,0,1,60
14,1635,524,1356273552,1356275773,0,2,2221
14,1635,942,1356275773,1356275833,0,2,60
14,1636,950,1356678182,1356678242,0,1,60
14,1637,934,1356703613,1356703673,0,1,60
14,1638,5,1356915615,1356933973,0,2,18358
14,1638,950,1356933973,1356934033,0,2,60
14,1639,946,1357019187,1357038077,0,2,18890
14,1639,524,1357038077,1357038137,0,2,60
14,1640,524,1357087740,1357087800,0,1,60
14,1641,19,1357114957,1357114968,0,4,11
14,1641,950,1357114968,1357115425,0,4,457
14,1641,19,1357115425,1357133746,0,4,18321
14,1641,16,1357133746,1357133806,0,4,60
14,1642,19,1357195540,1357195600,0,1,60
14,1643,973,1357265342,1357279137,0,2,13795
14,1643,974,1357279137,1357279197,0,2,60
14,1644,944,1357451585,1357451645,0,1,60
14,1645,1,1357482341,1357482401,0,1,60
14,1646,950,1357541835,1357541895,0,1,60
14,1647,940,1357650985,1357652016,0,2,1031
14,1647,5,1357652016,1357652076,0,2,60
14,1648,16,1357824843,1357824903,0,1,60
14,1649,524,1357953137,1357966002,0,3,12865
14,1649,975,1357966002,1357966062,0,3,60
14,1649,976,1357966062,1357966122,0,3,60
14,1650,970,1357994001,1357994061,0,1,60
14,1651,976,1358061605,1358061665,0,1,60
14,1652,942,1358136175,1358139524,0,2,3349
14,1652,954,1358139524,1358139584,0,2,60
14,1653,950,1358226370,1358226430,0,1,60
14,1654,524,1358252425,1358252485,0,1,60
14,1655,970,1358339333,1358339393,0,1,60
14,1656,613,1358428382,1358428442,0,1,60
14,1657,524,1358816667,1358835538,0,3,18871
14,1657,944,1358835538,1358835975,0,3,437
14,1657,944,1358835975,1358836035,0,3,60
14,1658,942,1359124552,1359124612,0,1,60
14,1659,976,1359183106,1359183182,0,3,76
14,1659,976,1359183182,1359193412,0,3,10230
14,1659,524,1359193412,1359193472,0,3,60
14,1660,970,1359204745,1359204805,0,1,60
14,1661,970,1359291577,1359291637,0,1,60
14,1662,524,1359594189,1359594249,0,1,60
14,1663,976,1359615811,1359616138,0,3,327
14,1663,976,1359616138,1359617206,0,3,1068
14,1663,950,1359617206,1359617266,0,3,60
14,1664,5,1359697983,1359698043,0,1,60
14,1665,940,1359725390,1359726905,0,2,1515
14,1665,613,1359726905,1359726965,0,2,60
14,1666,613,1360157985,1360158045,0,1,60
14,1667,524,1360199638,1360219700,0,2,20062
14,1667,976,1360219700,1360219760,0,2,60
14,1668,613,1360242634,1360242694,0,1,60
14,1669,524,1360308715,1360309140,0,2,425
14,1669,46,1360309140,1360309200,0,2,60
14,1670,976,1360570839,1360572275,0,3,1436
14,1670,950,1360572275,1360589017,0,3,16742
14,1670,524,1360589017,1360589077,0,3,60
14,1671,20,1360717850,1360717910,0,1,60
14,1672,944,1360742799,1360744445,0,4,1646
14,1672,237,1360744445,1360744517,0,4,72
14,1672,950,1360744517,1360761822,0,4,17305
14,1672,613,1360761822,1360761882,0,4,60
15,1673,20,1360815579,1360825637,0,4,10058
15,1673,950,1360825637,1360825687,0,4,50
15,1673,524,1360825687,1360825721,0,4,34
15,1673,16,1360825721,1360825781,0,4,60
15,1674,920,1333552523,1333552583,0,1,60
15,1675,977,1334027764,1334027824,0,1,60
15,1676,978,1334071733,1334071793,0,1,60
15,1677,979,1334212215,1334212275,0,1,60
15,1678,980,1334307305,1334307365,0,1,60
15,1679,978,1334673554,1334673614,0,1,60
15,1680,981,1334822520,1334822580,0,1,60
15,1681,982,1334930667,1334931372,0,4,705
15,1681,983,1334931372,1334932368,0,4,996
15,1681,984,1334932368,1334932856,0,4,488
15,1681,985,1334932856,1334932916,0,4,60
15,1682,921,1335144499,1335149056,0,2,4557
15,1682,422,1335149056,1335149116,0,2,60
15,1683,986,1335596498,1335596558,0,1,60
15,1684,987,1335675710,1335675770,0,1,60
15,1685,988,1335912784,1335929181,0,2,16397
15,1685,977,1335929181,1335929241,0,2,60
15,1686,989,1336097147,1336097207,0,1,60
15,1687,990,1336545244,1336545304,0,1,60
15,1688,15,1336698887,1336705393,0,4,6506
15,1688,991,1336705393,1336705393,0,4,0
15,1688,991,1336705393,1336716482,0,4,11089
15,1688,520,1336716482,1336716542,0,4,60
15,1689,992,1336790640,1336790700,0,1,60
15,1690,993,1336965211,1336971293,0,2,6082
15,1690,994,1336971293,1336971353,0,2,60
15,1691,979,1337137975,1337138035,0,1,60
15,1692,978,1337181100,1337181160,0,1,60
15,1693,995,1337216133,1337216193,0,1,60
15,1694,992,1337395086,1337405960,0,2,10874
15,1694,996,1337405960,1337406020,0,2,60
15,1695,997,1337826217,1337826277,0,1,60
15,1696,86,1337854464,1337854524,0,1,60
15,1697,998,1338082155,1338083083,0,2,928
15,1697,999,1338083083,1338083143,0,2,60
15,1698,1000,1338183968,1338184028,0,1,60
15,1699,1001,1338260743,1338260803,0,1,60
15,1700,1002,1338349106,1338349166,0,1,60
15,1701,1003,1339037823,1339037883,0,1,60
15,1702,23,1339631023,1339646398,0,2,15375
15,1702,1004,1339646398,1339646458,0,2,60
15,1703,1005,1339669134,1339670329,0,2,1195
15,1703,1006,1339670329,1339670389,0,2,60
15,1704,1007,1339993089,1339993149,0,1,60
15,1705,263,1340015261,1340015321,0,1,60
15,1706,1008,1340757916,1340757976,0,1,60
15,1707,1009,1342064775,1342064835,0,1,60
15,1708,1010,1342097953,1342098013,0,1,60
15,1709,1011,1342172403,1342172959,0,5,556
15,1709,1012,1342172959,1342174212,0,5,1253
15,1709,1013,1342174212,1342174770,0,5,558
15,1709,985,1342174770,1342175042,0,5,272
15,1709,1014,1342175042,1342175102,0,5,60
15,1710,1015,1344608149,1344608209,0,1,60
15,1711,1015,1344678990,1344679050,0,1,60
15,1712,1015,1344769744,1344769804,0,1,60
15,1713,263,1347531238,1347531298,0,1,60
15,1714,1016,1347625347,1347625407,0,1,60
15,1715,1017,1347679947,1347680007,0,1,60
15,1716,1018,1347757281,1347757341,0,2,60
15,1716,1018,1347757341,1347757401,0,2,60
15,1717,100,1350030113,1350030173,0,1,60
15,1718,979,1351226966,1351227026,0,1,60
15,1719,1019,1351253578,1351253638,0,1,60
15,1720,1020,1351414922,1351414998,0,2,76
15,1720,1021,1351414998,1351415058,0,2,60
15,1721,1022,1351482987,1351483047,0,1,60
15,1722,1023,1352123272,1352126171,0,2,2899
15,1722,1024,1352126171,1352126231,0,2,60
15,1723,1025,1352601258,1352601318,0,1,60
15,1724,1026,1352767907,1352767967,0,1,60
15,1725,1027,1353218435,1353218495,0,1,60
15,1726,1028,1353718530,1353735491,0,3,16961
15,1726,1029,1353735491,1353736318,0,3,827
15,1726,1030,1353736318,1353736378,0,3,60
15,1727,1031,1354592346,1354592406,0,1,60
15,1728,1032,1354766260,1354766320,0,1,60
15,1729,1033,1355292816,1355292876,0,1,60
15,1730,1034,1355496242,1355496302,0,1,60
15,1731,1035,1355641467,1355641527,0,1,60
15,1732,1036,1355723730,1355723790,0,1,60
15,1733,1037,1355873083,1355880389,0,2,7306
15,1733,1038,1355880389,1355880449,0,2,60
15,1734,1039,1357790601,1357790661,0,1,60
15,1735,1040,1358351671,1358351731,0,1,60
15,1736,1041,1358505097,1358505157,0,1,60
15,1737,977,1358825830,1358825890,0,1,60
15,1738,1042,1359091964,1359107298,0,15,15334
15,1738,1043,1359107298,1359107557,0,15,259
15,1738,1044,1359107557,1359108074,0,15,517
15,1738,984,1359108074,1359108262,0,15,188
15,1738,1045,1359108262,1359108883,0,15,621
15,1738,1046,1359108883,1359109098,0,15,215
15,1738,1047,1359109098,1359109814,0,15,716
15,1738,1048,1359109814,1359110077,0,15,263
15,1738,1049,1359110077,1359110545,0,15,468
15,1738,1050,1359110545,1359111258,0,15,713
15,1738,1051,1359111258,1359112556,0,15,1298
15,1738,1027,1359112556,1359112615,0,15,59
15,1738,1052,1359112615,1359112951,0,15,336
15,1738,1053,1359112951,1359113140,0,15,189
15,1738,1054,1359113140,1359113200,0,15,60
15,1739,1055,1359353833,1359353893,0,1,60
15,1740,21,1359595713,1359595773,0,1,60
15,1741,260,1359634715,1359634775,0,1,60
15,1742,1056,1359857390,1359857450,0,1,60
15,1743,50,1360076346,1360076406,0,1,60
15,1744,1041,1360147561,1360147621,0,1,60
15,1745,1057,1360328506,1360328566,0,1,60
16,1746,979,1360814003,1360814063,0,1,60
16,1747,1058,1334114959,1334119439,0,7,4480
16,1747,1059,1334119439,1334126432,0,7,6993
16,1747,1060,1334126432,1334130908,0,7,4476
16,1747,253,1334130908,1334132402,0,7,1494
16,1747,1061,1334132402,1334132524,0,7,122
16,1747,1062,1334132524,1334136011,0,7,3487
16,1747,1063,1334136011,1334136071,0,7,60
16,1748,1063,1334209113,1334209173,0,1,60
16,1749,1064,1334288449,1334293959,0,2,5510
16,1749,1065,1334293959,1334294019,0,2,60
16,1750,1063,1334464802,1334464862,0,1,60
16,1751,1066,1334928223,1334928283,0,1,60
16,1752,1061,1334994769,1334999149,0,2,4380
16,1752,1067,1334999149,1334999209,0,2,60
16,1753,585,1335019137,1335019197,0,1,60
16,1754,1061,1335071287,1335072288,0,6,1001
16,1754,585,1335072288,1335077474,0,6,5186
16,1754,1068,1335077474,1335081350,0,6,3876
16,1754,35,1335081350,1335081524,0,6,174
16,1754,601,1335081524,1335092221,0,6,10697
16,1754,640,1335092221,1335092281,0,6,60
16,1755,50,1335173407,1335176685,0,6,3278
16,1755,1067,1335176685,1335176907,0,6,222
16,1755,575,1335176907,1335178866,0,6,1959
16,1755,835,1335178866,1335182173,0,6,3307
16,1755,1069,1335182173,1335183190,0,6,1017
16,1755,585,1335183190,1335183250,0,6,60
16,1756,1070,1335350692,1335353556,0,2,2864
16,1756,35,1335353556,1335353616,0,2,60
16,1757,1071,1335693087,1335694332,0,4,1245
16,1757,1072,1335694332,1335694332,0,4,0
16,1757,1072,1335694332,1335698571,0,4,4239
16,1757,585,1335698571,1335698631,0,4,60
16,1758,1063,1335930421,1335930468,0,2,47
16,1758,1073,1335930468,1335930528,0,2,60
16,1759,1074,1336097759,1336100441,0,7,2682
16,1759,1075,1336100441,1336100967,0,7,526
16,1759,35,1336100967,1336101266,0,7,299
16,1759,253,1336101266,1336101862,0,7,596
16,1759,1070,1336101862,1336106269,0,7,4407
16,1759,1076,1336106269,1336112062,0,7,5793
16,1759,1077,1336112062,1336112122,0,7,60
16,1760,1078,1336207183,1336207243,0,1,60
16,1761,1062,1336390943,1336390992,0,3,49
16,1761,1079,1336390992,1336391954,0,3,962
16,1761,1080,1336391954,1336392014,0,3,60
16,1762,1081,1336552385,1336552445,0,1,60
16,1763,640,1336894723,1336904363,0,2,9640
16,1763,1082,1336904363,1336904423,0,2,60
16,1764,983,1336981727,1336981818,0,5,91
16,1764,1083,1336981818,1336981949,0,5,131
16,1764,1084,1336981949,1336992018,0,5,10069
16,1764,1085,1336992018,1336996100,0,5,4082
16,1764,585,1336996100,1336996160,0,5,60
16,1765,1086,1337147517,1337147577,0,1,60
16,1766,1087,1337831332,1337831392,0,1,60
16,1767,1088,1337936635,1337936695,0,1,60
16,1768,253,1338268069,1338268129,0,1,60
16,1769,791,1338289896,1338289956,0,1,60
16,1770,1061,1338541977,1338545957,0,2,3980
16,1770,791,1338545957,1338546017,0,2,60
16,1771,1089,1338875452,1338875512,0,1,60
16,1772,231,1339043438,1339062776,0,2,19338
16,1772,1090,1339062776,1339062836,0,2,60
16,1773,1061,1339306572,1339306632,0,1,60
16,1774,1091,1339921946,1339934663,0,2,12717
16,1774,1092,1339934663,1339934723,0,2,60
16,1775,1093,1341484271,1341484331,0,1,60
16,1776,1094,1342081902,1342081962,0,1,60
16,1777,1095,1342174992,1342183123,0,2,8131
16,1777,1096,1342183123,1342183183,0,2,60
16,1778,640,1342255652,1342255712,0,1,60
16,1779,1097,1343550268,1343550456,0,4,188
16,1779,1098,1343550456,1343561950,0,4,11494
16,1779,1098,1343561950,1343564264,0,4,2314
16,1779,640,1343564264,1343564324,0,4,60
16,1780,1099,1344649040,1344649100,0,1,60
16,1781,1090,1344762404,1344762464,0,1,60
16,1782,1100,1344829400,1344829460,0,1,60
16,1783,1101,1347695275,1347695335,0,1,60
16,1784,1102,1350023372,1350031860,0,2,8488
16,1784,1103,1350031860,1350031920,0,2,60
16,1785,791,1350989613,1350989690,0,2,77
16,1785,1104,1350989690,1350989750,0,2,60
16,1786,1087,1351148686,1351155425,0,3,6739
16,1786,1076,1351155425,1351158183,0,3,2758
16,1786,1105,1351158183,1351158243,0,3,60
16,1787,403,1351231120,1351231787,0,5,667
16,1787,1106,1351231787,1351242634,0,5,10847
16,1787,1107,1351242634,1351244151,0,5,1517
16,1787,835,1351244151,1351244245,0,5,94
16,1787,791,1351244245,1351244305,0,5,60
16,1788,400,1351330445,1351332265,0,2,1820
16,1788,253,1351332265,1351332325,0,2,60
16,1789,791,1351415690,1351420471,0,2,4781
16,1789,1108,1351420471,1351420531,0,2,60
16,1790,1109,1351494418,1351495841,0,2,1423
16,1790,1110,1351495841,1351495901,0,2,60
16,1791,1111,1351671722,1351671782,0,1,60
16,1792,1112,1351763532,1351763763,0,2,231
16,1792,1113,1351763763,1351763823,0,2,60
16,1793,640,1351845119,1351845402,0,2,283
16,1793,1111,1351845402,1351845462,0,2,60
16,1794,1107,1352265698,1352265758,0,1,60
16,1795,1089,1352615935,1352615995,0,1,60
16,1796,23,1352703462,1352703522,0,1,60
16,1797,1114,1353054114,1353056931,0,2,2817
16,1797,35,1353056931,1353056991,0,2,60
16,1798,1115,1353131734,1353131794,0,1,60
16,1799,35,1353445101,1353445161,0,1,60
16,1800,1116,1353576533,1353576593,0,1,60
16,1801,791,1353639144,1353639204,0,1,60
16,1802,1117,1354782888,1354785510,0,3,2622
16,1802,1112,1354785510,1354786846,0,3,1336
16,1802,1113,1354786846,1354786906,0,3,60
16,1803,1118,1354868468,1354868528,0,1,60
16,1804,35,1354954913,1354958032,0,2,3119
16,1804,1119,1354958032,1354958092,0,2,60
16,1805,1113,1355392484,1355411076,0,2,18592
16,1805,640,1355411076,1355411136,0,2,60
16,1806,35,1355561521,1355561581,0,1,60
16,1807,1076,1355645065,1355645114,0,2,49
16,1807,253,1355645114,1355645174,0,2,60
16,1808,603,1355730543,1355730603,0,1,60
16,1809,1120,1356689963,1356690023,0,1,60
16,1810,1121,1356772435,1356772495,0,1,60
16,1811,35,1356845937,1356845997,0,1,60
16,1812,1122,1357018577,1357018637,0,1,60
16,1813,35,1357099925,1357099985,0,1,60
16,1814,1076,1357192066,1357192126,0,1,60
16,1815,1123,1357458379,1357458439,0,1,60
16,1816,1124,1357896724,1357896784,0,1,60
16,1817,1124,1358758253,1358758313,0,1,60
16,1818,791,1359021463,1359021523,0,1,60
16,1819,1125,1359255905,1359261980,0,2,6075
16,1819,1126,1359261980,1359262040,0,2,60
16,1820,1127,1359280033,1359280093,0,1,60
16,1821,1128,1359364893,1359364953,0,1,60
16,1822,601,1359709422,1359709482,0,1,60
16,1823,791,1360060229,1360060289,0,1,60
16,1824,1129,1360565074,1360565134,0,1,60
17,1825,1130,1360661346,1360661406,0,1,60
17,1826,1131,1333509777,1333509837,0,1,60
17,1827,1132,1333546709,1333546769,0,1,60
17,1828,651,1333875484,1333881796,0,2,6312
17,1828,538,1333881796,1333881856,0,2,60
17,1829,1133,1333928713,1333928773,0,1,60
17,1830,1134,1334028623,1334048914,0,5,20291
17,1830,1135,1334048914,1334049575,0,5,661
17,1830,1006,1334049575,1334049663,0,5,88
17,1830,1136,1334049663,1334049795,0,5,132
17,1830,1137,1334049795,1334049855,0,5,60
17,1831,1138,1334055271,1334065030,0,3,9759
17,1831,1139,1334065030,1334065137,0,3,107
17,1831,1140,1334065137,1334065197,0,3,60
17,1832,261,1334187497,1334200677,0,2,13180
17,1832,1141,1334200677,1334200737,0,2,60
17,1833,1142,1334289994,1334290054,0,1,60
17,1834,1143,1334317512,1334317832,0,5,320
17,1834,8,1334317832,1334328213,0,5,10381
17,1834,538,1334328213,1334328436,0,5,223
17,1834,1144,1334328436,1334328436,0,5,0
17,1834,1144,1334328436,1334328496,0,5,60
17,1835,449,1334451115,1334451229,0,7,114
17,1835,451,1334451229,1334451321,0,7,92
17,1835,452,1334451321,1334462346,0,7,11025
17,1835,451,1334462346,1334462590,0,7,244
17,1835,1145,1334462590,1334464422,0,7,1832
17,1835,1146,1334464422,1334465717,0,7,1295
17,1835,1147,1334465717,1334465777,0,7,60
17,1836,1148,1334571433,1334571493,0,1,60
17,1837,1149,1334656715,1334656775,0,1,60
17,1838,1144,1334790399,1334806301,0,3,15902
17,1838,1150,1334806301,1334808749,0,3,2448
17,1838,1151,1334808749,1334808809,0,3,60
17,1839,1152,1334831552,1334831612,0,1,60
17,1840,1153,1334918593,1334919743,0,3,1150
17,1840,1154,1334919743,1334920218,0,3,475
17,1840,1155,1334920218,1334920278,0,3,60
17,1841,1146,1335098914,1335099774,0,2,860
17,1841,1156,1335099774,1335099834,0,2,60
17,1842,1155,1335436647,1335439510,0,2,2863
17,1842,1144,1335439510,1335439570,0,2,60
17,1843,1157,1335592795,1335593037,0,4,242
17,1843,86,1335593037,1335593756,0,4,719
17,1843,1158,1335593756,1335594574,0,4,818
17,1843,1159,1335594574,1335594634,0,4,60
17,1844,1144,1335912601,1335912772,0,12,171
17,1844,1160,1335912772,1335912872,0,12,100
17,1844,1161,1335912872,1335913030,0,12,158
17,1844,1162,1335913030,1335913704,0,12,674
17,1844,1163,1335913704,1335914959,0,12,1255
17,1844,1155,1335914959,1335915412,0,12,453
17,1844,1154,1335915412,1335915732,0,12,320
17,1844,1164,1335915732,1335915932,0,12,200
17,1844,1165,1335915932,1335915956,0,12,24
17,1844,1166,1335915956,1335916291,0,12,335
17,1844,1167,1335916291,1335929748,0,12,13457
17,1844,1167,1335929748,1335929808,0,12,60
17,1845,1154,1335953669,1335954180,0,5,511
17,1845,1155,1335954180,1335955060,0,5,880
17,1845,292,1335955060,1335955242,0,5,182
17,1845,1163,1335955242,1335958545,0,5,3303
17,1845,1168,1335958545,1335958605,0,5,60
17,1846,1159,1336108035,1336109779,0,5,1744
17,1846,1169,1336109779,1336116391,0,5,6612
17,1846,1170,1336116391,1336119778,0,5,3387
17,1846,1171,1336119778,1336121095,0,5,1317
17,1846,1172,1336121095,1336121155,0,5,60
17,1847,1144,1336344689,1336346315,0,6,1626
17,1847,1173,1336346315,1336346413,0,6,98
17,1847,1163,1336346413,1336346737,0,6,324
17,1847,292,1336346737,1336360110,0,6,13373
17,1847,1174,1336360110,1336360661,0,6,551
17,1847,1167,1336360661,1336360721,0,6,60
17,1848,1175,1336384915,1336385106,0,6,191
17,1848,1176,1336385106,1336385566,0,6,460
17,1848,1163,1336385566,1336387134,0,6,1568
17,1848,1144,1336387134,1336387529,0,6,395
17,1848,1177,1336387529,1336388175,0,6,646
17,1848,1147,1336388175,1336388235,0,6,60
17,1849,1155,1336473184,1336474216,0,5,1032
17,1849,314,1336474216,1336474359,0,5,143
17,1849,1163,1336474359,1336476146,0,5,1787
17,1849,1158,1336476146,1336477156,0,5,1010
17,1849,1178,1336477156,1336477216,0,5,60
17,1850,1158,1336517582,1336519167,0,8,1585
17,1850,1163,1336519167,1336519307,0,8,140
17,1850,292,1336519307,1336519485,0,8,178
17,1850,1176,1336519485,1336520265,0,8,780
17,1850,35,1336520265,1336520720,0,8,455
17,1850,1154,1336520720,1336521292,0,8,572
17,1850,1179,1336521292,1336533592,0,8,12300
17,1850,1167,1336533592,1336533652,0,8,60
17,1851,1155,1336558497,1336559794,0,3,1297
17,1851,314,1336559794,1336560155,0,3,361
17,1851,1163,1336560155,1336560215,0,3,60
17,1852,1158,1336603260,1336604221,0,5,961
17,1852,1180,1336604221,1336604560,0,5,339
17,1852,1163,1336604560,1336604823,0,5,263
17,1852,292,1336604823,1336606282,0,5,1459
17,1852,1154,1336606282,1336606342,0,5,60
17,1853,1160,1336690017,1336690215,0,8,198
17,1853,1162,1336690215,1336690961,0,8,746
17,1853,1180,1336690961,1336691065,0,8,104
17,1853,1173,1336691065,1336691245,0,8,180
17,1853,1163,1336691245,1336692740,0,8,1495
17,1853,1154,1336692740,1336705625,0,8,12885
17,1853,1181,1336705625,1336706163,0,8,538
17,1853,1167,1336706163,1336706223,0,8,60
17,1854,86,1336795204,1336796382,0,7,1178
17,1854,651,1336796382,1336809412,0,7,13030
17,1854,86,1336809412,1336809580,0,7,168
17,1854,1182,1336809580,1336809673,0,7,93
17,1854,538,1336809673,1336809966,0,7,293
17,1854,1144,1336809966,1336810391,0,7,425
17,1854,1147,1336810391,1336810451,0,7,60
17,1855,86,1336976817,1336976839,0,13,22
17,1855,1183,1336976839,1336976861,0,13,22
17,1855,86,1336976861,1336978955,0,13,2094
17,1855,1184,1336978955,1336979979,0,13,1024
17,1855,1185,1336979979,1336981224,0,13,1245
17,1855,1186,1336981224,1336982397,0,13,1173
17,1855,1187,1336982397,1336982543,0,13,146
17,1855,1188,1336982543,1336982593,0,13,50
17,1855,1189,1336982593,1336984194,0,13,1601
17,1855,1190,1336984194,1336984720,0,13,526
17,1855,1183,1336984720,1336989206,0,13,4486
17,1855,1191,1336989206,1336992471,0,13,3265
17,1855,1192,1336992471,1336992531,0,13,60
17,1856,1193,1336998977,1336999037,0,1,60
17,1857,1194,1337035355,1337035709,0,9,354
17,1857,1195,1337035709,1337036221,0,9,512
17,1857,1196,1337036221,1337036438,0,9,217
17,1857,1197,1337036438,1337036573,0,9,135
17,1857,1198,1337036573,1337036669,0,9,96
17,1857,1199,1337036669,1337037103,0,9,434
17,1857,1200,1337037103,1337037148,0,9,45
17,1857,292,1337037148,1337051450,0,9,14302
17,1857,1167,1337051450,1337051510,0,9,60
17,1858,1154,1337076085,1337076442,0,4,357
17,1858,1155,1337076442,1337077772,0,4,1330
17,1858,292,1337077772,1337077887,0,4,115
17,1858,1163,1337077887,1337077947,0,4,60
17,1859,1194,1337121594,1337123314,0,11,1720
17,1859,1200,1337123314,1337125073,0,11,1759
17,1859,1154,1337125073,1337125284,0,11,211
17,1859,1165,1337125284,1337125333,0,11,49
17,1859,1201,1337125333,1337125369,0,11,36
17,1859,1165,1337125369,1337125394,0,11,25
17,1859,1179,1337125394,1337125418,0,11,24
17,1859,1202,1337125418,1337125740,0,11,322
17,1859,1179,1337125740,1337137779,0,11,12039
17,1859,1181,1337137779,1337138470,0,11,691
17,1859,1167,1337138470,1337138530,0,11,60
17,1860,1202,1337161795,1337161904,0,8,109
17,1860,1164,1337161904,1337161923,0,8,19
17,1860,1154,1337161923,1337162520,0,8,597
17,1860,1203,1337162520,1337163608,0,8,1088
17,1860,292,1337163608,1337163779,0,8,171
17,1860,1163,1337163779,1337164744,0,8,965
17,1860,1162,1337164744,1337165453,0,8,709
17,1860,1144,1337165453,1337165513,0,8,60
17,1861,1194,1337208445,1337209990,0,10,1545
17,1861,1204,1337209990,1337210095,0,10,105
17,1861,1200,1337210095,1337210125,0,10,30
17,1861,292,1337210125,1337210431,0,10,306
17,1861,1176,1337210431,1337211469,0,10,1038
17,1861,1154,1337211469,1337211663,0,10,194
17,1861,1154,1337211663,1337211978,0,10,315
17,1861,1205,1337211978,1337224011,0,10,12033
17,1861,1181,1337224011,1337224393,0,10,382
17,1861,1167,1337224393,1337224453,0,10,60
17,1862,1202,1337248201,1337248329,0,4,128
17,1862,1164,1337248329,1337248349,0,4,20
17,1862,1154,1337248349,1337248920,0,4,571
17,1862,1203,1337248920,1337248980,0,4,60
17,1863,1206,1337294973,1337296276,0,4,1303
17,1863,1200,1337296276,1337296303,0,4,27
17,1863,292,1337296303,1337296760,0,4,457
17,1863,1194,1337296760,1337296820,0,4,60
17,1864,290,1337345850,1337346718,0,2,868
17,1864,1203,1337346718,1337346778,0,2,60
17,1865,1205,1337592711,1337593173,0,6,462
17,1865,1154,1337593173,1337593642,0,6,469
17,1865,1203,1337593642,1337594622,0,6,980
17,1865,314,1337594622,1337594796,0,6,174
17,1865,1163,1337594796,1337596405,0,6,1609
17,1865,1207,1337596405,1337596465,0,6,60
17,1866,1194,1337640697,1337640833,0,7,136
17,1866,1208,1337640833,1337642139,0,7,1306
17,1866,1204,1337642139,1337642305,0,7,166
17,1866,1200,1337642305,1337643015,0,7,710
17,1866,1209,1337643015,1337643761,0,7,746
17,1866,817,1337643761,1337644256,0,7,495
17,1866,1205,1337644256,1337644316,0,7,60
17,1867,1203,1337681754,1337681847,0,6,93
17,1867,1210,1337681847,1337682615,0,6,768
17,1867,292,1337682615,1337682739,0,6,124
17,1867,1163,1337682739,1337684065,0,6,1326
17,1867,1158,1337684065,1337684648,0,6,583
17,1867,1211,1337684648,1337684708,0,6,60
17,1868,1144,1337817051,1337817481,0,11,430
17,1868,1160,1337817481,1337818513,0,11,1032
17,1868,1163,1337818513,1337819477,0,11,964
17,1868,1203,1337819477,1337820045,0,11,568
17,1868,1154,1337820045,1337820107,0,11,62
17,1868,1202,1337820107,1337820197,0,11,90
17,1868,1165,1337820197,1337820426,0,11,229
17,1868,1212,1337820426,1337820465,0,11,39
17,1868,1213,1337820465,1337820592,0,11,127
17,1868,1179,1337820592,1337829106,0,11,8514
17,1868,1212,1337829106,1337829166,0,11,60
17,1869,1167,1337853855,1337854221,0,2,366
17,1869,1165,1337854221,1337854281,0,2,60
17,1870,651,1337943661,1337944692,0,2,1031
17,1870,538,1337944692,1337944752,0,2,60
17,1871,1183,1338002555,1338003260,0,6,705
17,1871,1191,1338003260,1338007700,0,6,4440
17,1871,1150,1338007700,1338019548,0,6,11848
17,1871,1146,1338019548,1338020789,0,6,1241
17,1871,1147,1338020789,1338021248,0,6,459
17,1871,1159,1338021248,1338021308,0,6,60
17,1872,1194,1338158916,1338159740,0,8,824
17,1872,1214,1338159740,1338161628,0,8,1888
17,1872,1203,1338161628,1338162147,0,8,519
17,1872,1154,1338162147,1338162382,0,8,235
17,1872,1205,1338162382,1338162722,0,8,340
17,1872,1179,1338162722,1338174622,0,8,11900
17,1872,1212,1338174622,1338175432,0,8,810
17,1872,1167,1338175432,1338175492,0,8,60
17,1873,1164,1338196906,1338196939,0,5,33
17,1873,1154,1338196939,1338197542,0,5,603
17,1873,1203,1338197542,1338198470,0,5,928
17,1873,292,1338198470,1338198644,0,5,174
17,1873,1163,1338198644,1338198704,0,5,60
17,1874,1194,1338245106,1338246824,0,10,1718
17,1874,1204,1338246824,1338246963,0,10,139
17,1874,1200,1338246963,1338247006,0,10,43
17,1874,292,1338247006,1338247974,0,10,968
17,1874,1203,1338247974,1338248323,0,10,349
17,1874,817,1338248323,1338248783,0,10,460
17,1874,1154,1338248783,1338249184,0,10,401
17,1874,1213,1338249184,1338249278,0,10,94
17,1874,1179,1338249278,1338261186,0,10,11908
17,1874,1212,1338261186,1338261246,0,10,60
17,1875,1179,1338287417,1338287821,0,12,404
17,1875,1165,1338287821,1338287907,0,12,86
17,1875,1205,1338287907,1338288382,0,12,475
17,1875,1153,1338288382,1338289099,0,12,717
17,1875,1164,1338289099,1338289138,0,12,39
17,1875,1154,1338289138,1338289673,0,12,535
17,1875,1203,1338289673,1338289937,0,12,264
17,1875,1210,1338289937,1338290490,0,12,553
17,1875,292,1338290490,1338290661,0,12,171
17,1875,1163,1338290661,1338292308,0,12,1647
17,1875,1211,1338292308,1338293841,0,12,1533
17,1875,1215,1338293841,1338293901,0,12,60
17,1876,1194,1338331871,1338332277,0,4,406
17,1876,1206,1338332277,1338333149,0,4,872
17,1876,1198,1338333149,1338334842,0,4,1693
17,1876,817,1338334842,1338334902,0,4,60
17,1877,1154,1338545685,1338546479,0,3,794
17,1877,1203,1338546479,1338550443,0,3,3964
17,1877,1216,1338550443,1338550503,0,3,60
17,1878,1194,1338763959,1338764591,0,18,632
17,1878,1217,1338764591,1338765191,0,18,600
17,1878,1196,1338765191,1338765263,0,18,72
17,1878,1197,1338765263,1338765432,0,18,169
17,1878,1198,1338765432,1338765714,0,18,282
17,1878,1204,1338765714,1338765917,0,18,203
17,1878,1200,1338765917,1338766007,0,18,90
17,1878,292,1338766007,1338766576,0,18,569
17,1878,1218,1338766576,1338767500,0,18,924
17,1878,1164,1338767500,1338767612,0,18,112
17,1878,1202,1338767612,1338767691,0,18,79
17,1878,1205,1338767691,1338767753,0,18,62
17,1878,1201,1338767753,1338767907,0,18,154
17,1878,1212,1338767907,1338767917,0,18,10
17,1878,1213,1338767917,1338768005,0,18,88
17,1878,1179,1338768005,1338780396,0,18,12391
17,1878,1219,1338780396,1338782954,0,18,2558
17,1878,1167,1338782954,1338783014,0,18,60
17,1879,1205,1338802712,1338802912,0,12,200
17,1879,1154,1338802912,1338804574,0,12,1662
17,1879,1203,1338804574,1338805551,0,12,977
17,1879,292,1338805551,1338806280,0,12,729
17,1879,1180,1338806280,1338806672,0,12,392
17,1879,1220,1338806672,1338806733,0,12,61
17,1879,1221,1338806733,1338806816,0,12,83
17,1879,1162,1338806816,1338806992,0,12,176
17,1879,1161,1338806992,1338807075,0,12,83
17,1879,1160,1338807075,1338807180,0,12,105
17,1879,1158,1338807180,1338807305,0,12,125
17,1879,1144,1338807305,1338807365,0,12,60
17,1880,1194,1338850389,1338850783,0,18,394
17,1880,1195,1338850783,1338851102,0,18,319
17,1880,1196,1338851102,1338851470,0,18,368
17,1880,1198,1338851470,1338851597,0,18,127
17,1880,1199,1338851597,1338851798,0,18,201
17,1880,1204,1338851798,1338852048,0,18,250
17,1880,1200,1338852048,1338852079,0,18,31
17,1880,292,1338852079,1338852420,0,18,341
17,1880,1222,1338852420,1338852698,0,18,278
17,1880,601,1338852698,1338852837,0,18,139
17,1880,1210,1338852837,1338852931,0,18,94
17,1880,1203,1338852931,1338853771,0,18,840
17,1880,1154,1338853771,1338854144,0,18,373
17,1880,1205,1338854144,1338854243,0,18,99
17,1880,1201,1338854243,1338854506,0,18,263
17,1880,1179,1338854506,1338866156,0,18,11650
17,1880,1212,1338866156,1338866606,0,18,450
17,1880,1167,1338866606,1338866666,0,18,60
17,1881,1223,1338891311,1338892310,0,8,999
17,1881,1224,1338892310,1338894130,0,8,1820
17,1881,1203,1338894130,1338894828,0,8,698
17,1881,1222,1338894828,1338895079,0,8,251
17,1881,292,1338895079,1338896066,0,8,987
17,1881,1221,1338896066,1338896299,0,8,233
17,1881,1161,1338896299,1338897303,0,8,1004
17,1881,1147,1338897303,1338897363,0,8,60
17,1882,1154,1338976088,1338976325,0,10,237
17,1882,817,1338976325,1338976765,0,10,440
17,1882,1203,1338976765,1338976931,0,10,166
17,1882,601,1338976931,1338977581,0,10,650
17,1882,292,1338977581,1338977699,0,10,118
17,1882,1163,1338977699,1338978452,0,10,753
17,1882,1220,1338978452,1338978988,0,10,536
17,1882,1158,1338978988,1338979051,0,10,63
17,1882,1144,1338979051,1338979544,0,10,493
17,1882,1225,1338979544,1338979604,0,10,60
17,1883,1194,1339023462,1339023631,0,15,169
17,1883,1206,1339023631,1339023796,0,15,165
17,1883,1195,1339023796,1339023937,0,15,141
17,1883,1214,1339023937,1339024449,0,15,512
17,1883,1197,1339024449,1339024793,0,15,344
17,1883,1199,1339024793,1339024972,0,15,179
17,1883,1204,1339024972,1339025125,0,15,153
17,1883,1200,1339025125,1339025168,0,15,43
17,1883,292,1339025168,1339026240,0,15,1072
17,1883,1203,1339026240,1339026723,0,15,483
17,1883,1154,1339026723,1339026819,0,15,96
17,1883,1202,1339026819,1339026871,0,15,52
17,1883,1205,1339026871,1339026981,0,15,110
17,1883,1201,1339026981,1339027186,0,15,205
17,1883,1179,1339027186,1339027246,0,15,60
17,1884,1203,1339064122,1339064492,0,7,370
17,1884,1218,1339064492,1339064936,0,7,444
17,1884,292,1339064936,1339065173,0,7,237
17,1884,1163,1339065173,1339065703,0,7,530
17,1884,1226,1339065703,1339067216,0,7,1513
17,1884,1227,1339067216,1339067697,0,7,481
17,1884,1159,1339067697,1339067757,0,7,60
17,1885,1194,1339108997,1339109444,0,11,447
17,1885,1195,1339109444,1339110142,0,11,698
17,1885,1198,1339110142,1339111247,0,11,1105
17,1885,601,1339111247,1339111492,0,11,245
17,1885,1203,1339111492,1339112410,0,11,918
17,1885,1205,1339112410,1339112495,0,11,85
17,1885,1201,1339112495,1339112534,0,11,39
17,1885,1228,1339112534,1339112653,0,11,119
17,1885,1229,1339112653,1339112666,0,11,13
17,1885,1212,1339112666,1339112824,0,11,158
17,1885,1179,1339112824,1339112884,0,11,60
17,1886,1176,1339159479,1339159973,0,7,494
17,1886,292,1339159973,1339159992,0,7,19
17,1886,1163,1339159992,1339160455,0,7,463
17,1886,1180,1339160455,1339161209,0,7,754
17,1886,1161,1339161209,1339161254,0,7,45
17,1886,1160,1339161254,1339161508,0,7,254
17,1886,1144,1339161508,1339161568,0,7,60
17,1887,538,1339204563,1339209507,0,3,4944
17,1887,1144,1339209507,1339211671,0,3,2164
17,1887,1147,1339211671,1339211731,0,3,60
17,1888,1208,1339368538,1339368590,0,9,52
17,1888,1206,1339368590,1339369899,0,9,1309
17,1888,1200,1339369899,1339370992,0,9,1093
17,1888,1203,1339370992,1339371555,0,9,563
17,1888,1154,1339371555,1339371789,0,9,234
17,1888,1205,1339371789,1339371911,0,9,122
17,1888,1201,1339371911,1339372059,0,9,148
17,1888,1212,1339372059,1339372200,0,9,141
17,1888,1179,1339372200,1339372260,0,9,60
17,1889,1154,1339407120,1339407933,0,16,813
17,1889,601,1339407933,1339408086,0,16,153
17,1889,1218,1339408086,1339408194,0,16,108
17,1889,100,1339408194,1339408344,0,16,150
17,1889,1176,1339408344,1339408669,0,16,325
17,1889,292,1339408669,1339408818,0,16,149
17,1889,1163,1339408818,1339409034,0,16,216
17,1889,1163,1339409034,1339409395,0,16,361
17,1889,1180,1339409395,1339410126,0,16,731
17,1889,1160,1339410126,1339410248,0,16,122
17,1889,1158,1339410248,1339410339,0,16,91
17,1889,1144,1339410339,1339410517,0,16,178
17,1889,1230,1339410517,1339411426,0,16,909
17,1889,1230,1339411426,1339413256,0,16,1830
17,1889,1231,1339413256,1339413675,0,16,419
17,1889,1159,1339413675,1339413735,0,16,60
17,1890,1194,1339454966,1339455349,0,19,383
17,1890,1232,1339455349,1339455475,0,19,126
17,1890,1217,1339455475,1339455536,0,19,61
17,1890,1214,1339455536,1339455763,0,19,227
17,1890,1196,1339455763,1339455842,0,19,79
17,1890,1197,1339455842,1339456028,0,19,186
17,1890,1198,1339456028,1339456361,0,19,333
17,1890,1204,1339456361,1339456521,0,19,160
17,1890,1200,1339456521,1339456534,0,19,13
17,1890,292,1339456534,1339456965,0,19,431
17,1890,1222,1339456965,1339457297,0,19,332
17,1890,601,1339457297,1339457550,0,19,253
17,1890,1203,1339457550,1339457632,0,19,82
17,1890,817,1339457632,1339458715,0,19,1083
17,1890,1154,1339458715,1339459061,0,19,346
17,1890,1179,1339459061,1339459086,0,19,25
17,1890,1167,1339459086,1339470812,0,19,11726
17,1890,1212,1339470812,1339471024,0,19,212
17,1890,1167,1339471024,1339471084,0,19,60
17,1891,1154,1339493466,1339493869,0,10,403
17,1891,817,1339493869,1339494015,0,10,146
17,1891,1203,1339494015,1339494280,0,10,265
17,1891,601,1339494280,1339494457,0,10,177
17,1891,1218,1339494457,1339494771,0,10,314
17,1891,1176,1339494771,1339494864,0,10,93
17,1891,292,1339494864,1339495009,0,10,145
17,1891,1163,1339495009,1339495531,0,10,522
17,1891,1180,1339495531,1339496079,0,10,548
17,1891,1221,1339496079,1339496139,0,10,60
17,1892,1206,1339541847,1339542101,0,9,254
17,1892,1195,1339542101,1339542618,0,9,517
17,1892,1197,1339542618,1339542839,0,9,221
17,1892,1198,1339542839,1339542950,0,9,111
17,1892,1199,1339542950,1339543129,0,9,179
17,1892,1204,1339543129,1339543415,0,9,286
17,1892,292,1339543415,1339544349,0,9,934
17,1892,1203,1339544349,1339556885,0,9,12536
17,1892,1181,1339556885,1339556945,0,9,60
17,1893,1167,1339577346,1339581688,0,7,4342
17,1893,791,1339581688,1339585590,0,7,3902
17,1893,1233,1339585590,1339585763,0,7,173
17,1893,1203,1339585763,1339586317,0,7,554
17,1893,1218,1339586317,1339586785,0,7,468
17,1893,292,1339586785,1339586808,0,7,23
17,1893,1163,1339586808,1339586868,0,7,60
17,1894,1206,1339628311,1339628326,0,9,15
17,1894,1232,1339628326,1339629438,0,9,1112
17,1894,1204,1339629438,1339629614,0,9,176
17,1894,292,1339629614,1339630540,0,9,926
17,1894,1203,1339630540,1339631799,0,9,1259
17,1894,1212,1339631799,1339631898,0,9,99
17,1894,1179,1339631898,1339631927,0,9,29
17,1894,1167,1339631927,1339643321,0,9,11394
17,1894,1181,1339643321,1339643381,0,9,60
17,1895,1154,1339666769,1339667306,0,3,537
17,1895,1203,1339667306,1339670536,0,3,3230
17,1895,1144,1339670536,1339670596,0,3,60
17,1896,1200,1339975466,1339975474,0,2,8
17,1896,292,1339975474,1339975534,0,2,60
17,1897,1210,1340013553,1340014261,0,3,708
17,1897,292,1340014261,1340014626,0,3,365
17,1897,1163,1340014626,1340014686,0,3,60
17,1898,292,1340234899,1340247882,0,2,12983
17,1898,1212,1340247882,1340247942,0,2,60
17,1899,1154,1340271599,1340271659,0,1,60
17,1900,1234,1340622457,1340623423,0,8,966
17,1900,1203,1340623423,1340623432,0,8,9
17,1900,1210,1340623432,1340623565,0,8,133
17,1900,601,1340623565,1340623680,0,8,115
17,1900,1218,1340623680,1340623959,0,8,279
17,1900,1176,1340623959,1340624077,0,8,118
17,1900,292,1340624077,1340624231,0,8,154
17,1900,1163,1340624231,1340624291,0,8,60
17,1901,1194,1340751183,1340751455,0,9,272
17,1901,1232,1340751455,1340751538,0,9,83
17,1901,1195,1340751538,1340751686,0,9,148
17,1901,1217,1340751686,1340752275,0,9,589
17,1901,1198,1340752275,1340752377,0,9,102
17,1901,1199,1340752377,1340752485,0,9,108
17,1901,1204,1340752485,1340752747,0,9,262
17,1901,292,1340752747,1340754386,0,9,1639
17,1901,1154,1340754386,1340754446,0,9,60
17,1902,1235,1340795099,1340795448,0,4,349
17,1902,1235,1340795448,1340798554,0,4,3106
17,1902,1144,1340798554,1340798955,0,4,401
17,1902,1236,1340798955,1340799015,0,4,60
17,1903,1154,1341221133,1341221332,0,8,199
17,1903,817,1341221332,1341221409,0,8,77
17,1903,1203,1341221409,1341221910,0,8,501
17,1903,1218,1341221910,1341222030,0,8,120
17,1903,1222,1341222030,1341222238,0,8,208
17,1903,1176,1341222238,1341222279,0,8,41
17,1903,292,1341222279,1341222405,0,8,126
17,1903,1163,1341222405,1341222465,0,8,60
17,1904,1194,1341269680,1341271298,0,7,1618
17,1904,1200,1341271298,1341271320,0,7,22
17,1904,292,1341271320,1341272328,0,7,1008
17,1904,1203,1341272328,1341272357,0,7,29
17,1904,817,1341272357,1341272984,0,7,627
17,1904,1154,1341272984,1341285955,0,7,12971
17,1904,1212,1341285955,1341286015,0,7,60
17,1905,1237,1341312300,1341314505,0,2,2205
17,1905,1203,1341314505,1341314565,0,2,60
17,1906,1194,1341355378,1341357007,0,7,1629
17,1906,1200,1341357007,1341357027,0,7,20
17,1906,292,1341357027,1341358102,0,7,1075
17,1906,817,1341358102,1341358664,0,7,562
17,1906,1154,1341358664,1341358975,0,7,311
17,1906,1205,1341358975,1341371888,0,7,12913
17,1906,1181,1341371888,1341371948,0,7,60
17,1907,1154,1341393847,1341394306,0,5,459
17,1907,817,1341394306,1341395417,0,5,1111
17,1907,292,1341395417,1341395535,0,5,118
17,1907,1163,1341395535,1341397243,0,5,1708
17,1907,1158,1341397243,1341397303,0,5,60
17,1908,1200,1341443946,1341444965,0,6,1019
17,1908,1203,1341444965,1341445287,0,6,322
17,1908,817,1341445287,1341445592,0,6,305
17,1908,1154,1341445592,1341457708,0,6,12116
17,1908,1167,1341457708,1341458119,0,6,411
17,1908,1167,1341458119,1341458179,0,6,60
17,1909,1238,1341480098,1341480117,0,8,19
17,1909,1238,1341480117,1341480136,0,8,19
17,1909,1238,1341480136,1341481613,0,8,1477
17,1909,1154,1341481613,1341481815,0,8,202
17,1909,817,1341481815,1341481969,0,8,154
17,1909,1203,1341481969,1341483324,0,8,1355
17,1909,651,1341483324,1341492757,0,8,9433
17,1909,1144,1341492757,1341492817,0,8,60
17,1910,1239,1341534854,1341534971,0,6,117
17,1910,1240,1341534971,1341535413,0,6,442
17,1910,1241,1341535413,1341536130,0,6,717
17,1910,1242,1341536130,1341548325,0,6,12195
17,1910,1243,1341548325,1341552453,0,6,4128
17,1910,1244,1341552453,1341552513,0,6,60
17,1911,1245,1341557333,1341558151,0,3,818
17,1911,1246,1341558151,1341558622,0,3,471
17,1911,538,1341558622,1341558682,0,3,60
17,1912,86,1341626126,1341626285,0,8,159
17,1912,1247,1341626285,1341628468,0,8,2183
17,1912,1248,1341628468,1341630183,0,8,1715
17,1912,1249,1341630183,1341631226,0,8,1043
17,1912,1182,1341631226,1341633253,0,8,2027
17,1912,1250,1341633253,1341640460,0,8,7207
17,1912,1236,1341640460,1341643717,0,8,3257
17,1912,1251,1341643717,1341643777,0,8,60
17,1913,1245,1341714540,1341715063,0,4,523
17,1913,1245,1341715063,1341716224,0,4,1161
17,1913,1252,1341716224,1341720944,0,4,4720
17,1913,1253,1341720944,1341721004,0,4,60
17,1914,1194,1341788134,1341789682,0,5,1548
17,1914,1200,1341789682,1341789700,0,5,18
17,1914,292,1341789700,1341790747,0,5,1047
17,1914,1203,1341790747,1341791209,0,5,462
17,1914,1154,1341791209,1341791269,0,5,60
17,1915,1154,1341826002,1341826323,0,4,321
17,1915,817,1341826323,1341826883,0,4,560
17,1915,791,1341826883,1341830363,0,4,3480
17,1915,1163,1341830363,1341830423,0,4,60
17,1916,1194,1341874335,1341876471,0,3,2136
17,1916,1200,1341876471,1341876479,0,3,8
17,1916,292,1341876479,1341876539,0,3,60
17,1917,1194,1341960304,1341976395,0,2,16091
17,1917,1254,1341976395,1341976455,0,2,60
17,1918,1179,1341999107,1341999744,0,7,637
17,1918,1154,1341999744,1342000254,0,7,510
17,1918,817,1342000254,1342000498,0,7,244
17,1918,791,1342000498,1342001795,0,7,1297
17,1918,1155,1342001795,1342002588,0,7,793
17,1918,292,1342002588,1342002648,0,7,60
17,1918,1163,1342002648,1342002708,0,7,60
17,1919,1194,1342046348,1342048121,0,6,1773
17,1919,1200,1342048121,1342048156,0,6,35
17,1919,292,1342048156,1342049207,0,6,1051
17,1919,1203,1342049207,1342049992,0,6,785
17,1919,1154,1342049992,1342062947,0,6,12955
17,1919,1212,1342062947,1342063007,0,6,60
17,1920,1154,1342085002,1342085544,0,5,542
17,1920,1203,1342085544,1342086556,0,5,1012
17,1920,292,1342086556,1342086586,0,5,30
17,1920,1163,1342086586,1342088208,0,5,1622
17,1920,1144,1342088208,1342088268,0,5,60
17,1921,1194,1342132775,1342134639,0,7,1864
17,1921,1200,1342134639,1342134672,0,7,33
17,1921,292,1342134672,1342135675,0,7,1003
17,1921,1203,1342135675,1342135826,0,7,151
17,1921,817,1342135826,1342149153,0,7,13327
17,1921,1167,1342149153,1342149243,0,7,90
17,1921,1167,1342149243,1342149303,0,7,60
17,1922,1154,1342171256,1342171911,0,4,655
17,1922,1203,1342171911,1342172281,0,4,370
17,1922,1218,1342172281,1342173257,0,4,976
17,1922,1070,1342173257,1342173317,0,4,60
17,1923,1177,1342225861,1342225880,0,7,19
17,1923,1144,1342225880,1342226115,0,7,235
17,1923,538,1342226115,1342226183,0,7,68
17,1923,86,1342226183,1342226972,0,7,789
17,1923,1248,1342226972,1342232364,0,7,5392
17,1923,1249,1342232364,1342239808,0,7,7444
17,1923,86,1342239808,1342239868,0,7,60
17,1924,1144,1342248969,1342249029,0,1,60
17,1925,292,1342484500,1342485596,0,5,1096
17,1925,1203,1342485596,1342485619,0,5,23
17,1925,817,1342485619,1342485889,0,5,270
17,1925,817,1342485889,1342486064,0,5,175
17,1925,1154,1342486064,1342486124,0,5,60
17,1926,1218,1342531363,1342531750,0,5,387
17,1926,1176,1342531750,1342531927,0,5,177
17,1926,292,1342531927,1342532031,0,5,104
17,1926,1163,1342532031,1342532044,0,5,13
17,1926,292,1342532044,1342532104,0,5,60
17,1927,1255,1342560392,1342569007,0,2,8615
17,1927,1205,1342569007,1342569067,0,2,60
17,1928,1200,1342653094,1342653119,0,3,25
17,1928,292,1342653119,1342654820,0,3,1701
17,1928,1154,1342654820,1342654880,0,3,60
17,1929,538,1342830106,1342830121,0,5,15
17,1929,538,1342830121,1342830318,0,5,197
17,1929,86,1342830318,1342831109,0,5,791
17,1929,1256,1342831109,1342833506,0,5,2397
17,1929,1257,1342833506,1342833566,0,5,60
17,1930,1203,1343120836,1343121575,0,3,739
17,1930,292,1343121575,1343121698,0,3,123
17,1930,1163,1343121698,1343121758,0,3,60
17,1931,1258,1343344695,1343344755,0,1,60
17,1932,1144,1343437385,1343437445,0,1,60
17,1933,1200,1343526247,1343526277,0,6,30
17,1933,292,1343526277,1343526708,0,6,431
17,1933,1259,1343526708,1343526876,0,6,168
17,1933,1260,1343526876,1343527877,0,6,1001
17,1933,1261,1343527877,1343540597,0,6,12720
17,1933,1262,1343540597,1343540657,0,6,60
17,1934,1200,1343603801,1343603823,0,3,22
17,1934,292,1343603823,1343605151,0,3,1328
17,1934,1203,1343605151,1343605211,0,3,60
17,1935,231,1343635581,1343635865,0,5,284
17,1935,520,1343635865,1343636032,0,5,167
17,1935,723,1343636032,1343636875,0,5,843
17,1935,5,1343636875,1343643480,0,5,6605
17,1935,538,1343643480,1343643540,0,5,60
17,1936,538,1344208917,1344208977,0,1,60
17,1937,1241,1344505332,1344506428,0,5,1096
17,1937,86,1344506428,1344513130,0,5,6702
17,1937,538,1344513130,1344513281,0,5,151
17,1937,1144,1344513281,1344513733,0,5,452
17,1937,1236,1344513733,1344513793,0,5,60
17,1938,1241,1344591027,1344592374,0,7,1347
17,1938,1263,1344592374,1344592684,0,7,310
17,1938,451,1344592684,1344593127,0,7,443
17,1938,1264,1344593127,1344594970,0,7,1843
17,1938,1264,1344594970,1344610320,0,7,15350
17,1938,538,1344610320,1344610684,0,7,364
17,1938,1144,1344610684,1344610744,0,7,60
17,1939,1144,1344649107,1344649683,0,2,576
17,1939,1249,1344649683,1344649743,0,2,60
17,1940,538,1344901103,1344901163,0,1,60
17,1941,86,1344986415,1344986475,0,1,60
17,1942,86,1345158861,1345158921,0,1,60
17,1943,1194,1345269843,1345271875,0,6,2032
17,1943,428,1345271875,1345273804,0,6,1929
17,1943,1265,1345273804,1345274541,0,6,737
17,1943,529,1345274541,1345274709,0,6,168
17,1943,765,1345274709,1345287079,0,6,12370
17,1943,1263,1345287079,1345287139,0,6,60
17,1944,1241,1345420045,1345420105,0,1,60
17,1945,622,1345450453,1345453387,0,5,2934
17,1945,538,1345453387,1345453814,0,5,427
17,1945,1266,1345453814,1345454513,0,5,699
17,1945,1267,1345454513,1345465497,0,5,10984
17,1945,1268,1345465497,1345465557,0,5,60
17,1946,1269,1346839870,1346840796,0,6,926
17,1946,1270,1346840796,1346840836,0,6,40
17,1946,482,1346840836,1346847481,0,6,6645
17,1946,464,1346847481,1346849129,0,6,1648
17,1946,86,1346849129,1346849143,0,6,14
17,1946,538,1346849143,1346849203,0,6,60
17,1947,1241,1347546571,1347547524,0,2,953
17,1947,538,1347547524,1347547584,0,2,60
17,1948,1205,1351469354,1351469414,0,1,60
17,1949,1271,1353740611,1353740671,0,1,60
17,1950,1146,1353848941,1353849001,0,1,60
18,1951,1272,1354941734,1354941794,0,1,60
18,1952,603,1333497897,1333500029,0,3,2132
18,1952,71,1333500029,1333509033,0,3,9004
18,1952,1273,1333509033,1333509093,0,3,60
18,1953,1274,1333521267,1333522646,0,3,1379
18,1953,1275,1333522646,1333542772,0,3,20126
18,1953,35,1333542772,1333542832,0,3,60
18,1954,603,1333543342,1333543402,0,1,60
18,1955,603,1333584428,1333584488,0,1,60
18,1956,603,1333719079,1333719139,0,1,60
18,1957,603,1333848190,1333849351,0,2,1161
18,1957,21,1333849351,1333849411,0,2,60
18,1958,603,1333871087,1333871147,0,1,60
18,1959,603,1333926885,1333928740,0,2,1855
18,1959,71,1333928740,1333928800,0,2,60
18,1960,603,1333975736,1333975796,0,1,60
18,1961,603,1334015732,1334015792,0,1,60
18,1962,603,1334102383,1334104119,0,3,1736
18,1962,71,1334104119,1334113946,0,3,9827
18,1962,1273,1334113946,1334114006,0,3,60
18,1963,5,1334135845,1334137796,0,3,1951
18,1963,8,1334137796,1334139238,0,3,1442
18,1963,1276,1334139238,1334139298,0,3,60
18,1964,603,1334188733,1334190795,0,3,2062
18,1964,71,1334190795,1334200480,0,3,9685
18,1964,1273,1334200480,1334200540,0,3,60
18,1965,21,1334228415,1334229611,0,3,1196
18,1965,35,1334229611,1334231969,0,3,2358
18,1965,603,1334231969,1334232029,0,3,60
18,1966,71,1334277288,1334286828,0,2,9540
18,1966,1277,1334286828,1334286888,0,2,60
18,1967,35,1334316984,1334317809,0,3,825
18,1967,791,1334317809,1334318704,0,3,895
18,1967,603,1334318704,1334318764,0,3,60
18,1968,1278,1334369592,1334369941,0,5,349
18,1968,603,1334369941,1334373228,0,5,3287
18,1968,1279,1334373228,1334380134,0,5,6906
18,1968,1280,1334380134,1334382311,0,5,2177
18,1968,875,1334382311,1334382371,0,5,60
18,1969,1257,1334454929,1334455273,0,2,344
18,1969,1281,1334455273,1334455333,0,2,60
18,1970,603,1334496947,1334497007,0,1,60
18,1971,603,1334575821,1334575881,0,1,60
18,1972,603,1334670796,1334670856,0,1,60
18,1973,603,1334707512,1334707572,0,1,60
18,1974,603,1334793756,1334805154,0,2,11398
18,1974,1282,1334805154,1334805214,0,2,60
18,1975,5,1334831013,1334832236,0,4,1223
18,1975,1283,1334832236,1334833571,0,4,1335
18,1975,701,1334833571,1334835261,0,4,1690
18,1975,603,1334835261,1334835321,0,4,60
18,1976,603,1334880122,1334881735,0,3,1613
18,1976,71,1334881735,1334891631,0,3,9896
18,1976,1277,1334891631,1334891691,0,3,60
18,1977,5,1334916879,1334917167,0,4,288
18,1977,1284,1334917167,1334919818,0,4,2651
18,1977,701,1334919818,1334921398,0,4,1580
18,1977,603,1334921398,1334921458,0,4,60
18,1978,35,1334974782,1334988078,0,2,13296
18,1978,603,1334988078,1334988138,0,2,60
18,1979,71,1335400543,1335400603,0,1,60
18,1980,5,1335431625,1335435697,0,5,4072
18,1980,1285,1335435697,1335435754,0,5,57
18,1980,1283,1335435754,1335438367,0,5,2613
18,1980,701,1335438367,1335439875,0,5,1508
18,1980,603,1335439875,1335439935,0,5,60
18,1981,5,1335520690,1335521074,0,3,384
18,1981,1284,1335521074,1335525859,0,3,4785
18,1981,603,1335525859,1335525919,0,3,60
18,1982,1286,1335581794,1335596500,0,4,14706
18,1982,5,1335596500,1335596613,0,4,113
18,1982,8,1335596613,1335600413,0,4,3800
18,1982,701,1335600413,1335600473,0,4,60
18,1983,765,1335608714,1335610263,0,2,1549
18,1983,289,1335610263,1335610323,0,2,60
18,1984,289,1336342014,1336344368,0,6,2354
18,1984,765,1336344368,1336345918,0,6,1550
18,1984,1287,1336345918,1336349142,0,6,3224
18,1984,603,1336349142,1336350801,0,6,1659
18,1984,71,1336350801,1336360292,0,6,9491
18,1984,1277,1336360292,1336360352,0,6,60
18,1985,603,1336385684,1336386937,0,4,1253
18,1985,1288,1336386937,1336388512,0,4,1575
18,1985,1289,1336388512,1336389302,0,4,790
18,1985,1290,1336389302,1336389362,0,4,60
18,1986,8,1336473886,1336476680,0,3,2794
18,1986,1291,1336476680,1336478033,0,3,1353
18,1986,701,1336478033,1336478093,0,3,60
18,1987,603,1336521937,1336523822,0,4,1885
18,1987,71,1336523822,1336533211,0,4,9389
18,1987,1277,1336533211,1336533211,0,4,0
18,1987,1277,1336533211,1336533271,0,4,60
18,1988,5,1336555849,1336561081,0,4,5232
18,1988,701,1336561081,1336563654,0,4,2573
18,1988,1292,1336563654,1336567534,0,4,3880
18,1988,603,1336567534,1336567594,0,4,60
18,1989,71,1336610476,1336610536,0,1,60
18,1990,603,1336694710,1336696560,0,3,1850
18,1990,71,1336696560,1336705860,0,3,9300
18,1990,1273,1336705860,1336705920,0,3,60
18,1991,603,1336735471,1336735794,0,3,323
18,1991,1290,1336735794,1336738941,0,3,3147
18,1991,1293,1336738941,1336739001,0,3,60
18,1992,1286,1336792815,1336794122,0,6,1307
18,1992,603,1336794122,1336795219,0,6,1097
18,1992,601,1336795219,1336796502,0,6,1283
18,1992,1294,1336796502,1336806723,0,6,10221
18,1992,1295,1336806723,1336812843,0,6,6120
18,1992,1296,1336812843,1336812903,0,6,60
18,1993,1070,1336815778,1336818811,0,4,3033
18,1993,253,1336818811,1336819904,0,4,1093
18,1993,603,1336819904,1336820459,0,4,555
18,1993,1297,1336820459,1336820519,0,4,60
18,1994,1298,1336873184,1336875414,0,6,2230
18,1994,1299,1336875414,1336878957,0,6,3543
18,1994,603,1336878957,1336879301,0,6,344
18,1994,1300,1336879301,1336881277,0,6,1976
18,1994,1289,1336881277,1336882628,0,6,1351
18,1994,605,1336882628,1336882688,0,6,60
18,1995,1301,1336902162,1336905221,0,4,3059
18,1995,1302,1336905221,1336920175,0,4,14954
18,1995,35,1336920175,1336920842,0,4,667
18,1995,603,1336920842,1336920902,0,4,60
18,1996,603,1336953864,1336955942,0,3,2078
18,1996,71,1336955942,1336964933,0,3,8991
18,1996,1277,1336964933,1336964993,0,3,60
18,1997,603,1336994942,1336995362,0,3,420
18,1997,1303,1336995362,1336996235,0,3,873
18,1997,1304,1336996235,1336996295,0,3,60
18,1998,603,1337040215,1337041861,0,2,1646
18,1998,71,1337041861,1337041921,0,2,60
18,1999,603,1337083522,1337084300,0,2,778
18,1999,1305,1337084300,1337084360,0,2,60
18,2000,603,1337126594,1337137862,0,2,11268
18,2000,1273,1337137862,1337137922,0,2,60
18,2001,5,1337160154,1337172048,0,3,11894
18,2001,701,1337172048,1337173679,0,3,1631
18,2001,603,1337173679,1337173739,0,3,60
18,2002,603,1337212977,1337214903,0,3,1926
18,2002,71,1337214903,1337224486,0,3,9583
18,2002,1277,1337224486,1337224546,0,3,60
18,2003,5,1337249611,1337249980,0,5,369
18,2003,1284,1337249980,1337251138,0,5,1158
18,2003,1283,1337251138,1337252433,0,5,1295
18,2003,701,1337252433,1337254553,0,5,2120
18,2003,603,1337254553,1337254613,0,5,60
18,2004,603,1337342889,1337342949,0,1,60
18,2005,35,1337391293,1337393090,0,4,1797
18,2005,253,1337393090,1337404140,0,4,11050
18,2005,1070,1337404140,1337409042,0,4,4902
18,2005,1306,1337409042,1337409102,0,4,60
18,2006,601,1337418504,1337419609,0,2,1105
18,2006,603,1337419609,1337419669,0,2,60
18,2007,5,1337593265,1337598508,0,3,5243
18,2007,701,1337598508,1337600420,0,3,1912
18,2007,603,1337600420,1337600480,0,3,60
18,2008,603,1337644956,1337646671,0,3,1715
18,2008,71,1337646671,1337656426,0,3,9755
18,2008,1273,1337656426,1337656486,0,3,60
18,2009,5,1337680017,1337680391,0,6,374
18,2009,1284,1337680391,1337683307,0,6,2916
18,2009,1283,1337683307,1337684760,0,6,1453
18,2009,701,1337684760,1337686053,0,6,1293
18,2009,603,1337686053,1337687273,0,6,1220
18,2009,1293,1337687273,1337687333,0,6,60
18,2010,603,1337817909,1337828831,0,2,10922
18,2010,1273,1337828831,1337828891,0,2,60
18,2011,21,1337853654,1337853714,0,1,60
18,2012,5,1337939634,1337939983,0,4,349
18,2012,1284,1337939983,1337943069,0,4,3086
18,2012,701,1337943069,1337944983,0,4,1914
18,2012,603,1337944983,1337945043,0,4,60
18,2013,1307,1337999674,1338006682,0,5,7008
18,2013,400,1338006682,1338018617,0,5,11935
18,2013,35,1338018617,1338019952,0,5,1335
18,2013,1308,1338019952,1338021026,0,5,1074
18,2013,603,1338021026,1338021086,0,5,60
18,2014,1309,1338094756,1338094816,0,1,60
18,2015,603,1338163721,1338174895,0,2,11174
18,2015,1277,1338174895,1338174955,0,2,60
18,2016,5,1338200006,1338200168,0,3,162
18,2016,1283,1338200168,1338204628,0,3,4460
18,2016,701,1338204628,1338204688,0,3,60
18,2017,603,1338250023,1338251592,0,3,1569
18,2017,71,1338251592,1338261051,0,3,9459
18,2017,1273,1338261051,1338261111,0,3,60
18,2018,603,1338291723,1338291783,0,1,60
18,2019,603,1338346445,1338348384,0,2,1939
18,2019,71,1338348384,1338348444,0,2,60
18,2020,603,1338553562,1338553622,0,1,60
18,2021,1310,1338693099,1338698130,0,3,5031
18,2021,1311,1338698130,1338699002,0,3,872
18,2021,875,1338699002,1338699062,0,3,60
18,2022,603,1338768484,1338768544,0,1,60
18,2023,603,1338812843,1338812903,0,1,60
18,2024,603,1338854898,1338854958,0,1,60
18,2025,603,1338899180,1338899669,0,2,489
18,2025,1293,1338899669,1338899729,0,2,60
18,2026,5,1338974948,1338980249,0,5,5301
18,2026,8,1338980249,1338984423,0,5,4174
18,2026,603,1338984423,1338984780,0,5,357
18,2026,1312,1338984780,1338985782,0,5,1002
18,2026,1293,1338985782,1338985842,0,5,60
18,2027,603,1339027688,1339029301,0,3,1613
18,2027,71,1339029301,1339038658,0,3,9357
18,2027,1277,1339038658,1339038718,0,3,60
18,2028,603,1339068721,1339068781,0,1,60
18,2029,603,1339114844,1339116419,0,2,1575
18,2029,71,1339116419,1339116479,0,2,60
18,2030,1313,1339153366,1339155905,0,7,2539
18,2030,701,1339155905,1339157167,0,7,1262
18,2030,314,1339157167,1339158053,0,7,886
18,2030,1314,1339158053,1339168306,0,7,10253
18,2030,314,1339168306,1339170440,0,7,2134
18,2030,35,1339170440,1339171509,0,7,1069
18,2030,603,1339171509,1339171569,0,7,60
18,2031,1309,1339209864,1339209924,0,1,60
18,2032,35,1339304592,1339307595,0,7,3003
18,2032,51,1339307595,1339308647,0,7,1052
18,2032,1315,1339308647,1339311334,0,7,2687
18,2032,1316,1339311334,1339319477,0,7,8143
18,2032,737,1339319477,1339320961,0,7,1484
18,2032,887,1339320961,1339321953,0,7,992
18,2032,603,1339321953,1339322013,0,7,60
18,2033,603,1339372386,1339384230,0,2,11844
18,2033,1277,1339384230,1339384290,0,2,60
18,2034,603,1339414822,1339414882,0,1,60
18,2035,71,1339460730,1339470412,0,2,9682
18,2035,1273,1339470412,1339470472,0,2,60
18,2036,1317,1339496482,1339501513,0,3,5031
18,2036,603,1339501513,1339502302,0,3,789
18,2036,1293,1339502302,1339502362,0,3,60
18,2037,603,1339545784,1339547326,0,2,1542
18,2037,71,1339547326,1339547386,0,2,60
18,2038,5,1339579439,1339581927,0,5,2488
18,2038,1284,1339581927,1339583618,0,5,1691
18,2038,1283,1339583618,1339585424,0,5,1806
18,2038,701,1339585424,1339587038,0,5,1614
18,2038,603,1339587038,1339587098,0,5,60
18,2039,71,1339634081,1339643816,0,2,9735
18,2039,1277,1339643816,1339643876,0,2,60
18,2040,5,1339753902,1339754327,0,4,425
18,2040,1284,1339754327,1339758960,0,4,4633
18,2040,701,1339758960,1339760845,0,4,1885
18,2040,603,1339760845,1339760905,0,4,60
18,2041,1298,1339894954,1339897389,0,3,2435
18,2041,1318,1339897389,1339899125,0,3,1736
18,2041,1319,1339899125,1339899185,0,3,60
18,2042,1318,1339916714,1339918182,0,4,1468
18,2042,1320,1339918182,1339920633,0,4,2451
18,2042,8,1339920633,1339923033,0,4,2400
18,2042,1284,1339923033,1339923093,0,4,60
18,2043,701,1339941756,1339943838,0,2,2082
18,2043,603,1339943838,1339943898,0,2,60
18,2044,71,1339979588,1339979648,0,1,60
18,2045,1321,1340016315,1340016354,0,3,39
18,2045,1322,1340016354,1340019472,0,3,3118
18,2045,603,1340019472,1340019532,0,3,60
18,2046,1323,1340097673,1340099119,0,2,1446
18,2046,603,1340099119,1340099179,0,2,60
18,2047,71,1340238729,1340238789,0,1,60
18,2048,5,1340272475,1340272737,0,5,262
18,2048,1284,1340272737,1340275336,0,5,2599
18,2048,8,1340275336,1340276940,0,5,1604
18,2048,701,1340276940,1340278632,0,5,1692
18,2048,603,1340278632,1340278692,0,5,60
18,2049,603,1340624578,1340624638,0,1,60
18,2050,603,1340755605,1340757203,0,3,1598
18,2050,71,1340757203,1340767171,0,3,9968
18,2050,1273,1340767171,1340767231,0,3,60
18,2051,5,1340788521,1340788687,0,4,166
18,2051,1284,1340788687,1340792017,0,4,3330
18,2051,8,1340792017,1340794490,0,4,2473
18,2051,1276,1340794490,1340794550,0,4,60
18,2052,603,1341108397,1341109374,0,3,977
18,2052,598,1341109374,1341112906,0,3,3532
18,2052,1324,1341112906,1341112966,0,3,60
18,2053,555,1341220403,1341220463,0,1,60
18,2054,603,1341273915,1341275604,0,3,1689
18,2054,71,1341275604,1341284816,0,3,9212
18,2054,1277,1341284816,1341284876,0,3,60
18,2055,603,1341315954,1341316884,0,2,930
18,2055,1293,1341316884,1341316944,0,2,60
18,2056,603,1341360333,1341361438,0,3,1105
18,2056,598,1341361438,1341362025,0,3,587
18,2056,71,1341362025,1341362085,0,3,60
18,2057,1325,1341393620,1341394508,0,6,888
18,2057,21,1341394508,1341395014,0,6,506
18,2057,1321,1341395014,1341395041,0,6,27
18,2057,1322,1341395041,1341403800,0,6,8759
18,2057,603,1341403800,1341404099,0,6,299
18,2057,1326,1341404099,1341404159,0,6,60
18,2058,603,1341446654,1341448244,0,2,1590
18,2058,71,1341448244,1341448304,0,2,60
18,2059,5,1341482913,1341488578,0,2,5665
18,2059,603,1341488578,1341488638,0,2,60
18,2060,603,1341533087,1341544244,0,2,11157
18,2060,1273,1341544244,1341544304,0,2,60
18,2061,5,1341568746,1341569305,0,5,559
18,2061,1284,1341569305,1341574331,0,5,5026
18,2061,701,1341574331,1341575937,0,5,1606
18,2061,603,1341575937,1341577013,0,5,1076
18,2061,1327,1341577013,1341577073,0,5,60
18,2062,640,1341624650,1341625025,0,5,375
18,2062,284,1341625025,1341640063,0,5,15038
18,2062,285,1341640063,1341645093,0,5,5030
18,2062,284,1341645093,1341645691,0,5,598
18,2062,35,1341645691,1341645751,0,5,60
18,2063,1328,1341652592,1341655929,0,3,3337
18,2063,1329,1341655929,1341659559,0,3,3630
18,2063,603,1341659559,1341659619,0,3,60
18,2064,35,1341712044,1341712803,0,5,759
18,2064,601,1341712803,1341715375,0,5,2572
18,2064,1330,1341715375,1341729216,0,5,13841
18,2064,1331,1341729216,1341732085,0,5,2869
18,2064,603,1341732085,1341732145,0,5,60
18,2065,603,1341792108,1341793921,0,2,1813
18,2065,71,1341793921,1341793981,0,2,60
18,2066,5,1341828930,1341829373,0,3,443
18,2066,232,1341829373,1341834534,0,3,5161
18,2066,603,1341834534,1341834594,0,3,60
18,2067,603,1341879106,1341879166,0,1,60
18,2068,603,1341965003,1341966656,0,3,1653
18,2068,71,1341966656,1341976077,0,3,9421
18,2068,1273,1341976077,1341976137,0,3,60
18,2069,5,1341999980,1342004784,0,4,4804
18,2069,701,1342004784,1342006075,0,4,1291
18,2069,791,1342006075,1342007629,0,4,1554
18,2069,603,1342007629,1342007689,0,4,60
18,2070,603,1342051551,1342062694,0,2,11143
18,2070,1273,1342062694,1342062754,0,2,60
18,2071,5,1342089049,1342089122,0,5,73
18,2071,1283,1342089122,1342091167,0,5,2045
18,2071,701,1342091167,1342092477,0,5,1310
18,2071,791,1342092477,1342093992,0,5,1515
18,2071,603,1342093992,1342094052,0,5,60
18,2072,603,1342137908,1342139616,0,2,1708
18,2072,71,1342139616,1342139676,0,2,60
18,2073,5,1342172933,1342173328,0,5,395
18,2073,1284,1342173328,1342177416,0,5,4088
18,2073,1332,1342177416,1342189727,0,5,12311
18,2073,701,1342189727,1342192471,0,5,2744
18,2073,603,1342192471,1342192531,0,5,60
18,2074,1287,1342224878,1342225467,0,2,589
18,2074,35,1342225467,1342225527,0,2,60
18,2075,253,1342413705,1342422105,0,4,8400
18,2075,601,1342422105,1342422802,0,4,697
18,2075,603,1342422802,1342430270,0,4,7468
18,2075,1287,1342430270,1342430330,0,4,60
18,2076,1326,1342439109,1342439169,0,1,60
18,2077,603,1342483701,1342485220,0,3,1519
18,2077,71,1342485220,1342494820,0,3,9600
18,2077,1273,1342494820,1342494880,0,3,60
18,2078,603,1342529642,1342530238,0,2,596
18,2078,1326,1342530238,1342530298,0,2,60
18,2079,603,1342568866,1342570625,0,2,1759
18,2079,71,1342570625,1342570685,0,2,60
18,2080,603,1342834212,1342834272,0,1,60
18,2081,701,1342962751,1342967234,0,2,4483
18,2081,603,1342967234,1342967294,0,2,60
18,2082,1333,1343125069,1343130208,0,2,5139
18,2082,603,1343130208,1343130268,0,2,60
18,2083,1334,1343443005,1343447046,0,3,4041
18,2083,1257,1343447046,1343458940,0,3,11894
18,2083,605,1343458940,1343459000,0,3,60
18,2084,603,1343520970,1343522384,0,3,1414
18,2084,21,1343522384,1343523635,0,3,1251
18,2084,1335,1343523635,1343523695,0,3,60
18,2085,603,1343549198,1343549258,0,1,60
18,2086,71,1343608627,1343608687,0,1,60
18,2087,603,1343648220,1343648280,0,1,60
18,2088,603,1344153427,1344153487,0,1,60
18,2089,71,1344213502,1344222399,0,2,8897
18,2089,1273,1344222399,1344222459,0,2,60
18,2090,603,1344255740,1344255800,0,1,60
18,2091,5,1344508247,1344514156,0,4,5909
18,2091,1335,1344514156,1344515868,0,4,1712
18,2091,603,1344515868,1344516897,0,4,1029
18,2091,1327,1344516897,1344516957,0,4,60
18,2092,1005,1344547662,1344547722,0,1,60
18,2093,765,1345335554,1345337673,0,3,2119
18,2093,603,1345337673,1345351114,0,3,13441
18,2093,1336,1345351114,1345351174,0,3,60
18,2094,71,1345422739,1345422799,0,1,60
18,2095,5,1345457371,1345457620,0,5,249
18,2095,1284,1345457620,1345459317,0,5,1697
18,2095,1283,1345459317,1345460771,0,5,1454
18,2095,701,1345460771,1345462108,0,5,1337
18,2095,603,1345462108,1345462168,0,5,60
18,2096,1325,1346838026,1346838227,0,8,201
18,2096,1337,1346838227,1346839998,0,8,1771
18,2096,5,1346839998,1346840253,0,8,255
18,2096,1284,1346840253,1346841549,0,8,1296
18,2096,1283,1346841549,1346843083,0,8,1534
18,2096,8,1346843083,1346845306,0,8,2223
18,2096,701,1346845306,1346846784,0,8,1478
18,2096,603,1346846784,1346846844,0,8,60
18,2097,1273,1346901459,1346901519,0,1,60
18,2098,603,1347235453,1347237224,0,2,1771
18,2098,71,1347237224,1347237284,0,2,60
18,2099,603,1347665864,1347667421,0,3,1557
18,2099,1283,1347667421,1347686064,0,3,18643
18,2099,701,1347686064,1347686124,0,3,60
18,2100,603,1347687791,1347687957,0,4,166
18,2100,1289,1347687957,1347694044,0,4,6087
18,2100,1005,1347694044,1347695500,0,4,1456
18,2100,289,1347695500,1347695560,0,4,60
18,2101,603,1350000128,1350000188,0,1,60
18,2102,1338,1350102372,1350104758,0,8,2386
18,2102,1339,1350104758,1350105108,0,8,350
18,2102,1339,1350105108,1350105891,0,8,783
18,2102,1340,1350105891,1350106749,0,8,858
18,2102,1341,1350106749,1350109988,0,8,3239
18,2102,1342,1350109988,1350111981,0,8,1993
18,2102,1257,1350111981,1350118857,0,8,6876
18,2102,1293,1350118857,1350118917,0,8,60
18,2103,1293,1350388761,1350388821,0,1,60
18,2104,5,1350466463,1350467159,0,3,696
18,2104,26,1350467159,1350472066,0,3,4907
18,2104,701,1350472066,1350472126,0,3,60
18,2105,71,1350607191,1350607251,0,1,60
18,2106,603,1350647195,1350647255,0,1,60
18,2107,603,1350950754,1350952342,0,2,1588
18,2107,71,1350952342,1350952402,0,2,60
18,2108,21,1350995435,1350995495,0,1,60
18,2109,71,1351038737,1351048571,0,2,9834
18,2109,1273,1351048571,1351048631,0,2,60
18,2110,5,1351071096,1351071316,0,4,220
18,2110,1343,1351071316,1351075069,0,4,3753
18,2110,8,1351075069,1351081792,0,4,6723
18,2110,603,1351081792,1351081852,0,4,60
18,2111,603,1351123408,1351134509,0,2,11101
18,2111,1273,1351134509,1351134569,0,2,60
18,2112,603,1351169709,1351169769,0,1,60
18,2113,1273,1351221324,1351221384,0,1,60
18,2114,603,1351260034,1351261051,0,2,1017
18,2114,1293,1351261051,1351261111,0,2,60
18,2115,1344,1351310979,1351312392,0,5,1413
18,2115,1345,1351312392,1351316467,0,5,4075
18,2115,1346,1351316467,1351321144,0,5,4677
18,2115,1296,1351321144,1351327402,0,5,6258
18,2115,1347,1351327402,1351327462,0,5,60
18,2116,1348,1351334622,1351334682,0,1,60
18,2117,1257,1351399311,1351399371,0,1,60
18,2118,603,1351469162,1351480093,0,2,10931
18,2118,1273,1351480093,1351480153,0,2,60
18,2119,603,1351599781,1351599841,0,1,60
18,2120,603,1351641741,1351653346,0,2,11605
18,2120,1273,1351653346,1351653406,0,2,60
18,2121,603,1351689110,1351689170,0,1,60
18,2122,71,1351729927,1351729987,0,1,60
18,2123,603,1351775587,1351775647,0,1,60
18,2124,603,1351814614,1351825862,0,2,11248
18,2124,1273,1351825862,1351825922,0,2,60
18,2125,603,1351862354,1351862414,0,1,60
18,2126,603,1352160336,1352171195,0,2,10859
18,2126,1273,1352171195,1352171255,0,2,60
18,2127,5,1352196954,1352200099,0,5,3145
18,2127,8,1352200099,1352201523,0,5,1424
18,2127,701,1352201523,1352203207,0,5,1684
18,2127,603,1352203207,1352204357,0,5,1150
18,2127,1293,1352204357,1352204417,0,5,60
18,2128,1273,1352258389,1352258449,0,1,60
18,2129,5,1352280287,1352283568,0,4,3281
18,2129,1283,1352283568,1352287973,0,4,4405
18,2129,701,1352287973,1352289710,0,4,1737
18,2129,603,1352289710,1352289770,0,4,60
18,2130,603,1352377609,1352377669,0,1,60
18,2131,603,1352466315,1352466375,0,1,60
18,2132,603,1352590133,1352590193,0,1,60
18,2133,603,1352638062,1352638122,0,1,60
18,2134,603,1352723026,1352723086,0,1,60
18,2135,1273,1352776195,1352776255,0,1,60
18,2136,701,1352802994,1352803466,0,4,472
18,2136,1322,1352803466,1352806932,0,4,3466
18,2136,791,1352806932,1352808892,0,4,1960
18,2136,603,1352808892,1352808952,0,4,60
18,2137,603,1353024289,1353024349,0,1,60
18,2138,1289,1353129756,1353133613,0,3,3857
18,2138,875,1353133613,1353143671,0,3,10058
18,2138,1349,1353143671,1353143731,0,3,60
18,2139,1350,1353205704,1353210865,0,3,5161
18,2139,1351,1353210865,1353225880,0,3,15015
18,2139,603,1353225880,1353225940,0,3,60
18,2140,71,1353371404,1353371464,0,1,60
18,2141,603,1353417155,1353417215,0,1,60
18,2142,603,1353456406,1353458204,0,2,1798
18,2142,71,1353458204,1353458264,0,2,60
18,2143,5,1353489749,1353490300,0,4,551
18,2143,1352,1353490300,1353491618,0,4,1318
18,2143,1284,1353491618,1353503367,0,4,11749
18,2143,603,1353503367,1353503427,0,4,60
18,2144,603,1353542839,1353544442,0,3,1603
18,2144,71,1353544442,1353553770,0,3,9328
18,2144,1277,1353553770,1353553830,0,3,60
18,2145,1325,1353576881,1353577561,0,5,680
18,2145,1353,1353577561,1353580320,0,5,2759
18,2145,5,1353580320,1353583266,0,5,2946
18,2145,701,1353583266,1353585204,0,5,1938
18,2145,603,1353585204,1353585264,0,5,60
18,2146,1354,1353653269,1353653329,0,1,60
18,2147,35,1353723480,1353724147,0,6,667
18,2147,253,1353724147,1353725039,0,6,892
18,2147,1355,1353725039,1353731535,0,6,6496
18,2147,1356,1353731535,1353733873,0,6,2338
18,2147,1357,1353733873,1353738344,0,6,4471
18,2147,1358,1353738344,1353738404,0,6,60
18,2148,342,1353746645,1353750286,0,2,3641
18,2148,1287,1353750286,1353750346,0,2,60
18,2149,1359,1353814170,1353814230,0,1,60
18,2150,603,1353847906,1353847966,0,1,60
18,2151,603,1353890665,1353890725,0,1,60
18,2152,603,1353934900,1353934960,0,1,60
18,2153,1322,1354013031,1354013091,0,1,60
18,2154,603,1354060970,1354061030,0,1,60
18,2155,71,1354149248,1354149308,0,1,60
18,2156,1286,1354344037,1354347756,0,4,3719
18,2156,23,1354347756,1354353222,0,4,5466
18,2156,1360,1354353222,1354361406,0,4,8184
18,2156,603,1354361406,1354361466,0,4,60
18,2157,603,1354408393,1354410305,0,2,1912
18,2157,1361,1354410305,1354410365,0,2,60
18,2158,5,1354431621,1354437429,0,2,5808
18,2158,1362,1354437429,1354437489,0,2,60
18,2159,603,1354454424,1354454484,0,1,60
18,2160,71,1354754055,1354757275,0,2,3220
18,2160,603,1354757275,1354757335,0,2,60
18,2161,603,1355028314,1355031360,0,4,3046
18,2161,449,1355031360,1355040218,0,4,8858
18,2161,1287,1355040218,1355048370,0,4,8152
18,2161,1286,1355048370,1355048430,0,4,60
18,2162,71,1355100580,1355109124,0,2,8544
18,2162,1273,1355109124,1355109184,0,2,60
18,2163,603,1355184115,1355184175,0,1,60
18,2164,5,1355219003,1355227279,0,2,8276
18,2164,603,1355227279,1355227339,0,2,60
18,2165,603,1355270729,1355272666,0,3,1937
18,2165,71,1355272666,1355281749,0,3,9083
18,2165,1273,1355281749,1355281809,0,3,60
18,2166,71,1355358727,1355368413,0,2,9686
18,2166,1277,1355368413,1355368473,0,2,60
18,2167,5,1355392704,1355398723,0,2,6019
18,2167,603,1355398723,1355398783,0,2,60
18,2168,603,1355485159,1355485219,0,1,60
18,2169,253,1355538041,1355543828,0,3,5787
18,2169,1070,1355543828,1355559026,0,3,15198
18,2169,601,1355559026,1355559086,0,3,60
18,2170,603,1355559685,1355561360,0,2,1675
18,2170,1293,1355561360,1355561420,0,2,60
18,2171,603,1355628849,1355631940,0,5,3091
18,2171,14,1355631940,1355632608,0,5,668
18,2171,15,1355632608,1355644954,0,5,12346
18,2171,434,1355644954,1355648368,0,5,3414
18,2171,403,1355648368,1355648428,0,5,60
18,2172,371,1355656242,1355657654,0,2,1412
18,2172,1287,1355657654,1355657714,0,2,60
18,2173,71,1355704644,1355704704,0,1,60
18,2174,1337,1355737995,1355740202,0,4,2207
18,2174,5,1355740202,1355741831,0,4,1629
18,2174,8,1355741831,1355743668,0,4,1837
18,2174,701,1355743668,1355743728,0,4,60
18,2175,603,1355789116,1355791100,0,2,1984
18,2175,71,1355791100,1355791160,0,2,60
18,2176,8,1355827142,1355832037,0,2,4895
18,2176,603,1355832037,1355832097,0,2,60
18,2177,603,1355875484,1355875544,0,1,60
18,2178,5,1355909172,1355909909,0,3,737
18,2178,8,1355909909,1355912228,0,3,2319
18,2178,1276,1355912228,1355912288,0,3,60
18,2179,1273,1355973309,1355973369,0,1,60
18,2180,603,1356048280,1356050065,0,2,1785
18,2180,71,1356050065,1356050125,0,2,60
18,2181,1322,1356085851,1356092112,0,2,6261
18,2181,603,1356092112,1356092172,0,2,60
18,2182,35,1356145742,1356147588,0,2,1846
18,2182,121,1356147588,1356147648,0,2,60
18,2183,1287,1356169531,1356169591,0,1,60
18,2184,5,1356238638,1356238886,0,3,248
18,2184,8,1356238886,1356247760,0,3,8874
18,2184,603,1356247760,1356247820,0,3,60
18,2185,603,1356605354,1356605414,0,1,60
18,2186,603,1356652989,1356654766,0,2,1777
18,2186,71,1356654766,1356654826,0,2,60
18,2187,701,1356765615,1356767175,0,3,1560
18,2187,263,1356767175,1356771854,0,3,4679
18,2187,261,1356771854,1356771914,0,3,60
18,2188,35,1356845357,1356848350,0,3,2993
18,2188,603,1356848350,1356848866,0,3,516
18,2188,605,1356848866,1356848926,0,3,60
18,2189,1363,1356940843,1356944225,0,3,3382
18,2189,603,1356944225,1356944795,0,3,570
18,2189,1364,1356944795,1356944855,0,3,60
18,2190,1289,1357278164,1357280188,0,5,2024
18,2190,5,1357280188,1357280783,0,5,595
18,2190,1365,1357280783,1357282096,0,5,1313
18,2190,1284,1357282096,1357284731,0,5,2635
18,2190,1366,1357284731,1357284791,0,5,60
18,2191,701,1357302008,1357303575,0,2,1567
18,2191,603,1357303575,1357303635,0,2,60
18,2192,35,1357350757,1357361965,0,2,11208
18,2192,603,1357361965,1357362025,0,2,60
18,2193,1367,1357459494,1357459902,0,3,408
18,2193,1368,1357459902,1357467772,0,3,7870
18,2193,1369,1357467772,1357467832,0,3,60
18,2194,1273,1357528416,1357528476,0,1,60
18,2195,603,1357555278,1357555338,0,1,60
18,2196,603,1357603754,1357603814,0,1,60
18,2197,5,1357638272,1357638772,0,3,500
18,2197,1370,1357638772,1357643223,0,3,4451
18,2197,603,1357643223,1357643283,0,3,60
18,2198,71,1357691716,1357700841,0,2,9125
18,2198,1273,1357700841,1357700901,0,2,60
18,2199,434,1357723119,1357723319,0,2,200
18,2199,1325,1357723319,1357723379,0,2,60
18,2200,8,1357811837,1357814943,0,3,3106
18,2200,701,1357814943,1357816193,0,3,1250
18,2200,603,1357816193,1357816253,0,3,60
18,2201,603,1357862747,1357864418,0,3,1671
18,2201,71,1357864418,1357874086,0,3,9668
18,2201,1277,1357874086,1357874146,0,3,60
18,2202,1371,1357901050,1357904142,0,2,3092
18,2202,603,1357904142,1357904202,0,2,60
18,2203,35,1357955977,1357968952,0,2,12975
18,2203,1372,1357968952,1357969012,0,2,60
18,2204,1289,1357989540,1357989813,0,2,273
18,2204,1290,1357989813,1357989873,0,2,60
18,2205,1287,1358025207,1358025267,0,1,60
18,2206,451,1358050544,1358050604,0,1,60
18,2207,5,1358327790,1358334994,0,3,7204
18,2207,603,1358334994,1358335029,0,3,35
18,2207,1289,1358335029,1358335089,0,3,60
18,2208,71,1358382782,1358392084,0,2,9302
18,2208,1273,1358392084,1358392144,0,2,60
18,2209,701,1358425322,1358425382,0,1,60
18,2210,71,1358469455,1358469515,0,1,60
18,2211,5,1358506847,1358510665,0,2,3818
18,2211,1298,1358510665,1358510725,0,2,60
18,2212,1277,1358824020,1358824080,0,1,60
18,2213,603,1358854680,1358854740,0,1,60
18,2214,1317,1359022122,1359030857,0,2,8735
18,2214,603,1359030857,1359030917,0,2,60
18,2215,603,1359072308,1359074300,0,2,1992
18,2215,71,1359074300,1359074360,0,2,60
18,2216,603,1359113676,1359113736,0,1,60
18,2217,603,1359248591,1359253477,0,5,4886
18,2217,1373,1359253477,1359265214,0,5,11737
18,2217,1374,1359265214,1359266830,0,5,1616
18,2217,1375,1359266830,1359269712,0,5,2882
18,2217,1376,1359269712,1359269772,0,5,60
18,2218,1377,1359277878,1359288675,0,3,10797
18,2218,541,1359288675,1359290403,0,3,1728
18,2218,1287,1359290403,1359290463,0,3,60
18,2219,583,1359372279,1359375754,0,2,3475
18,2219,603,1359375754,1359375814,0,2,60
18,2220,603,1359459421,1359459481,0,1,60
18,2221,71,1359506314,1359515549,0,2,9235
18,2221,1273,1359515549,1359515609,0,2,60
18,2222,5,1359538522,1359541582,0,4,3060
18,2222,8,1359541582,1359545063,0,4,3481
18,2222,701,1359545063,1359546711,0,4,1648
18,2222,603,1359546711,1359546771,0,4,60
18,2223,603,1359594392,1359594452,0,1,60
18,2224,1322,1359629541,1359629601,0,1,60
18,2225,434,1359712588,1359718706,0,2,6118
18,2225,603,1359718706,1359718766,0,2,60
18,2226,400,1359770837,1359783524,0,2,12687
18,2226,931,1359783524,1359783584,0,2,60
18,2227,603,1359793322,1359793382,0,1,60
18,2228,603,1359852051,1359863065,0,2,11014
18,2228,449,1359863065,1359863125,0,2,60
18,2229,451,1359884519,1359890811,0,3,6292
18,2229,1378,1359890811,1359893582,0,3,2771
18,2229,449,1359893582,1359893642,0,3,60
18,2230,603,1359978427,1359978487,0,1,60
18,2231,603,1360022703,1360022763,0,1,60
18,2232,5,1360058521,1360065336,0,3,6815
18,2232,603,1360065336,1360066051,0,3,715
18,2232,1293,1360066051,1360066111,0,3,60
18,2233,603,1360109067,1360111042,0,2,1975
18,2233,598,1360111042,1360111102,0,2,60
18,2234,8,1360146425,1360150294,0,2,3869
18,2234,603,1360150294,1360150354,0,2,60
18,2235,71,1360197333,1360206422,0,2,9089
18,2235,1273,1360206422,1360206482,0,2,60
18,2236,5,1360232915,1360233826,0,4,911
18,2236,701,1360233826,1360236090,0,4,2264
18,2236,35,1360236090,1360236207,0,4,117
18,2236,1379,1360236207,1360236267,0,4,60
18,2237,603,1360282233,1360284217,0,2,1984
18,2237,71,1360284217,1360284277,0,2,60
18,2238,603,1360541365,1360541425,0,1,60
18,2239,603,1360572660,1360572682,0,2,22
18,2239,1289,1360572682,1360572742,0,2,60
18,2240,603,1360627400,1360627460,0,1,60
18,2241,603,1360670456,1360670516,0,1,60
18,2242,603,1360714000,1360715623,0,2,1623
18,2242,71,1360715623,1360715683,0,2,60
18,2243,5,1360747810,1360748079,0,6,269
18,2243,1380,1360748079,1360749393,0,6,1314
18,2243,1381,1360749393,1360749533,0,6,140
18,2243,8,1360749533,1360754334,0,6,4801
18,2243,701,1360754334,1360755600,0,6,1266
18,2243,603,1360755600,1360755660,0,6,60
18,2244,71,1360802399,1360802459,0,1,60
18,2245,5,1360835035,1360835961,0,5,926
18,2245,10,1360835961,1360840301,0,5,4340
18,2245,701,1360840301,1360841759,0,5,1458
18,2245,1257,1360841759,1360842203,0,5,444
18,2245,1364,1360842203,1360842263,0,5,60
19,2246,100,1360979074,1360979134,0,1,60
19,2247,1382,1343451874,1343463926,0,3,12052
19,2247,1383,1343463926,1343465403,0,3,1477
19,2247,1322,1343465403,1343465463,0,3,60
19,2248,14,1343546240,1343546887,0,2,647
19,2248,1384,1343546887,1343546947,0,2,60
19,2249,1385,1343608229,1343608289,0,1,60
19,2250,1386,1344556060,1344556120,0,1,60
19,2251,1387,1344661666,1344661726,0,1,60
19,2252,1386,1344900774,1344902875,0,2,2101
19,2252,1385,1344902875,1344902935,0,2,60
19,2253,1385,1345424971,1345425031,0,1,60
19,2254,1322,1346846975,1346847035,0,1,60
19,2255,1386,1347234382,1347237566,0,2,3184
19,2255,1385,1347237566,1347237626,0,2,60
19,2256,1388,1347680997,1347699402,0,4,18405
19,2256,1387,1347699402,1347699523,0,4,121
19,2256,1389,1347699523,1347701586,0,4,2063
19,2256,1386,1347701586,1347701646,0,4,60
19,2257,684,1347766924,1347766984,0,1,60
19,2258,1390,1350011719,1350013035,0,2,1316
19,2258,1391,1350013035,1350013095,0,2,60
19,2259,298,1350114760,1350117328,0,3,2568
19,2259,1392,1350117328,1350117467,0,3,139
19,2259,1390,1350117467,1350117527,0,3,60
19,2260,1393,1350388336,1350388573,0,2,237
19,2260,1394,1350388573,1350388633,0,2,60
19,2261,1395,1350470211,1350470271,0,1,60
19,2262,1396,1350601854,1350604114,0,2,2260
19,2262,1397,1350604114,1350604174,0,2,60
19,2263,1387,1350652128,1350652188,0,1,60
19,2264,1398,1350900185,1350903645,0,3,3460
19,2264,1399,1350903645,1350903694,0,3,49
19,2264,1400,1350903694,1350903754,0,3,60
19,2265,1401,1350948819,1350948879,0,1,60
19,2266,1386,1351035107,1351038607,0,3,3500
19,2266,1385,1351038607,1351039221,0,3,614
19,2266,1397,1351039221,1351039281,0,3,60
19,2267,1387,1351076416,1351076476,0,1,60
19,2268,391,1351112758,1351112818,0,1,60
19,2269,1395,1351156120,1351158929,0,2,2809
19,2269,1322,1351158929,1351158989,0,2,60
19,2270,1402,1351312782,1351326402,0,3,13620
19,2270,1155,1351326402,1351327517,0,3,1115
19,2270,1403,1351327517,1351327577,0,3,60
19,2271,1387,1351678123,1351680551,0,2,2428
19,2271,1404,1351680551,1351680611,0,2,60
19,2272,1405,1352110714,1352110774,0,1,60
19,2273,1387,1352157633,1352157693,0,1,60
19,2274,1385,1352201315,1352201740,0,2,425
19,2274,1322,1352201740,1352201800,0,2,60
19,2275,1386,1352244080,1352244140,0,1,60
19,2276,1406,1352287125,1352287185,0,1,60
19,2277,1406,1352370380,1352371886,0,3,1506
19,2277,1407,1352371886,1352372168,0,3,282
19,2277,1408,1352372168,1352372228,0,3,60
19,2278,1387,1352464633,1352464693,0,1,60
19,2279,1409,1352762927,1352762987,0,1,60
19,2280,1393,1353063782,1353063909,0,3,127
19,2280,1394,1353063909,1353067326,0,3,3417
19,2280,1410,1353067326,1353067386,0,3,60
19,2281,1070,1353126072,1353146183,0,2,20111
19,2281,684,1353146183,1353146243,0,2,60
19,2282,1387,1353205876,1353215728,0,2,9852
19,2282,1389,1353215728,1353215788,0,2,60
19,2283,561,1353449533,1353449593,0,1,60
19,2284,1411,1353633656,1353633716,0,1,60
19,2285,1412,1353743384,1353743992,0,3,608
19,2285,1413,1353743992,1353748283,0,3,4291
19,2285,1389,1353748283,1353748343,0,3,60
19,2286,1414,1353885879,1353889808,0,2,3929
19,2286,1385,1353889808,1353889868,0,2,60
19,2287,1394,1353926378,1353931175,0,2,4797
19,2287,1415,1353931175,1353931235,0,2,60
19,2288,1385,1353976502,1353976562,0,1,60
19,2289,1386,1354144426,1354144486,0,1,60
19,2290,1416,1354325062,1354335586,0,2,10524
19,2290,1417,1354335586,1354335646,0,2,60
19,2291,1389,1354355582,1354355642,0,1,60
19,2292,1385,1354667627,1354667687,0,1,60
19,2293,1401,1354796435,1354796495,0,1,60
19,2294,1414,1354836634,1354836694,0,1,60
19,2295,1418,1355099324,1355099384,0,1,60
19,2296,1385,1355185948,1355186008,0,1,60
19,2297,1419,1355395756,1355395816,0,1,60
19,2298,1420,1355566483,1355566543,0,1,60
19,2299,298,1355807656,1355817858,0,2,10202
19,2299,1387,1355817858,1355817918,0,2,60
19,2300,561,1357121115,1357122513,0,2,1398
19,2300,1387,1357122513,1357122573,0,2,60
19,2301,1389,1357196776,1357196836,0,1,60
19,2302,1322,1357298759,1357298819,0,1,60
19,2303,1409,1357600830,1357600890,0,1,60
19,2304,1385,1357691571,1357691631,0,1,60
19,2305,1421,1357725037,1357729024,0,2,3987
19,2305,1422,1357729024,1357729084,0,2,60
19,2306,1423,1357817865,1357817925,0,1,60
19,2307,1322,1357901396,1357901456,0,1,60
19,2308,1387,1357956670,1357967155,0,3,10485
19,2308,1424,1357967155,1357975537,0,3,8382
19,2308,1425,1357975537,1357975597,0,3,60
19,2309,1155,1358173398,1358173458,0,1,60
19,2310,1406,1358420552,1358420612,0,1,60
19,2311,1385,1358469408,1358469468,0,1,60
19,2312,1426,1358510170,1358510230,0,1,60
19,2313,1427,1359022246,1359023795,0,3,1549
19,2313,1428,1359023795,1359024988,0,3,1193
19,2313,1413,1359024988,1359025048,0,3,60
19,2314,1322,1359185306,1359190524,0,4,5218
19,2314,1429,1359190524,1359195493,0,4,4969
19,2314,1408,1359195493,1359197170,0,4,1677
19,2314,464,1359197170,1359197230,0,4,60
19,2315,1409,1359329084,1359329144,0,1,60
19,2316,1387,1359376304,1359376364,0,1,60
19,2317,1385,1359505842,1359505902,0,1,60
19,2318,1393,1359545745,1359545805,0,1,60
19,2319,1425,1359675257,1359675317,0,1,60
19,2320,1430,1359764926,1359764986,0,1,60
19,2321,558,1359876473,1359879339,0,2,2866
19,2321,1431,1359879339,1359879399,0,2,60
19,2322,1389,1359976239,1359977796,0,2,1557
19,2322,1387,1359977796,1359977856,0,2,60
19,2323,1322,1360058940,1360059000,0,1,60
19,2324,1395,1360322739,1360324949,0,3,2210
19,2324,482,1360324949,1360325092,0,3,143
19,2324,1394,1360325092,1360325152,0,3,60
20,2325,1432,1360666101,1360666161,0,1,60
20,2326,1433,1333539170,1333539230,0,1,60
20,2327,1434,1333619925,1333619985,0,1,60
20,2328,1435,1333973975,1333974035,0,1,60
20,2329,1436,1334030149,1334030209,0,1,60
20,2330,1435,1334055219,1334055279,0,1,60
20,2331,1437,1334380497,1334401119,0,2,20622
20,2331,1435,1334401119,1334401179,0,2,60
20,2332,1438,1334460179,1334460239,0,1,60
20,2333,1435,1334569956,1334570016,0,1,60
20,2334,1435,1334674442,1334674502,0,1,60
20,2335,482,1334921258,1334921318,0,1,60
20,2336,1439,1335068039,1335068099,0,1,60
20,2337,1440,1335175152,1335175212,0,1,60
20,2338,1435,1335277396,1335277456,0,1,60
20,2339,1441,1335523885,1335523990,0,2,105
20,2339,1442,1335523990,1335524050,0,2,60
20,2340,1435,1335611264,1335611324,0,1,60
20,2341,1443,1336035270,1336036482,0,2,1212
20,2341,1444,1336036482,1336036542,0,2,60
20,2342,1438,1336113667,1336113727,0,1,60
20,2343,1445,1336360977,1336361037,0,1,60
20,2344,1435,1336385034,1336385094,0,1,60
20,2345,1446,1336536007,1336536067,0,1,60
20,2346,1447,1336795466,1336802777,0,2,7311
20,2346,1448,1336802777,1336802837,0,2,60
20,2347,1435,1336820641,1336821122,0,3,481
20,2347,1449,1336821122,1336827571,0,3,6449
20,2347,1450,1336827571,1336827631,0,3,60
20,2348,1451,1336886363,1336886423,0,1,60
20,2349,1452,1336913659,1336916791,0,2,3132
20,2349,710,1336916791,1336916851,0,2,60
20,2350,1435,1336989782,1336989842,0,1,60
20,2351,1406,1337079444,1337079515,0,2,71
20,2351,1435,1337079515,1337079575,0,2,60
20,2352,1453,1337141554,1337141614,0,1,60
20,2353,1454,1337235411,1337235471,0,1,60
20,2354,1439,1337341411,1337341471,0,1,60
20,2355,1435,1337425201,1337425261,0,1,60
20,2356,1434,1337659529,1337659589,0,1,60
20,2357,1437,1338006729,1338008609,0,2,1880
20,2357,1455,1338008609,1338008669,0,2,60
20,2358,1456,1338103260,1338103320,0,1,60
20,2359,1435,1338301067,1338301127,0,1,60
20,2360,1457,1338694712,1338696183,0,4,1471
20,2360,1458,1338696183,1338703672,0,4,7489
20,2360,1438,1338703672,1338709444,0,4,5772
20,2360,1459,1338709444,1338709504,0,4,60
20,2361,1460,1338785089,1338785149,0,1,60
20,2362,1435,1338896215,1338896275,0,1,60
20,2363,1461,1338991277,1338991337,0,1,60
20,2364,1415,1339069674,1339070240,0,3,566
20,2364,1462,1339070240,1339070607,0,3,367
20,2364,1463,1339070607,1339070667,0,3,60
20,2365,1442,1339212680,1339216078,0,3,3398
20,2365,1464,1339216078,1339216183,0,3,105
20,2365,555,1339216183,1339216243,0,3,60
20,2366,1465,1339241427,1339241487,0,1,60
20,2367,1458,1339297056,1339297116,0,1,60
20,2368,1445,1339386013,1339386073,0,1,60
20,2369,1466,1340249305,1340249365,0,1,60
20,2370,1467,1341115488,1341118947,0,2,3459
20,2370,1468,1341118947,1341119007,0,2,60
20,2371,1446,1341287007,1341287067,0,1,60
20,2372,1435,1341327283,1341327343,0,1,60
20,2373,1469,1341395215,1341402423,0,2,7208
20,2373,8,1341402423,1341402483,0,2,60
20,2374,1437,1341633523,1341633583,0,1,60
20,2375,1470,1341723620,1341723680,0,1,60
20,2376,1471,1341796203,1341798411,0,2,2208
20,2376,1472,1341798411,1341798471,0,2,60
20,2377,1437,1341833414,1341833474,0,1,60
20,2378,1473,1342003914,1342003974,0,1,60
20,2379,1457,1342073275,1342074533,0,3,1258
20,2379,1458,1342074533,1342078874,0,3,4341
20,2379,1474,1342078874,1342078934,0,3,60
20,2380,1475,1342154630,1342155644,0,3,1014
20,2380,1476,1342155644,1342171762,0,3,16118
20,2380,1477,1342171762,1342171822,0,3,60
20,2381,1478,1342264836,1342264896,0,1,60
20,2382,1462,1343127978,1343138833,0,2,10855
20,2382,1435,1343138833,1343138893,0,2,60
20,2383,1479,1343467358,1343467418,0,1,60
20,2384,1480,1343548928,1343548985,0,3,57
20,2384,1481,1343548985,1343549152,0,3,167
20,2384,1459,1343549152,1343549212,0,3,60
20,2385,1445,1343619998,1343639100,0,2,19102
20,2385,1482,1343639100,1343639160,0,2,60
20,2386,1483,1344226359,1344246812,0,2,20453
20,2386,1484,1344246812,1344246872,0,2,60
20,2387,1485,1344681832,1344681892,0,1,60
20,2388,1486,1344749084,1344757335,0,2,8251
20,2388,1487,1344757335,1344757395,0,2,60
20,2389,1488,1344815815,1344816296,0,2,481
20,2389,273,1344816296,1344816356,0,2,60
20,2390,1489,1344948638,1344948698,0,1,60
20,2391,1490,1345283029,1345291810,0,2,8781
20,2391,1491,1345291810,1345291870,0,2,60
20,2392,1492,1345457604,1345459986,0,3,2382
20,2392,1493,1345459986,1345460086,0,3,100
20,2392,1462,1345460086,1345460146,0,3,60
20,2393,1494,1347623158,1347623218,0,1,60
20,2394,555,1347702385,1347714349,0,2,11964
20,2394,1495,1347714349,1347714409,0,2,60
20,2395,1457,1347764693,1347768696,0,2,4003
20,2395,1496,1347768696,1347768756,0,2,60
20,2396,1497,1350107821,1350108965,0,2,1144
20,2396,1498,1350108965,1350109025,0,2,60
20,2397,1435,1350398714,1350398774,0,1,60
20,2398,1435,1351001635,1351001695,0,1,60
20,2399,1499,1351484399,1351484459,0,1,60
20,2400,1435,1351606359,1351608762,0,2,2403
20,2400,1485,1351608762,1351608822,0,2,60
20,2401,1500,1351738010,1351738070,0,1,60
20,2402,1501,1351854776,1351854836,0,1,60
20,2403,1435,1352198821,1352198881,0,1,60
20,2404,1502,1352294569,1352294629,0,1,60
20,2405,1503,1352603495,1352606529,0,4,3034
20,2405,1504,1352606529,1352612311,0,4,5782
20,2405,1505,1352612311,1352622675,0,4,10364
20,2405,1506,1352622675,1352622735,0,4,60
20,2406,1507,1352628599,1352628659,0,1,60
20,2407,1435,1352804528,1352804588,0,1,60
20,2408,1435,1353423059,1353423119,0,1,60
20,2409,1508,1353564539,1353570842,0,2,6303
20,2409,1469,1353570842,1353570902,0,2,60
20,2410,1509,1353633675,1353633735,0,1,60
20,2411,1510,1353836481,1353836541,0,1,60
20,2412,1435,1354012270,1354012330,0,1,60
20,2413,1435,1354629841,1354629901,0,1,60
20,2414,1508,1354862997,1354863029,0,2,32
20,2414,1511,1354863029,1354863089,0,2,60
20,2415,1512,1355394544,1355394604,0,1,60
20,2416,1513,1355561955,1355562015,0,1,60
20,2417,1514,1355890211,1355902987,0,2,12776
20,2417,1515,1355902987,1355903047,0,2,60
20,2418,1438,1356770965,1356775517,0,2,4552
20,2418,1516,1356775517,1356775577,0,2,60
20,2419,1438,1356945121,1356945181,0,1,60
20,2420,1435,1357384419,1357384479,0,1,60
20,2421,1438,1357453508,1357454757,0,2,1249
20,2421,1517,1357454757,1357454817,0,2,60
20,2422,1435,1357654616,1357654676,0,1,60
20,2423,1491,1357737332,1357737392,0,1,60
20,2424,1435,1357794550,1357794610,0,1,60
20,2425,1518,1358400261,1358400321,0,1,60
20,2426,1435,1358852188,1358852248,0,1,60
20,2427,1519,1359248715,1359248775,0,1,60
20,2428,1520,1359354980,1359355040,0,1,60
20,2429,1521,1359865833,1359868536,0,2,2703
20,2429,1522,1359868536,1359868596,0,2,60
20,2430,1435,1360075538,1360075598,0,1,60
20,2431,1523,1360199078,1360205295,0,2,6217
20,2431,1524,1360205295,1360205355,0,2,60
21,2432,1525,1360819109,1360823598,0,2,4489
21,2432,1106,1360823598,1360823658,0,2,60
21,2433,1526,1333493861,1333493921,0,1,60
21,2434,561,1333535869,1333536334,0,2,465
21,2434,1526,1333536334,1333536394,0,2,60
21,2435,1526,1333580175,1333580675,0,2,500
21,2435,561,1333580675,1333580735,0,2,60
21,2436,1527,1333623295,1333623355,0,1,60
21,2437,1526,1333862094,1333862119,0,3,25
21,2437,1527,1333862119,1333864085,0,3,1966
21,2437,1528,1333864085,1333864145,0,3,60
21,2438,1526,1333925391,1333925864,0,2,473
21,2438,561,1333925864,1333925924,0,2,60
21,2439,1528,1333969904,1333969964,0,1,60
21,2440,561,1334012694,1334012754,0,1,60
21,2441,561,1334054861,1334055728,0,3,867
21,2441,1526,1334055728,1334055760,0,3,32
21,2441,1529,1334055760,1334055820,0,3,60
21,2442,561,1334098414,1334098474,0,1,60
21,2443,561,1334140563,1334141438,0,3,875
21,2443,1526,1334141438,1334141473,0,3,35
21,2443,1528,1334141473,1334141533,0,3,60
21,2444,561,1334185306,1334185366,0,1,60
21,2445,561,1334228241,1334228684,0,3,443
21,2445,1526,1334228684,1334228937,0,3,253
21,2445,1528,1334228937,1334228997,0,3,60
21,2446,1526,1334270817,1334271483,0,2,666
21,2446,561,1334271483,1334271543,0,2,60
21,2447,561,1334319221,1334320008,0,3,787
21,2447,1526,1334320008,1334320054,0,3,46
21,2447,1530,1334320054,1334320114,0,3,60
21,2448,1526,1334399412,1334399982,0,4,570
21,2448,351,1334399982,1334401491,0,4,1509
21,2448,1531,1334401491,1334407871,0,4,6380
21,2448,1532,1334407871,1334407931,0,4,60
21,2449,1532,1334438681,1334442913,0,6,4232
21,2449,35,1334442913,1334443629,0,6,716
21,2449,284,1334443629,1334444252,0,6,623
21,2449,351,1334444252,1334444813,0,6,561
21,2449,1526,1334444813,1334444897,0,6,84
21,2449,1533,1334444897,1334444957,0,6,60
21,2450,561,1334572802,1334573902,0,3,1100
21,2450,1526,1334573902,1334573922,0,3,20
21,2450,1534,1334573922,1334573982,0,3,60
21,2451,23,1334659900,1334665561,0,3,5661
21,2451,1152,1334665561,1334667840,0,3,2279
21,2451,1526,1334667840,1334667900,0,3,60
21,2452,1526,1334702961,1334703471,0,2,510
21,2452,561,1334703471,1334703531,0,2,60
21,2453,1535,1334805190,1334807241,0,2,2051
21,2453,561,1334807241,1334807301,0,2,60
21,2454,561,1334831832,1334832362,0,4,530
21,2454,1526,1334832362,1334832732,0,4,370
21,2454,1526,1334832732,1334832754,0,4,22
21,2454,1536,1334832754,1334832814,0,4,60
21,2455,1526,1334875929,1334875989,0,1,60
21,2456,561,1334918233,1334918934,0,3,701
21,2456,1526,1334918934,1334918974,0,3,40
21,2456,1530,1334918974,1334919034,0,3,60
21,2457,1528,1334984365,1334984599,0,10,234
21,2457,1526,1334984599,1334984599,0,10,0
21,2457,1526,1334984599,1334986170,0,10,1571
21,2457,5,1334986170,1334986335,0,10,165
21,2457,8,1334986335,1334987653,0,10,1318
21,2457,736,1334987653,1334989813,0,10,2160
21,2457,26,1334989813,1334990111,0,10,298
21,2457,280,1334990111,1334991700,0,10,1589
21,2457,9,1334991700,1335003913,0,10,12213
21,2457,1537,1335003913,1335003973,0,10,60
21,2458,5,1335011493,1335013470,0,2,1977
21,2458,1526,1335013470,1335013530,0,2,60
21,2459,1526,1335075636,1335075696,0,1,60
21,2460,1526,1335135058,1335135118,0,1,60
21,2461,561,1335183136,1335183196,0,1,60
21,2462,1526,1335221597,1335222271,0,2,674
21,2462,561,1335222271,1335222331,0,2,60
21,2463,561,1335263844,1335264401,0,3,557
21,2463,1526,1335264401,1335264832,0,3,431
21,2463,1528,1335264832,1335264892,0,3,60
21,2464,561,1335308302,1335308362,0,1,60
21,2465,561,1335350164,1335351682,0,3,1518
21,2465,1526,1335351682,1335351786,0,3,104
21,2465,1538,1335351786,1335351846,0,3,60
21,2466,561,1335394683,1335394743,0,1,60
21,2467,561,1335436706,1335437155,0,3,449
21,2467,1526,1335437155,1335437391,0,3,236
21,2467,1528,1335437391,1335437451,0,3,60
21,2468,561,1335523081,1335523584,0,2,503
21,2468,1526,1335523584,1335523644,0,2,60
21,2469,1526,1335604835,1335606869,0,4,2034
21,2469,5,1335606869,1335607525,0,4,656
21,2469,619,1335607525,1335608341,0,4,816
21,2469,1539,1335608341,1335608401,0,4,60
21,2470,1539,1335642041,1335642441,0,5,400
21,2470,619,1335642441,1335643366,0,5,925
21,2470,5,1335643366,1335645086,0,5,1720
21,2470,1526,1335645086,1335645292,0,5,206
21,2470,1536,1335645292,1335645352,0,5,60
21,2471,1526,1335936687,1335936747,0,1,60
21,2472,1526,1336048843,1336048903,0,1,60
21,2473,1526,1336128337,1336128397,0,1,60
21,2474,1526,1336201525,1336201551,0,2,26
21,2474,1540,1336201551,1336201611,0,2,60
21,2475,1526,1336344777,1336345588,0,2,811
21,2475,561,1336345588,1336345648,0,2,60
21,2476,5,1336388672,1336390297,0,3,1625
21,2476,1526,1336390297,1336390774,0,3,477
21,2476,1528,1336390774,1336390834,0,3,60
21,2477,561,1336476452,1336477088,0,3,636
21,2477,1526,1336477088,1336477585,0,3,497
21,2477,1528,1336477585,1336477645,0,3,60
21,2478,561,1336517934,1336517994,0,1,60
21,2479,561,1336559840,1336560524,0,3,684
21,2479,1526,1336560524,1336560543,0,3,19
21,2479,1530,1336560543,1336560603,0,3,60
21,2480,1526,1336607708,1336607768,0,1,60
21,2481,1526,1336690228,1336690663,0,2,435
21,2481,561,1336690663,1336690723,0,2,60
21,2482,561,1336739623,1336740209,0,3,586
21,2482,1526,1336740209,1336740506,0,3,297
21,2482,1530,1336740506,1336740566,0,3,60
21,2483,1526,1336794976,1336796804,0,7,1828
21,2483,5,1336796804,1336797779,0,7,975
21,2483,20,1336797779,1336799356,0,7,1577
21,2483,1541,1336799356,1336809633,0,7,10277
21,2483,5,1336809633,1336811132,0,7,1499
21,2483,619,1336811132,1336812466,0,7,1334
21,2483,1539,1336812466,1336812526,0,7,60
21,2484,619,1336855454,1336858349,0,3,2895
21,2484,1526,1336858349,1336858470,0,3,121
21,2484,1535,1336858470,1336858530,0,3,60
21,2485,1542,1336889305,1336889365,0,1,60
21,2486,1526,1336949813,1336950253,0,2,440
21,2486,561,1336950253,1336950313,0,2,60
21,2487,5,1336991085,1336991127,0,4,42
21,2487,1152,1336991127,1337002558,0,4,11431
21,2487,1152,1337002558,1337004388,0,4,1830
21,2487,1526,1337004388,1337004448,0,4,60
21,2488,1526,1337036221,1337036808,0,2,587
21,2488,561,1337036808,1337036868,0,2,60
21,2489,561,1337082441,1337083033,0,3,592
21,2489,1526,1337083033,1337083330,0,3,297
21,2489,1534,1337083330,1337083390,0,3,60
21,2490,1526,1337122426,1337122486,0,1,60
21,2491,561,1337164603,1337165148,0,3,545
21,2491,1526,1337165148,1337165176,0,3,28
21,2491,1543,1337165176,1337165236,0,3,60
21,2492,1526,1337209050,1337209488,0,2,438
21,2492,561,1337209488,1337209548,0,2,60
21,2493,561,1337251154,1337251612,0,2,458
21,2493,1526,1337251612,1337251672,0,2,60
21,2494,1526,1337396622,1337396673,0,3,51
21,2494,1540,1337396673,1337396866,0,3,193
21,2494,1530,1337396866,1337396926,0,3,60
21,2495,561,1337602292,1337603063,0,3,771
21,2495,1526,1337603063,1337603159,0,3,96
21,2495,1544,1337603159,1337603219,0,3,60
21,2496,1526,1337641025,1337641460,0,2,435
21,2496,561,1337641460,1337641520,0,2,60
21,2497,561,1337686026,1337686901,0,3,875
21,2497,1526,1337686901,1337686921,0,3,20
21,2497,1534,1337686921,1337686981,0,3,60
21,2498,1526,1337813842,1337814317,0,2,475
21,2498,561,1337814317,1337814377,0,2,60
21,2499,561,1337947163,1337947559,0,3,396
21,2499,1526,1337947559,1337947877,0,3,318
21,2499,1545,1337947877,1337947937,0,3,60
21,2500,351,1338072571,1338073164,0,2,593
21,2500,1526,1338073164,1338073224,0,2,60
21,2501,561,1338159900,1338159960,0,1,60
21,2502,561,1338201426,1338202138,0,3,712
21,2502,1526,1338202138,1338202192,0,3,54
21,2502,1529,1338202192,1338202252,0,3,60
21,2503,1526,1338245691,1338246407,0,2,716
21,2503,561,1338246407,1338246467,0,2,60
21,2504,561,1338291057,1338291402,0,3,345
21,2504,1526,1338291402,1338291701,0,3,299
21,2504,1546,1338291701,1338291761,0,3,60
21,2505,1526,1338331833,1338332288,0,2,455
21,2505,561,1338332288,1338332348,0,2,60
21,2506,561,1338552699,1338553257,0,2,558
21,2506,1526,1338553257,1338553317,0,2,60
21,2507,1526,1338698793,1338698853,0,1,60
21,2508,561,1338764280,1338764340,0,1,60
21,2509,561,1338809234,1338809923,0,3,689
21,2509,1526,1338809923,1338809958,0,3,35
21,2509,1536,1338809958,1338810018,0,3,60
21,2510,1526,1338849887,1338850604,0,2,717
21,2510,561,1338850604,1338850664,0,2,60
21,2511,561,1338895642,1338896073,0,3,431
21,2511,1526,1338896073,1338896104,0,3,31
21,2511,1536,1338896104,1338896164,0,3,60
21,2512,561,1338979136,1338979611,0,3,475
21,2512,1526,1338979611,1338980015,0,3,404
21,2512,1534,1338980015,1338980075,0,3,60
21,2513,1526,1339022735,1339022795,0,1,60
21,2514,561,1339074780,1339075514,0,3,734
21,2514,1526,1339075514,1339075531,0,3,17
21,2514,1530,1339075531,1339075591,0,3,60
21,2515,1526,1339109402,1339109904,0,2,502
21,2515,561,1339109904,1339109964,0,2,60
21,2516,561,1339158864,1339159477,0,2,613
21,2516,1526,1339159477,1339159537,0,2,60
21,2517,1526,1339194433,1339194862,0,2,429
21,2517,561,1339194862,1339194922,0,2,60
21,2518,28,1339240665,1339241811,0,3,1146
21,2518,1526,1339241811,1339242251,0,3,440
21,2518,1536,1339242251,1339242311,0,3,60
21,2519,1526,1339299700,1339301434,0,7,1734
21,2519,5,1339301434,1339301622,0,7,188
21,2519,1547,1339301622,1339302085,0,7,463
21,2519,8,1339302085,1339303881,0,7,1796
21,2519,5,1339303881,1339305261,0,7,1380
21,2519,1526,1339305261,1339305410,0,7,149
21,2519,1548,1339305410,1339305470,0,7,60
21,2520,1526,1339347592,1339368490,0,2,20898
21,2520,1526,1339368490,1339368550,0,2,60
21,2521,561,1339369298,1339369358,0,1,60
21,2522,561,1339418069,1339418642,0,2,573
21,2522,1526,1339418642,1339418702,0,2,60
21,2523,561,1339455738,1339455798,0,1,60
21,2524,561,1339498780,1339499527,0,3,747
21,2524,1526,1339499527,1339500029,0,3,502
21,2524,1534,1339500029,1339500089,0,3,60
21,2525,1526,1339543109,1339543169,0,1,60
21,2526,561,1339590839,1339591514,0,3,675
21,2526,1526,1339591514,1339591769,0,3,255
21,2526,1536,1339591769,1339591829,0,3,60
21,2527,1526,1339627793,1339628324,0,2,531
21,2527,561,1339628324,1339628384,0,2,60
21,2528,12,1339755204,1339756352,0,5,1148
21,2528,434,1339756352,1339757096,0,5,744
21,2528,1549,1339757096,1339769185,0,5,12089
21,2528,1526,1339769185,1339769204,0,5,19
21,2528,1536,1339769204,1339769264,0,5,60
21,2529,1526,1339902365,1339902897,0,11,532
21,2529,351,1339902897,1339903528,0,11,631
21,2529,287,1339903528,1339903698,0,11,170
21,2529,1550,1339903698,1339905129,0,11,1431
21,2529,1551,1339905129,1339914648,0,11,9519
21,2529,1552,1339914648,1339917278,0,11,2630
21,2529,1553,1339917278,1339921832,0,11,4554
21,2529,287,1339921832,1339922499,0,11,667
21,2529,351,1339922499,1339922553,0,11,54
21,2529,1451,1339922553,1339923206,0,11,653
21,2529,1526,1339923206,1339923266,0,11,60
21,2530,1528,1339924056,1339924116,0,1,60
21,2531,561,1340102238,1340103065,0,3,827
21,2531,1526,1340103065,1340103328,0,3,263
21,2531,1534,1340103328,1340103388,0,3,60
21,2532,561,1340233050,1340233110,0,1,60
21,2533,566,1340276509,1340276747,0,2,238
21,2533,1526,1340276747,1340276807,0,2,60
21,2534,1526,1340750864,1340750924,0,1,60
21,2535,561,1340793438,1340794034,0,3,596
21,2535,1526,1340794034,1340794058,0,3,24
21,2535,1534,1340794058,1340794118,0,3,60
21,2536,1526,1341118371,1341119760,0,5,1389
21,2536,5,1341119760,1341119899,0,5,139
21,2536,8,1341119899,1341120792,0,5,893
21,2536,29,1341120792,1341121574,0,5,782
21,2536,1320,1341121574,1341121634,0,5,60
21,2537,1528,1341232462,1341232522,0,1,60
21,2538,561,1341270079,1341270139,0,1,60
21,2539,561,1341311745,1341312523,0,3,778
21,2539,1526,1341312523,1341312859,0,3,336
21,2539,1528,1341312859,1341312919,0,3,60
21,2540,1526,1341356228,1341356288,0,1,60
21,2541,561,1341398336,1341399076,0,3,740
21,2541,1526,1341399076,1341399094,0,3,18
21,2541,1534,1341399094,1341399154,0,3,60
21,2542,1526,1341442436,1341442953,0,2,517
21,2542,561,1341442953,1341443013,0,2,60
21,2543,561,1341484644,1341485128,0,4,484
21,2543,1526,1341485128,1341485296,0,4,168
21,2543,1548,1341485296,1341486126,0,4,830
21,2543,1536,1341486126,1341486186,0,4,60
21,2544,1526,1341528469,1341528529,0,1,60
21,2545,561,1341568554,1341569214,0,3,660
21,2545,1526,1341569214,1341569229,0,3,15
21,2545,1536,1341569229,1341569289,0,3,60
21,2546,1526,1341644188,1341644210,0,2,22
21,2546,1545,1341644210,1341644270,0,2,60
21,2547,1526,1341736138,1341736305,0,2,167
21,2547,1530,1341736305,1341736365,0,2,60
21,2548,561,1341830304,1341830742,0,3,438
21,2548,1526,1341830742,1341830919,0,3,177
21,2548,1548,1341830919,1341830979,0,3,60
21,2549,1526,1341873924,1341873984,0,1,60
21,2550,1526,1341960710,1341961320,0,2,610
21,2550,561,1341961320,1341961380,0,2,60
21,2551,561,1342001670,1342002176,0,3,506
21,2551,1526,1342002176,1342002523,0,3,347
21,2551,1534,1342002523,1342002583,0,3,60
21,2552,1526,1342046760,1342047345,0,2,585
21,2552,561,1342047345,1342047405,0,2,60
21,2553,12,1342071387,1342071823,0,7,436
21,2553,14,1342071823,1342072144,0,7,321
21,2553,15,1342072144,1342081743,0,7,9599
21,2553,14,1342081743,1342084637,0,7,2894
21,2553,351,1342084637,1342085220,0,7,583
21,2553,1526,1342085220,1342085406,0,7,186
21,2553,1548,1342085406,1342085466,0,7,60
21,2554,561,1342175869,1342176366,0,8,497
21,2554,1526,1342176366,1342182228,0,8,5862
21,2554,1526,1342182228,1342183370,0,8,1142
21,2554,351,1342183370,1342184449,0,8,1079
21,2554,1554,1342184449,1342185124,0,8,675
21,2554,1555,1342185124,1342185297,0,8,173
21,2554,1556,1342185297,1342189447,0,8,4150
21,2554,1555,1342189447,1342189507,0,8,60
21,2555,1557,1342214224,1342215776,0,4,1552
21,2555,351,1342215776,1342216405,0,4,629
21,2555,1526,1342216405,1342220018,0,4,3613
21,2555,21,1342220018,1342220078,0,4,60
21,2556,21,1342407357,1342408917,0,2,1560
21,2556,1526,1342408917,1342408977,0,2,60
21,2557,1526,1342478818,1342479567,0,2,749
21,2557,561,1342479567,1342479627,0,2,60
21,2558,561,1342521342,1342521961,0,3,619
21,2558,1526,1342521961,1342522087,0,3,126
21,2558,1543,1342522087,1342522147,0,3,60
21,2559,1526,1342565155,1342565215,0,1,60
21,2560,561,1343126469,1343127239,0,2,770
21,2560,1526,1343127239,1343127299,0,2,60
21,2561,1526,1343343427,1343343487,0,1,60
21,2562,1558,1343455309,1343461947,0,6,6638
21,2562,5,1343461947,1343462756,0,6,809
21,2562,1559,1343462756,1343463642,0,6,886
21,2562,770,1343463642,1343470399,0,6,6757
21,2562,5,1343470399,1343472364,0,6,1965
21,2562,1526,1343472364,1343472424,0,6,60
21,2563,1526,1343602161,1343602221,0,1,60
21,2564,1543,1343658830,1343658856,0,2,26
21,2564,1526,1343658856,1343658916,0,2,60
21,2565,1538,1344150964,1344151024,0,1,60
21,2566,1526,1344205394,1344205912,0,2,518
21,2566,561,1344205912,1344205972,0,2,60
21,2567,5,1344248217,1344250457,0,2,2240
21,2567,1526,1344250457,1344250517,0,2,60
21,2568,5,1344507184,1344508841,0,2,1657
21,2568,1526,1344508841,1344508901,0,2,60
21,2569,561,1344551526,1344551586,0,1,60
21,2570,52,1344940169,1344941452,0,3,1283
21,2570,5,1344941452,1344943406,0,3,1954
21,2570,1526,1344943406,1344943466,0,3,60
21,2571,561,1344983528,1344983588,0,1,60
21,2572,561,1345156324,1345156384,0,1,60
21,2573,1536,1345270680,1345270806,0,3,126
21,2573,1526,1345270806,1345271339,0,3,533
21,2573,1529,1345271339,1345271399,0,3,60
21,2574,1526,1345414999,1345415513,0,2,514
21,2574,561,1345415513,1345415573,0,2,60
21,2575,5,1345457877,1345459802,0,3,1925
21,2575,1526,1345459802,1345460073,0,3,271
21,2575,1534,1345460073,1345460133,0,3,60
21,2576,5,1346840169,1346842128,0,3,1959
21,2576,1526,1346842128,1346842190,0,3,62
21,2576,1538,1346842190,1346842250,0,3,60
21,2577,1560,1347531942,1347532398,0,5,456
21,2577,5,1347532398,1347534459,0,5,2061
21,2577,5,1347534459,1347534927,0,5,468
21,2577,21,1347534927,1347538866,0,5,3939
21,2577,1561,1347538866,1347538926,0,5,60
21,2578,1526,1347626832,1347627650,0,3,818
21,2578,351,1347627650,1347629489,0,3,1839
21,2578,35,1347629489,1347629549,0,3,60
21,2579,1562,1349686525,1349689421,0,4,2896
21,2579,5,1349689421,1349691034,0,4,1613
21,2579,1526,1349691034,1349691057,0,4,23
21,2579,1536,1349691057,1349691117,0,4,60
21,2580,1526,1349962569,1349962629,0,1,60
21,2581,1526,1349995761,1349995821,0,1,60
21,2582,5,1350037245,1350037467,0,5,222
21,2582,20,1350037467,1350038914,0,5,1447
21,2582,1563,1350038914,1350039793,0,5,879
21,2582,5,1350039793,1350041895,0,5,2102
21,2582,1536,1350041895,1350041955,0,5,60
21,2583,1526,1350077621,1350079223,0,2,1602
21,2583,5,1350079223,1350079283,0,2,60
21,2584,1564,1350129862,1350135890,0,2,6028
21,2584,5,1350135890,1350135950,0,2,60
21,2585,5,1350382819,1350383261,0,7,442
21,2585,230,1350383261,1350383948,0,7,687
21,2585,1565,1350383948,1350384964,0,7,1016
21,2585,25,1350384964,1350385263,0,7,299
21,2585,5,1350385263,1350386818,0,7,1555
21,2585,1526,1350386818,1350387142,0,7,324
21,2585,1536,1350387142,1350387202,0,7,60
21,2586,561,1350470256,1350470729,0,4,473
21,2586,1526,1350470729,1350471075,0,4,346
21,2586,1536,1350471075,1350471171,0,4,96
21,2586,1534,1350471171,1350471231,0,4,60
21,2587,561,1350601129,1350604580,0,2,3451
21,2587,561,1350604580,1350604640,0,2,60
21,2588,1526,1350647571,1350647609,0,2,38
21,2588,1536,1350647609,1350647669,0,2,60
21,2589,561,1350902212,1350902763,0,4,551
21,2589,1526,1350902763,1350903037,0,4,274
21,2589,1536,1350903037,1350903271,0,4,234
21,2589,1534,1350903271,1350903331,0,4,60
21,2590,1526,1351118925,1351119456,0,2,531
21,2590,561,1351119456,1351119516,0,2,60
21,2591,561,1351161415,1351161989,0,3,574
21,2591,1526,1351161989,1351162181,0,3,192
21,2591,1545,1351162181,1351162241,0,3,60
21,2592,1526,1351205378,1351205954,0,2,576
21,2592,561,1351205954,1351206014,0,2,60
21,2593,5,1351247115,1351247434,0,5,319
21,2593,20,1351247434,1351251667,0,5,4233
21,2593,8,1351251667,1351252959,0,5,1292
21,2593,5,1351252959,1351254716,0,5,1757
21,2593,1526,1351254716,1351254776,0,5,60
21,2594,5,1351308731,1351309355,0,10,624
21,2594,1566,1351309355,1351309927,0,10,572
21,2594,26,1351309927,1351313339,0,10,3412
21,2594,619,1351313339,1351313554,0,10,215
21,2594,1567,1351313554,1351320410,0,10,6856
21,2594,1539,1351320410,1351320416,0,10,6
21,2594,619,1351320416,1351321464,0,10,1048
21,2594,5,1351321464,1351323093,0,10,1629
21,2594,1526,1351323093,1351323360,0,10,267
21,2594,1536,1351323360,1351323420,0,10,60
21,2595,1526,1351398546,1351400108,0,7,1562
21,2595,5,1351400108,1351400229,0,7,121
21,2595,20,1351400229,1351404210,0,7,3981
21,2595,1320,1351404210,1351405119,0,7,909
21,2595,16,1351405119,1351405945,0,7,826
21,2595,5,1351405945,1351407600,0,7,1655
21,2595,1526,1351407600,1351407660,0,7,60
21,2596,1526,1351464514,1351465066,0,2,552
21,2596,561,1351465066,1351465126,0,2,60
21,2597,5,1351506046,1351506746,0,4,700
21,2597,1568,1351506746,1351509241,0,4,2495
21,2597,25,1351509241,1351511333,0,4,2092
21,2597,1536,1351511333,1351511393,0,4,60
21,2598,1526,1351637633,1351638145,0,2,512
21,2598,561,1351638145,1351638205,0,2,60
21,2599,5,1351678816,1351679372,0,4,556
21,2599,1569,1351679372,1351679751,0,4,379
21,2599,1292,1351679751,1351683135,0,4,3384
21,2599,1526,1351683135,1351683195,0,4,60
21,2600,561,1351766139,1351766805,0,2,666
21,2600,1526,1351766805,1351766865,0,2,60
21,2601,1526,1351810212,1351810272,0,1,60
21,2602,1526,1351853163,1351853308,0,3,145
21,2602,1548,1351853308,1351854703,0,3,1395
21,2602,1570,1351854703,1351854763,0,3,60
21,2603,561,1352111800,1352112583,0,3,783
21,2603,1526,1352112583,1352112587,0,3,4
21,2603,1545,1352112587,1352112647,0,3,60
21,2604,1526,1352242157,1352242736,0,2,579
21,2604,561,1352242736,1352242796,0,2,60
21,2605,561,1352288775,1352289449,0,3,674
21,2605,1526,1352289449,1352289470,0,3,21
21,2605,1545,1352289470,1352289530,0,3,60
21,2606,561,1352371047,1352371107,0,1,60
21,2607,29,1352456963,1352458268,0,7,1305
21,2607,25,1352458268,1352458635,0,7,367
21,2607,1566,1352458635,1352458981,0,7,346
21,2607,8,1352458981,1352459910,0,7,929
21,2607,1571,1352459910,1352462855,0,7,2945
21,2607,5,1352462855,1352464614,0,7,1759
21,2607,1526,1352464614,1352464674,0,7,60
21,2608,1526,1352674208,1352674268,0,1,60
21,2609,561,1352716606,1352717173,0,4,567
21,2609,1526,1352717173,1352717322,0,4,149
21,2609,1548,1352717322,1352718876,0,4,1554
21,2609,1536,1352718876,1352718936,0,4,60
21,2610,1526,1352760602,1352761057,0,2,455
21,2610,561,1352761057,1352761117,0,2,60
21,2611,561,1352803036,1352803715,0,3,679
21,2611,1526,1352803715,1352803752,0,3,37
21,2611,1572,1352803752,1352803812,0,3,60
21,2612,21,1353059976,1353062580,0,3,2604
21,2612,5,1353062580,1353065496,0,3,2916
21,2612,1573,1353065496,1353065556,0,3,60
21,2613,541,1353137352,1353137750,0,6,398
21,2613,5,1353137750,1353139664,0,6,1914
21,2613,1526,1353139664,1353139683,0,6,19
21,2613,1536,1353139683,1353153990,0,6,14307
21,2613,619,1353153990,1353157984,0,6,3994
21,2613,1539,1353157984,1353158044,0,6,60
21,2614,619,1353204634,1353205684,0,10,1050
21,2614,5,1353205684,1353209486,0,10,3802
21,2614,1574,1353209486,1353209509,0,10,23
21,2614,248,1353209509,1353210189,0,10,680
21,2614,5,1353210189,1353210920,0,10,731
21,2614,297,1353210920,1353220238,0,10,9318
21,2614,297,1353220238,1353220256,0,10,18
21,2614,1575,1353220256,1353223943,0,10,3687
21,2614,5,1353223943,1353225269,0,10,1326
21,2614,8,1353225269,1353225329,0,10,60
21,2615,770,1353228338,1353234601,0,3,6263
21,2615,1526,1353234601,1353234706,0,3,105
21,2615,1536,1353234706,1353234766,0,3,60
21,2616,1526,1353365568,1353365628,0,1,60
21,2617,561,1353407862,1353408373,0,3,511
21,2617,1526,1353408373,1353408516,0,3,143
21,2617,1548,1353408516,1353408576,0,3,60
21,2618,561,1353494204,1353494893,0,2,689
21,2618,1526,1353494893,1353494953,0,2,60
21,2619,35,1353755500,1353756711,0,5,1211
21,2619,5,1353756711,1353757094,0,5,383
21,2619,1566,1353757094,1353757310,0,5,216
21,2619,5,1353757310,1353759134,0,5,1824
21,2619,1526,1353759134,1353759194,0,5,60
21,2620,1526,1353815554,1353817228,0,6,1674
21,2620,5,1353817228,1353821489,0,6,4261
21,2620,1576,1353821489,1353822933,0,6,1444
21,2620,5,1353822933,1353824012,0,6,1079
21,2620,351,1353824012,1353824695,0,6,683
21,2620,1526,1353824695,1353824755,0,6,60
21,2621,1526,1353884151,1353884211,0,1,60
21,2622,561,1353926249,1353926785,0,3,536
21,2622,1526,1353926785,1353926826,0,3,41
21,2622,1570,1353926826,1353926886,0,3,60
21,2623,1526,1353970207,1353970699,0,2,492
21,2623,561,1353970699,1353970759,0,2,60
21,2624,561,1354013253,1354013719,0,2,466
21,2624,1526,1354013719,1354013779,0,2,60
21,2625,1526,1354056879,1354056939,0,1,60
21,2626,561,1354143497,1354143557,0,1,60
21,2627,233,1354321702,1354328214,0,4,6512
21,2627,233,1354328214,1354329431,0,4,1217
21,2627,1577,1354329431,1354330664,0,4,1233
21,2627,5,1354330664,1354330724,0,4,60
21,2628,1578,1354435228,1354435288,0,1,60
21,2629,1526,1354538719,1354538775,0,2,56
21,2629,1530,1354538775,1354538835,0,2,60
21,2630,1526,1354575012,1354575072,0,1,60
21,2631,561,1354617555,1354617615,0,1,60
21,2632,1526,1354661357,1354661884,0,2,527
21,2632,561,1354661884,1354661944,0,2,60
21,2633,561,1354709490,1354710142,0,3,652
21,2633,1526,1354710142,1354710272,0,3,130
21,2633,1543,1354710272,1354710332,0,3,60
21,2634,561,1354793339,1354794049,0,2,710
21,2634,1535,1354794049,1354794109,0,2,60
21,2635,561,1354834732,1354834792,0,1,60
21,2636,1530,1354877675,1354877735,0,1,60
21,2637,1579,1354922847,1354924160,0,7,1313
21,2637,1401,1354924160,1354926915,0,7,2755
21,2637,5,1354926915,1354927502,0,7,587
21,2637,1560,1354927502,1354933727,0,7,6225
21,2637,1560,1354933727,1354935548,0,7,1821
21,2637,1526,1354935548,1354935748,0,7,200
21,2637,1535,1354935748,1354935808,0,7,60
21,2638,1526,1355179871,1355180275,0,2,404
21,2638,561,1355180275,1355180335,0,2,60
21,2639,5,1355220835,1355220895,0,1,60
21,2640,1580,1355274550,1355274610,0,1,60
21,2641,1526,1355358296,1355358356,0,1,60
21,2642,5,1355480282,1355482119,0,3,1837
21,2642,1526,1355482119,1355482150,0,3,31
21,2642,1548,1355482150,1355482210,0,3,60
21,2643,1526,1355551985,1355552045,0,1,60
21,2644,561,1355698695,1355698755,0,1,60
21,2645,5,1355739303,1355741296,0,2,1993
21,2645,1535,1355741296,1355741356,0,2,60
21,2646,1526,1355784396,1355786149,0,2,1753
21,2646,5,1355786149,1355786209,0,2,60
21,2647,1581,1355825255,1355833089,0,5,7834
21,2647,1582,1355833089,1355837213,0,5,4124
21,2647,35,1355837213,1355838995,0,5,1782
21,2647,1526,1355838995,1355839178,0,5,183
21,2647,1570,1355839178,1355839238,0,5,60
21,2648,1535,1355884405,1355904749,0,2,20344
21,2648,1526,1355904749,1355904809,0,2,60
21,2649,5,1355906425,1355908419,0,3,1994
21,2649,1581,1355908419,1355908549,0,3,130
21,2649,1583,1355908549,1355908609,0,3,60
21,2650,1581,1355958066,1355958126,0,1,60
21,2651,619,1356091932,1356099325,0,2,7393
21,2651,695,1356099325,1356099385,0,2,60
21,2652,1584,1356151745,1356160238,0,6,8493
21,2652,695,1356160238,1356165516,0,6,5278
21,2652,5,1356165516,1356166571,0,6,1055
21,2652,695,1356166571,1356166582,0,6,11
21,2652,1585,1356166582,1356173042,0,6,6460
21,2652,695,1356173042,1356173102,0,6,60
21,2653,1586,1356194408,1356194468,0,1,60
21,2654,1587,1356232463,1356232474,0,3,11
21,2654,1588,1356232474,1356233805,0,3,1331
21,2654,5,1356233805,1356233865,0,3,60
21,2655,1581,1356602241,1356602301,0,1,60
21,2656,1581,1356648398,1356648458,0,1,60
21,2657,1581,1356688394,1356688454,0,1,60
21,2658,1539,1356946607,1356946667,0,1,60
21,2659,1589,1356983058,1356990691,0,2,7633
21,2659,1539,1356990691,1356990751,0,2,60
21,2660,695,1357298441,1357298818,0,3,377
21,2660,619,1357298818,1357301583,0,3,2765
21,2660,1539,1357301583,1357301643,0,3,60
21,2661,5,1357559610,1357559670,0,1,60
21,2662,1581,1357638715,1357640207,0,2,1492
21,2662,1590,1357640207,1357640267,0,2,60
21,2663,1581,1357725536,1357725596,0,1,60
21,2664,1581,1357824911,1357824971,0,1,60
21,2665,1581,1357905696,1357905756,0,1,60
21,2666,1581,1357961781,1357965767,0,5,3986
21,2666,16,1357965767,1357969072,0,5,3305
21,2666,1566,1357969072,1357970721,0,5,1649
21,2666,233,1357970721,1357972715,0,5,1994
21,2666,1581,1357972715,1357972775,0,5,60
21,2667,1581,1358201897,1358201957,0,1,60
21,2668,1581,1358253712,1358253772,0,1,60
21,2669,1581,1358850626,1358850713,0,3,87
21,2669,1591,1358850713,1358850731,0,3,18
21,2669,1592,1358850731,1358850791,0,3,60
21,2670,1539,1359272515,1359272575,0,1,60
21,2671,1581,1359345637,1359345697,0,1,60
21,2672,5,1359370674,1359378925,0,3,8251
21,2672,1593,1359378925,1359379215,0,3,290
21,2672,233,1359379215,1359379275,0,3,60
21,2673,1581,1359413755,1359413815,0,1,60
21,2674,1581,1359500030,1359500090,0,1,60
21,2675,1581,1359586509,1359586569,0,1,60
21,2676,1581,1359673134,1359673194,0,1,60
21,2677,695,1359695031,1359695220,0,9,189
21,2677,1585,1359695220,1359696803,0,9,1583
21,2677,1586,1359696803,1359698483,0,9,1680
21,2677,1588,1359698483,1359699693,0,9,1210
21,2677,5,1359699693,1359700616,0,9,923
21,2677,1576,1359700616,1359701710,0,9,1094
21,2677,1566,1359701710,1359701920,0,9,210
21,2677,8,1359701920,1359704611,0,9,2691
21,2677,1581,1359704611,1359704671,0,9,60
21,2678,1581,1359932080,1359932140,0,1,60
21,2679,1581,1359975261,1359975269,0,2,8
21,2679,1594,1359975269,1359975329,0,2,60
21,2680,1581,1360019294,1360019354,0,1,60
21,2681,1581,1360208162,1360208222,0,1,60
21,2682,1581,1360277829,1360277889,0,1,60
21,2683,1581,1360316648,1360326052,0,3,9404
21,2683,1595,1360326052,1360326080,0,3,28
21,2683,1596,1360326080,1360326140,0,3,60
21,2684,1581,1360623835,1360623895,0,1,60
21,2685,1581,1360662252,1360662543,0,2,291
21,2685,1592,1360662543,1360662603,0,2,60
21,2686,50,1360767382,1360767442,0,1,60
21,2687,1581,1360796155,1360796215,0,1,60
22,2688,1581,1360833912,1360833972,0,1,60
22,2689,1597,1334710573,1334710599,0,2,26
22,2689,1598,1334710599,1334710659,0,2,60
22,2690,1599,1334967300,1334967323,0,5,23
22,2690,1600,1334967323,1334967341,0,5,18
22,2690,1601,1334967341,1334967362,0,5,21
22,2690,1602,1334967362,1334972900,0,5,5538
22,2690,1603,1334972900,1334972960,0,5,60
22,2691,1604,1335054658,1335055105,0,23,447
22,2691,1605,1335055105,1335056886,0,23,1781
22,2691,35,1335056886,1335062979,0,23,6093
22,2691,1606,1335062979,1335062997,0,23,18
22,2691,1321,1335062997,1335063090,0,23,93
22,2691,1607,1335063090,1335063254,0,23,164
22,2691,1608,1335063254,1335064705,0,23,1451
22,2691,1609,1335064705,1335064808,0,23,103
22,2691,1610,1335064808,1335065017,0,23,209
22,2691,1611,1335065017,1335065058,0,23,41
22,2691,1612,1335065058,1335066125,0,23,1067
22,2691,1613,1335066125,1335066159,0,23,34
22,2691,1614,1335066159,1335066403,0,23,244
22,2691,1615,1335066403,1335066482,0,23,79
22,2691,1616,1335066482,1335066519,0,23,37
22,2691,1617,1335066519,1335068652,0,23,2133
22,2691,1618,1335068652,1335068695,0,23,43
22,2691,1619,1335068695,1335068726,0,23,31
22,2691,1620,1335068726,1335073215,0,23,4489
22,2691,1621,1335073215,1335073323,0,23,108
22,2691,1622,1335073323,1335074903,0,23,1580
22,2691,1623,1335074903,1335075321,0,23,418
22,2691,866,1335075321,1335075381,0,23,60
22,2692,1624,1335076926,1335079815,0,2,2889
22,2692,1625,1335079815,1335079875,0,2,60
22,2693,1626,1335350791,1335350824,0,2,33
22,2693,1627,1335350824,1335350884,0,2,60
22,2694,1628,1335574826,1335577532,0,20,2706
22,2694,1629,1335577532,1335578041,0,20,509
22,2694,1630,1335578041,1335578121,0,20,80
22,2694,1631,1335578121,1335579751,0,20,1630
22,2694,1632,1335579751,1335579977,0,20,226
22,2694,1633,1335579977,1335582030,0,20,2053
22,2694,1634,1335582030,1335582099,0,20,69
22,2694,1635,1335582099,1335582459,0,20,360
22,2694,1636,1335582459,1335583073,0,20,614
22,2694,1637,1335583073,1335583569,0,20,496
22,2694,1638,1335583569,1335585179,0,20,1610
22,2694,1639,1335585179,1335586623,0,20,1444
22,2694,1640,1335586623,1335586862,0,20,239
22,2694,1641,1335586862,1335593100,0,20,6238
22,2694,1642,1335593100,1335593667,0,20,567
22,2694,1643,1335593667,1335593717,0,20,50
22,2694,1644,1335593717,1335593983,0,20,266
22,2694,1645,1335593983,1335595511,0,20,1528
22,2694,181,1335595511,1335596272,0,20,761
22,2694,1646,1335596272,1335596332,0,20,60
22,2695,1647,1335597069,1335597161,0,19,92
22,2695,1648,1335597161,1335597380,0,19,219
22,2695,1649,1335597380,1335597573,0,19,193
22,2695,1650,1335597573,1335597735,0,19,162
22,2695,1651,1335597735,1335597915,0,19,180
22,2695,1652,1335597915,1335597944,0,19,29
22,2695,1653,1335597944,1335598660,0,19,716
22,2695,1654,1335598660,1335598839,0,19,179
22,2695,1655,1335598839,1335599167,0,19,328
22,2695,1656,1335599167,1335601779,0,19,2612
22,2695,1657,1335601779,1335601789,0,19,10
22,2695,1658,1335601789,1335601842,0,19,53
22,2695,1659,1335601842,1335602420,0,19,578
22,2695,1660,1335602420,1335603027,0,19,607
22,2695,1661,1335603027,1335604105,0,19,1078
22,2695,1662,1335604105,1335605175,0,19,1070
22,2695,1663,1335605175,1335605427,0,19,252
22,2695,1664,1335605427,1335606281,0,19,854
22,2695,1665,1335606281,1335606341,0,19,60
22,2696,865,1336036873,1336038193,0,17,1320
22,2696,1666,1336038193,1336039181,0,17,988
22,2696,1667,1336039181,1336039197,0,17,16
22,2696,1668,1336039197,1336040072,0,17,875
22,2696,1669,1336040072,1336040105,0,17,33
22,2696,1670,1336040105,1336040127,0,17,22
22,2696,1671,1336040127,1336042037,0,17,1910
22,2696,1672,1336042037,1336044322,0,17,2285
22,2696,1673,1336044322,1336044331,0,17,9
22,2696,1674,1336044331,1336046085,0,17,1754
22,2696,1675,1336046085,1336046178,0,17,93
22,2696,1676,1336046178,1336054791,0,17,8613
22,2696,1677,1336054791,1336054824,0,17,33
22,2696,1678,1336054824,1336054944,0,17,120
22,2696,1679,1336054944,1336055034,0,17,90
22,2696,637,1336055034,1336055817,0,17,783
22,2696,1680,1336055817,1336055877,0,17,60
22,2697,1681,1336520721,1336520781,0,1,60
22,2698,1681,1336798472,1336798532,0,1,60
22,2699,600,1336883607,1336883642,0,18,35
22,2699,1682,1336883642,1336885232,0,18,1590
22,2699,1683,1336885232,1336885261,0,18,29
22,2699,1684,1336885261,1336885400,0,18,139
22,2699,1685,1336885400,1336887539,0,18,2139
22,2699,1686,1336887539,1336888025,0,18,486
22,2699,601,1336888025,1336888127,0,18,102
22,2699,1687,1336888127,1336888346,0,18,219
22,2699,1688,1336888346,1336889023,0,18,677
22,2699,1689,1336889023,1336889319,0,18,296
22,2699,168,1336889319,1336890374,0,18,1055
22,2699,1690,1336890374,1336890399,0,18,25
22,2699,1691,1336890399,1336891446,0,18,1047
22,2699,1345,1336891446,1336892534,0,18,1088
22,2699,1692,1336892534,1336894745,0,18,2211
22,2699,35,1336894745,1336894815,0,18,70
22,2699,1693,1336894815,1336898629,0,18,3814
22,2699,1694,1336898629,1336898689,0,18,60
22,2700,1695,1337398966,1337399294,0,31,328
22,2700,1696,1337399294,1337399323,0,31,29
22,2700,1697,1337399323,1337399429,0,31,106
22,2700,1698,1337399429,1337401101,0,31,1672
22,2700,1699,1337401101,1337401135,0,31,34
22,2700,1700,1337401135,1337401718,0,31,583
22,2700,1701,1337401718,1337401787,0,31,69
22,2700,1702,1337401787,1337402955,0,31,1168
22,2700,1703,1337402955,1337403508,0,31,553
22,2700,648,1337403508,1337404089,0,31,581
22,2700,1704,1337404089,1337405394,0,31,1305
22,2700,1705,1337405394,1337407702,0,31,2308
22,2700,1706,1337407702,1337408106,0,31,404
22,2700,1707,1337408106,1337408935,0,31,829
22,2700,1708,1337408935,1337409345,0,31,410
22,2700,1709,1337409345,1337409402,0,31,57
22,2700,1710,1337409402,1337410768,0,31,1366
22,2700,1711,1337410768,1337410877,0,31,109
22,2700,1712,1337410877,1337411191,0,31,314
22,2700,1713,1337411191,1337412860,0,31,1669
22,2700,1714,1337412860,1337413248,0,31,388
22,2700,1715,1337413248,1337413329,0,31,81
22,2700,1716,1337413329,1337413769,0,31,440
22,2700,1717,1337413769,1337414026,0,31,257
22,2700,1718,1337414026,1337415241,0,31,1215
22,2700,1719,1337415241,1337416154,0,31,913
22,2700,1720,1337416154,1337417992,0,31,1838
22,2700,1721,1337417992,1337418328,0,31,336
22,2700,1722,1337418328,1337419150,0,31,822
22,2700,1723,1337419150,1337419776,0,31,626
22,2700,1724,1337419776,1337419836,0,31,60
22,2701,1725,1337421090,1337421150,0,1,60
22,2702,1726,1337595858,1337595874,0,2,16
22,2702,35,1337595874,1337595934,0,2,60
22,2703,1695,1338692173,1338693400,0,24,1227
22,2703,35,1338693400,1338695212,0,24,1812
22,2703,1727,1338695212,1338695264,0,24,52
22,2703,724,1338695264,1338695429,0,24,165
22,2703,1728,1338695429,1338696301,0,24,872
22,2703,1729,1338696301,1338696615,0,24,314
22,2703,1730,1338696615,1338697130,0,24,515
22,2703,1731,1338697130,1338697644,0,24,514
22,2703,1732,1338697644,1338697921,0,24,277
22,2703,1733,1338697921,1338698807,0,24,886
22,2703,1734,1338698807,1338699891,0,24,1084
22,2703,1735,1338699891,1338700047,0,24,156
22,2703,1736,1338700047,1338701759,0,24,1712
22,2703,1737,1338701759,1338702751,0,24,992
22,2703,1738,1338702751,1338703231,0,24,480
22,2703,1739,1338703231,1338707313,0,24,4082
22,2703,1740,1338707313,1338707626,0,24,313
22,2703,1741,1338707626,1338707746,0,24,120
22,2703,1742,1338707746,1338708202,0,24,456
22,2703,1743,1338708202,1338708452,0,24,250
22,2703,1744,1338708452,1338708695,0,24,243
22,2703,1745,1338708695,1338711715,0,24,3020
22,2703,1693,1338711715,1338711827,0,24,112
22,2703,1746,1338711827,1338711887,0,24,60
22,2704,1747,1338802842,1338802862,0,7,20
22,2704,1748,1338802862,1338802984,0,7,122
22,2704,1749,1338802984,1338803104,0,7,120
22,2704,1750,1338803104,1338804679,0,7,1575
22,2704,35,1338804679,1338805370,0,7,691
22,2704,1726,1338805370,1338805387,0,7,17
22,2704,1751,1338805387,1338805447,0,7,60
22,2705,1752,1339203288,1339205538,0,22,2250
22,2705,1753,1339205538,1339208122,0,22,2584
22,2705,1754,1339208122,1339209535,0,22,1413
22,2705,1755,1339209535,1339209703,0,22,168
22,2705,1756,1339209703,1339209887,0,22,184
22,2705,1757,1339209887,1339209907,0,22,20
22,2705,1758,1339209907,1339210544,0,22,637
22,2705,1759,1339210544,1339210676,0,22,132
22,2705,1760,1339210676,1339210733,0,22,57
22,2705,1761,1339210733,1339211640,0,22,907
22,2705,1762,1339211640,1339211707,0,22,67
22,2705,1763,1339211707,1339213606,0,22,1899
22,2705,1764,1339213606,1339216634,0,22,3028
22,2705,1765,1339216634,1339218435,0,22,1801
22,2705,1766,1339218435,1339219889,0,22,1454
22,2705,541,1339219889,1339220600,0,22,711
22,2705,1315,1339220600,1339220632,0,22,32
22,2705,1767,1339220632,1339222484,0,22,1852
22,2705,1768,1339222484,1339223238,0,22,754
22,2705,1769,1339223238,1339223622,0,22,384
22,2705,1770,1339223622,1339223850,0,22,228
22,2705,1771,1339223850,1339223910,0,22,60
22,2706,100,1339228563,1339229997,0,20,1434
22,2706,1772,1339229997,1339230157,0,20,160
22,2706,1773,1339230157,1339230244,0,20,87
22,2706,1774,1339230244,1339230700,0,20,456
22,2706,1775,1339230700,1339230743,0,20,43
22,2706,1776,1339230743,1339231059,0,20,316
22,2706,1777,1339231059,1339231551,0,20,492
22,2706,1778,1339231551,1339232247,0,20,696
22,2706,1779,1339232247,1339233155,0,20,908
22,2706,1780,1339233155,1339233301,0,20,146
22,2706,1781,1339233301,1339233506,0,20,205
22,2706,1782,1339233506,1339235628,0,20,2122
22,2706,622,1339235628,1339236255,0,20,627
22,2706,1783,1339236255,1339236443,0,20,188
22,2706,1784,1339236443,1339237540,0,20,1097
22,2706,1785,1339237540,1339238223,0,20,683
22,2706,1786,1339238223,1339239013,0,20,790
22,2706,1787,1339239013,1339239424,0,20,411
22,2706,1788,1339239424,1339242451,0,20,3027
22,2706,1726,1339242451,1339242511,0,20,60
22,2707,170,1339291010,1339292980,0,18,1970
22,2707,1240,1339292980,1339293396,0,18,416
22,2707,1789,1339293396,1339293558,0,18,162
22,2707,1790,1339293558,1339293730,0,18,172
22,2707,1791,1339293730,1339294327,0,18,597
22,2707,1792,1339294327,1339297537,0,18,3210
22,2707,1793,1339297537,1339300607,0,18,3070
22,2707,261,1339300607,1339300848,0,18,241
22,2707,86,1339300848,1339301849,0,18,1001
22,2707,1188,1339301849,1339302046,0,18,197
22,2707,1794,1339302046,1339302122,0,18,76
22,2707,1795,1339302122,1339303731,0,18,1609
22,2707,1796,1339303731,1339307462,0,18,3731
22,2707,1797,1339307462,1339309267,0,18,1805
22,2707,1798,1339309267,1339309453,0,18,186
22,2707,1799,1339309453,1339310587,0,18,1134
22,2707,1800,1339310587,1339312336,0,18,1749
22,2707,1801,1339312336,1339312396,0,18,60
22,2708,1802,1339314866,1339315347,0,14,481
22,2708,1803,1339315347,1339315921,0,14,574
22,2708,1804,1339315921,1339316866,0,14,945
22,2708,1805,1339316866,1339317505,0,14,639
22,2708,1806,1339317505,1339318088,0,14,583
22,2708,1807,1339318088,1339318163,0,14,75
22,2708,1808,1339318163,1339318978,0,14,815
22,2708,1,1339318978,1339320881,0,14,1903
22,2708,284,1339320881,1339321439,0,14,558
22,2708,1809,1339321439,1339322411,0,14,972
22,2708,640,1339322411,1339323453,0,14,1042
22,2708,1810,1339323453,1339325507,0,14,2054
22,2708,1811,1339325507,1339325538,0,14,31
22,2708,1812,1339325538,1339325598,0,14,60
22,2709,599,1339895992,1339897521,0,22,1529
22,2709,1813,1339897521,1339897599,0,22,78
22,2709,1814,1339897599,1339899708,0,22,2109
22,2709,1815,1339899708,1339899802,0,22,94
22,2709,1816,1339899802,1339900811,0,22,1009
22,2709,1817,1339900811,1339902011,0,22,1200
22,2709,1818,1339902011,1339902040,0,22,29
22,2709,1819,1339902040,1339902709,0,22,669
22,2709,1820,1339902709,1339903226,0,22,517
22,2709,1821,1339903226,1339903709,0,22,483
22,2709,1822,1339903709,1339904355,0,22,646
22,2709,1823,1339904355,1339905360,0,22,1005
22,2709,1824,1339905360,1339905776,0,22,416
22,2709,1825,1339905776,1339907273,0,22,1497
22,2709,1826,1339907273,1339910103,0,22,2830
22,2709,1827,1339910103,1339910592,0,22,489
22,2709,1828,1339910592,1339910936,0,22,344
22,2709,1829,1339910936,1339912330,0,22,1394
22,2709,1830,1339912330,1339912403,0,22,73
22,2709,1831,1339912403,1339912639,0,22,236
22,2709,1832,1339912639,1339913112,0,22,473
22,2709,1833,1339913112,1339913172,0,22,60
22,2710,1834,1339918343,1339918421,0,18,78
22,2710,1835,1339918421,1339918666,0,18,245
22,2710,1836,1339918666,1339919600,0,18,934
22,2710,1837,1339919600,1339920458,0,18,858
22,2710,1838,1339920458,1339920549,0,18,91
22,2710,1839,1339920549,1339921196,0,18,647
22,2710,1840,1339921196,1339921859,0,18,663
22,2710,1841,1339921859,1339922633,0,18,774
22,2710,1842,1339922633,1339923197,0,18,564
22,2710,1843,1339923197,1339923768,0,18,571
22,2710,1844,1339923768,1339923928,0,18,160
22,2710,1845,1339923928,1339924339,0,18,411
22,2710,1846,1339924339,1339924386,0,18,47
22,2710,1847,1339924386,1339924691,0,18,305
22,2710,1848,1339924691,1339925182,0,18,491
22,2710,1849,1339925182,1339929965,0,18,4783
22,2710,1850,1339929965,1339937597,0,18,7632
22,2710,1851,1339937597,1339937657,0,18,60
22,2711,1852,1341272118,1341272140,0,3,22
22,2711,1853,1341272140,1341272197,0,3,57
22,2711,1854,1341272197,1341272257,0,3,60
22,2712,1855,1341396109,1341396125,0,2,16
22,2712,1856,1341396125,1341396185,0,2,60
22,2713,35,1341471484,1341471665,0,14,181
22,2713,609,1341471665,1341471684,0,14,19
22,2713,1857,1341471684,1341471752,0,14,68
22,2713,1858,1341471752,1341471776,0,14,24
22,2713,1859,1341471776,1341473225,0,14,1449
22,2713,1390,1341473225,1341473247,0,14,22
22,2713,1860,1341473247,1341473272,0,14,25
22,2713,1861,1341473272,1341473862,0,14,590
22,2713,1862,1341473862,1341484018,0,14,10156
22,2713,1863,1341484018,1341484069,0,14,51
22,2713,1864,1341484069,1341484099,0,14,30
22,2713,1865,1341484099,1341484155,0,14,56
22,2713,1866,1341484155,1341484186,0,14,31
22,2713,1867,1341484186,1341484246,0,14,60
22,2714,35,1341625602,1341625703,0,38,101
22,2714,1868,1341625703,1341626886,0,38,1183
22,2714,1869,1341626886,1341628505,0,38,1619
22,2714,386,1341628505,1341628765,0,38,260
22,2714,1870,1341628765,1341629716,0,38,951
22,2714,1871,1341629716,1341629777,0,38,61
22,2714,1872,1341629777,1341629883,0,38,106
22,2714,1873,1341629883,1341630010,0,38,127
22,2714,1874,1341630010,1341630357,0,38,347
22,2714,1875,1341630357,1341630515,0,38,158
22,2714,1876,1341630515,1341631229,0,38,714
22,2714,1876,1341631229,1341631265,0,38,36
22,2714,15,1341631265,1341633417,0,38,2152
22,2714,1877,1341633417,1341633471,0,38,54
22,2714,1878,1341633471,1341633537,0,38,66
22,2714,1879,1341633537,1341634244,0,38,707
22,2714,1880,1341634244,1341634426,0,38,182
22,2714,1881,1341634426,1341635987,0,38,1561
22,2714,1882,1341635987,1341636043,0,38,56
22,2714,1883,1341636043,1341636471,0,38,428
22,2714,1884,1341636471,1341636725,0,38,254
22,2714,1885,1341636725,1341638530,0,38,1805
22,2714,1886,1341638530,1341638565,0,38,35
22,2714,1887,1341638565,1341639178,0,38,613
22,2714,1888,1341639178,1341639579,0,38,401
22,2714,1889,1341639579,1341639666,0,38,87
22,2714,466,1341639666,1341640219,0,38,553
22,2714,1890,1341640219,1341641617,0,38,1398
22,2714,1891,1341641617,1341641868,0,38,251
22,2714,1892,1341641868,1341642257,0,38,389
22,2714,1893,1341642257,1341642286,0,38,29
22,2714,1894,1341642286,1341644148,0,38,1862
22,2714,1895,1341644148,1341644683,0,38,535
22,2714,1896,1341644683,1341644901,0,38,218
22,2714,1897,1341644901,1341645772,0,38,871
22,2714,1898,1341645772,1341645900,0,38,128
22,2714,1899,1341645900,1341646924,0,38,1024
22,2714,1900,1341646924,1341646984,0,38,60
22,2715,1372,1341648746,1341649020,0,8,274
22,2715,1901,1341649020,1341649221,0,8,201
22,2715,1902,1341649221,1341649450,0,8,229
22,2715,1133,1341649450,1341650533,0,8,1083
22,2715,1903,1341650533,1341650575,0,8,42
22,2715,1904,1341650575,1341652006,0,8,1431
22,2715,1905,1341652006,1341655012,0,8,3006
22,2715,1906,1341655012,1341655072,0,8,60
22,2716,35,1341711338,1341711368,0,20,30
22,2716,1677,1341711368,1341715050,0,20,3682
22,2716,386,1341715050,1341716087,0,20,1037
22,2716,1390,1341716087,1341716259,0,20,172
22,2716,1907,1341716259,1341716348,0,20,89
22,2716,1908,1341716348,1341716471,0,20,123
22,2716,1909,1341716471,1341716957,0,20,486
22,2716,1910,1341716957,1341717551,0,20,594
22,2716,1911,1341717551,1341717594,0,20,43
22,2716,1912,1341717594,1341717838,0,20,244
22,2716,15,1341717838,1341724893,0,20,7055
22,2716,1913,1341724893,1341724985,0,20,92
22,2716,1914,1341724985,1341727145,0,20,2160
22,2716,1915,1341727145,1341727234,0,20,89
22,2716,1916,1341727234,1341727385,0,20,151
22,2716,1917,1341727385,1341727662,0,20,277
22,2716,1918,1341727662,1341727962,0,20,300
22,2716,1919,1341727962,1341729363,0,20,1401
22,2716,50,1341729363,1341731018,0,20,1655
22,2716,1693,1341731018,1341731078,0,20,60
22,2717,1920,1341739594,1341739634,0,14,40
22,2717,1921,1341739634,1341740710,0,14,1076
22,2717,1922,1341740710,1341741292,0,14,582
22,2717,1923,1341741292,1341741305,0,14,13
22,2717,1924,1341741305,1341744634,0,14,3329
22,2717,50,1341744634,1341744671,0,14,37
22,2717,283,1341744671,1341750557,0,14,5886
22,2717,1925,1341750557,1341750939,0,14,382
22,2717,1926,1341750939,1341751005,0,14,66
22,2717,1927,1341751005,1341751058,0,14,53
22,2717,1928,1341751058,1341751496,0,14,438
22,2717,1929,1341751496,1341751515,0,14,19
22,2717,1930,1341751515,1341751549,0,14,34
22,2717,1931,1341751549,1341751609,0,14,60
22,2718,1677,1342228856,1342231721,0,20,2865
22,2718,1932,1342231721,1342231995,0,20,274
22,2718,1933,1342231995,1342233020,0,20,1025
22,2718,1934,1342233020,1342233071,0,20,51
22,2718,1935,1342233071,1342234289,0,20,1218
22,2718,1936,1342234289,1342234833,0,20,544
22,2718,1937,1342234833,1342234934,0,20,101
22,2718,1938,1342234934,1342235228,0,20,294
22,2718,1939,1342235228,1342235431,0,20,203
22,2718,1940,1342235431,1342236691,0,20,1260
22,2718,1941,1342236691,1342237427,0,20,736
22,2718,1942,1342237427,1342241205,0,20,3778
22,2718,1943,1342241205,1342241813,0,20,608
22,2718,1944,1342241813,1342245031,0,20,3218
22,2718,1945,1342245031,1342247807,0,20,2776
22,2718,1946,1342247807,1342247832,0,20,25
22,2718,1947,1342247832,1342247992,0,20,160
22,2718,1948,1342247992,1342248152,0,20,160
22,2718,1949,1342248152,1342249069,0,20,917
22,2718,1950,1342249069,1342249129,0,20,60
22,2719,1951,1342254498,1342254526,0,9,28
22,2719,1952,1342254526,1342254627,0,9,101
22,2719,1953,1342254627,1342254731,0,9,104
22,2719,1954,1342254731,1342255400,0,9,669
22,2719,1955,1342255400,1342259337,0,9,3937
22,2719,1956,1342259337,1342261331,0,9,1994
22,2719,1957,1342261331,1342262119,0,9,788
22,2719,1958,1342262119,1342262633,0,9,514
22,2719,1959,1342262633,1342262693,0,9,60
22,2720,1960,1342339535,1342347499,0,11,7964
22,2720,1961,1342347499,1342347516,0,11,17
22,2720,1962,1342347516,1342347547,0,11,31
22,2720,1963,1342347547,1342347575,0,11,28
22,2720,1964,1342347575,1342347607,0,11,32
22,2720,1965,1342347607,1342347658,0,11,51
22,2720,1966,1342347658,1342347738,0,11,80
22,2720,1967,1342347738,1342347786,0,11,48
22,2720,1968,1342347786,1342347940,0,11,154
22,2720,1969,1342347940,1342348058,0,11,118
22,2720,1970,1342348058,1342348118,0,11,60
22,2721,1971,1342400213,1342403868,0,13,3655
22,2721,1065,1342403868,1342404599,0,13,731
22,2721,1972,1342404599,1342405633,0,13,1034
22,2721,1973,1342405633,1342406886,0,13,1253
22,2721,1974,1342406886,1342407658,0,13,772
22,2721,1975,1342407658,1342408426,0,13,768
22,2721,1976,1342408426,1342408493,0,13,67
22,2721,1977,1342408493,1342411120,0,13,2627
22,2721,1978,1342411120,1342413155,0,13,2035
22,2721,1979,1342413155,1342416037,0,13,2882
22,2721,1980,1342416037,1342416084,0,13,47
22,2721,1981,1342416084,1342418883,0,13,2799
22,2721,1982,1342418883,1342418943,0,13,60
22,2722,1983,1342428624,1342429233,0,28,609
22,2722,1984,1342429233,1342429554,0,28,321
22,2722,1985,1342429554,1342429995,0,28,441
22,2722,1986,1342429995,1342430434,0,28,439
22,2722,1987,1342430434,1342430847,0,28,413
22,2722,1988,1342430847,1342431568,0,28,721
22,2722,1989,1342431568,1342431861,0,28,293
22,2722,1990,1342431861,1342431912,0,28,51
22,2722,1991,1342431912,1342432390,0,28,478
22,2722,1992,1342432390,1342433292,0,28,902
22,2722,1993,1342433292,1342433638,0,28,346
22,2722,1994,1342433638,1342435364,0,28,1726
22,2722,1995,1342435364,1342435404,0,28,40
22,2722,1996,1342435404,1342435469,0,28,65
22,2722,1997,1342435469,1342435494,0,28,25
22,2722,1998,1342435494,1342435534,0,28,40
22,2722,1999,1342435534,1342435550,0,28,16
22,2722,2000,1342435550,1342435568,0,28,18
22,2722,2001,1342435568,1342435661,0,28,93
22,2722,2002,1342435661,1342435677,0,28,16
22,2722,2003,1342435677,1342435728,0,28,51
22,2722,2004,1342435728,1342435756,0,28,28
22,2722,2005,1342435756,1342435901,0,28,145
22,2722,2006,1342435901,1342437113,0,28,1212
22,2722,2007,1342437113,1342437283,0,28,170
22,2722,2008,1342437283,1342437367,0,28,84
22,2722,2009,1342437367,1342437432,0,28,65
22,2722,2010,1342437432,1342437492,0,28,60
22,2723,2011,1342833354,1342833395,0,3,41
22,2723,558,1342833395,1342834683,0,3,1288
22,2723,562,1342834683,1342834743,0,3,60
22,2724,2012,1342956890,1342957025,0,3,135
22,2724,2013,1342957025,1342957134,0,3,109
22,2724,2014,1342957134,1342957194,0,3,60
22,2725,2015,1343118571,1343119222,0,8,651
22,2725,2016,1343119222,1343120873,0,8,1651
22,2725,2017,1343120873,1343121938,0,8,1065
22,2725,1726,1343121938,1343123587,0,8,1649
22,2725,2018,1343123587,1343123668,0,8,81
22,2725,2019,1343123668,1343123693,0,8,25
22,2725,2020,1343123693,1343123925,0,8,232
22,2725,2021,1343123925,1343123985,0,8,60
22,2726,2022,1343444823,1343456721,0,14,11898
22,2726,2023,1343456721,1343456822,0,14,101
22,2726,2024,1343456822,1343457490,0,14,668
22,2726,2025,1343457490,1343459022,0,14,1532
22,2726,2026,1343459022,1343460232,0,14,1210
22,2726,2027,1343460232,1343460268,0,14,36
22,2726,2028,1343460268,1343460848,0,14,580
22,2726,2029,1343460848,1343460879,0,14,31
22,2726,2030,1343460879,1343462166,0,14,1287
22,2726,2031,1343462166,1343462241,0,14,75
22,2726,2032,1343462241,1343462805,0,14,564
22,2726,2033,1343462805,1343464117,0,14,1312
22,2726,2034,1343464117,1343464310,0,14,193
22,2726,2035,1343464310,1343464370,0,14,60
22,2727,2036,1343471477,1343471499,0,4,22
22,2727,2037,1343471499,1343471540,0,4,41
22,2727,2038,1343471540,1343471703,0,4,163
22,2727,2039,1343471703,1343471763,0,4,60
22,2728,71,1343529751,1343530997,0,18,1246
22,2728,2040,1343530997,1343531633,0,18,636
22,2728,2041,1343531633,1343532041,0,18,408
22,2728,2042,1343532041,1343532101,0,18,60
22,2728,2043,1343532101,1343532469,0,18,368
22,2728,2044,1343532469,1343532568,0,18,99
22,2728,2045,1343532568,1343533803,0,18,1235
22,2728,2046,1343533803,1343534327,0,18,524
22,2728,2047,1343534327,1343534390,0,18,63
22,2728,2048,1343534390,1343534738,0,18,348
22,2728,2049,1343534738,1343537524,0,18,2786
22,2728,2050,1343537524,1343539823,0,18,2299
22,2728,1903,1343539823,1343539846,0,18,23
22,2728,1904,1343539846,1343539899,0,18,53
22,2728,2051,1343539899,1343543849,0,18,3950
22,2728,2052,1343543849,1343544025,0,18,176
22,2728,2053,1343544025,1343546971,0,18,2946
22,2728,2054,1343546971,1343547031,0,18,60
22,2729,2055,1343552153,1343552239,0,7,86
22,2729,1693,1343552239,1343553744,0,7,1505
22,2729,2056,1343553744,1343553763,0,7,19
22,2729,2057,1343553763,1343554191,0,7,428
22,2729,2058,1343554191,1343554212,0,7,21
22,2729,2059,1343554212,1343554238,0,7,26
22,2729,2060,1343554238,1343554298,0,7,60
22,2730,2061,1343647275,1343650744,0,2,3469
22,2730,2062,1343650744,1343650804,0,2,60
22,2731,2013,1344591814,1344591874,0,1,60
22,2732,2063,1352785805,1352785842,0,2,37
22,2732,2064,1352785842,1352785902,0,2,60
22,2733,2065,1353208997,1353211368,0,24,2371
22,2733,2066,1353211368,1353211613,0,24,245
22,2733,2067,1353211613,1353213104,0,24,1491
22,2733,2068,1353213104,1353213119,0,24,15
22,2733,2069,1353213119,1353216005,0,24,2886
22,2733,2068,1353216005,1353216067,0,24,62
22,2733,2070,1353216067,1353216297,0,24,230
22,2733,2071,1353216297,1353216908,0,24,611
22,2733,2072,1353216908,1353216936,0,24,28
22,2733,2073,1353216936,1353218691,0,24,1755
22,2733,520,1353218691,1353219975,0,24,1284
22,2733,2074,1353219975,1353220269,0,24,294
22,2733,2075,1353220269,1353221254,0,24,985
22,2733,1608,1353221254,1353221513,0,24,259
22,2733,2076,1353221513,1353221771,0,24,258
22,2733,2077,1353221771,1353222968,0,24,1197
22,2733,766,1353222968,1353223021,0,24,53
22,2733,1569,1353223021,1353223100,0,24,79
22,2733,2078,1353223100,1353224989,0,24,1889
22,2733,603,1353224989,1353225506,0,24,517
22,2733,2079,1353225506,1353225740,0,24,234
22,2733,2080,1353225740,1353226610,0,24,870
22,2733,2081,1353226610,1353227162,0,24,552
22,2733,2082,1353227162,1353227222,0,24,60
22,2734,2083,1353351671,1353351778,0,2,107
22,2734,2084,1353351778,1353351838,0,2,60
22,2735,177,1353374730,1353377833,0,12,3103
22,2735,2085,1353377833,1353380048,0,12,2215
22,2735,706,1353380048,1353386901,0,12,6853
22,2735,2086,1353386901,1353387434,0,12,533
22,2735,2087,1353387434,1353390195,0,12,2761
22,2735,2088,1353390195,1353390291,0,12,96
22,2735,2089,1353390291,1353395773,0,12,5482
22,2735,2090,1353395773,1353395790,0,12,17
22,2735,2091,1353395790,1353395910,0,12,120
22,2735,2092,1353395910,1353395915,0,12,5
22,2735,2093,1353395915,1353395923,0,12,8
22,2735,2092,1353395923,1353395983,0,12,60
22,2736,2094,1353396881,1353400578,0,3,3697
22,2736,2095,1353400578,1353403135,0,3,2557
22,2736,2096,1353403135,1353403195,0,3,60
22,2737,2097,1353586763,1353586823,0,1,60
22,2738,35,1353730177,1353730211,0,16,34
22,2738,1859,1353730211,1353730237,0,16,26
22,2738,791,1353730237,1353730259,0,16,22
22,2738,2098,1353730259,1353730434,0,16,175
22,2738,2099,1353730434,1353731595,0,16,1161
22,2738,2100,1353731595,1353732578,0,16,983
22,2738,2101,1353732578,1353736482,0,16,3904
22,2738,2102,1353736482,1353736978,0,16,496
22,2738,2103,1353736978,1353737253,0,16,275
22,2738,2104,1353737253,1353737716,0,16,463
22,2738,2105,1353737716,1353737767,0,16,51
22,2738,2106,1353737767,1353738983,0,16,1216
22,2738,2107,1353738983,1353739010,0,16,27
22,2738,2108,1353739010,1353739834,0,16,824
22,2738,104,1353739834,1353741071,0,16,1237
22,2738,2109,1353741071,1353741131,0,16,60
22,2739,875,1353814027,1353815499,0,9,1472
22,2739,2110,1353815499,1353818196,0,9,2697
22,2739,2111,1353818196,1353821030,0,9,2834
22,2739,125,1353821030,1353833166,0,9,12136
22,2739,2112,1353833166,1353833262,0,9,96
22,2739,2113,1353833262,1353833294,0,9,32
22,2739,2114,1353833294,1353834575,0,9,1281
22,2739,2115,1353834575,1353834980,0,9,405
22,2739,2116,1353834980,1353835040,0,9,60
22,2740,2117,1353836773,1353837505,0,7,732
22,2740,2118,1353837505,1353837639,0,7,134
22,2740,2119,1353837639,1353839166,0,7,1527
22,2740,2120,1353839166,1353839758,0,7,592
22,2740,2121,1353839758,1353840499,0,7,741
22,2740,2122,1353840499,1353841351,0,7,852
22,2740,2123,1353841351,1353841411,0,7,60
22,2741,177,1354414639,1354414698,0,9,59
22,2741,2124,1354414698,1354414805,0,9,107
22,2741,2125,1354414805,1354415806,0,9,1001
22,2741,2126,1354415806,1354420232,0,9,4426
22,2741,2127,1354420232,1354420632,0,9,400
22,2741,2128,1354420632,1354430012,0,9,9380
22,2741,1062,1354430012,1354430036,0,9,24
22,2741,1079,1354430036,1354430142,0,9,106
22,2741,2129,1354430142,1354430202,0,9,60
22,2742,2130,1354762141,1354762201,0,1,60
22,2743,1203,1354957455,1354957515,0,3,60
22,2743,35,1354957515,1354957516,0,3,1
22,2743,1859,1354957516,1354957576,0,3,60
22,2744,2131,1355021901,1355022040,0,5,139
22,2744,2132,1355022040,1355022071,0,5,31
22,2744,2133,1355022071,1355023541,0,5,1470
22,2744,2134,1355023541,1355027239,0,5,3698
22,2744,2135,1355027239,1355027299,0,5,60
22,2745,35,1355532904,1355532942,0,5,38
22,2745,35,1355532942,1355532967,0,5,25
22,2745,2136,1355532967,1355534894,0,5,1927
22,2745,1203,1355534894,1355541708,0,5,6814
22,2745,834,1355541708,1355541768,0,5,60
22,2746,2137,1357184823,1357184831,0,4,8
22,2746,875,1357184831,1357185417,0,4,586
22,2746,2120,1357185417,1357187220,0,4,1803
22,2746,2111,1357187220,1357187280,0,4,60
22,2747,177,1357267745,1357285218,0,2,17473
22,2747,1813,1357285218,1357285278,0,2,60
22,2748,1203,1357441142,1357458427,0,2,17285
22,2748,2136,1357458427,1357458487,0,2,60
23,2749,2137,1358048756,1358048757,0,6,1
23,2749,875,1358048757,1358053363,0,6,4606
23,2749,2111,1358053363,1358053373,0,6,10
23,2749,126,1358053373,1358067341,0,6,13968
23,2749,2137,1358067341,1358067427,0,6,86
23,2749,2138,1358067427,1358067487,0,6,60
23,2750,35,1333491808,1333491868,0,1,60
23,2751,2139,1333534856,1333536540,0,2,1684
23,2751,35,1333536540,1333536600,0,2,60
23,2752,35,1333843379,1333843439,0,1,60
23,2753,35,1333923546,1333923606,0,1,60
23,2754,35,1334143154,1334143214,0,1,60
23,2755,2140,1334313596,1334325875,0,2,12279
23,2755,35,1334325875,1334325935,0,2,60
23,2756,35,1334528308,1334528368,0,1,60
23,2757,35,1334667672,1334667732,0,1,60
23,2758,35,1334701458,1334701518,0,1,60
23,2759,35,1334787975,1334788643,0,3,668
23,2759,2141,1334788643,1334802950,0,3,14307
23,2759,35,1334802950,1334803010,0,3,60
23,2760,2142,1334828995,1334829055,0,1,60
23,2761,35,1334874332,1334874392,0,1,60
23,2762,2143,1334924315,1334924375,0,1,60
23,2763,2141,1335233844,1335233904,0,1,60
23,2764,35,1335355625,1335355632,0,2,7
23,2764,590,1335355632,1335355692,0,2,60
23,2765,35,1335392573,1335392633,0,1,60
23,2766,35,1335596302,1335602374,0,3,6072
23,2766,2144,1335602374,1335602711,0,3,337
23,2766,2145,1335602711,1335602771,0,3,60
23,2767,35,1335911175,1335911235,0,1,60
23,2768,35,1335959062,1335959798,0,2,736
23,2768,2146,1335959798,1335959858,0,2,60
23,2769,2147,1336218643,1336218703,0,1,60
23,2770,35,1336429065,1336429125,0,1,60
23,2771,35,1336515479,1336515539,0,1,60
23,2772,35,1336559026,1336559086,0,1,60
23,2773,35,1336688308,1336688368,0,1,60
23,2774,35,1336737042,1336737102,0,1,60
23,2775,35,1336947538,1336947598,0,1,60
23,2776,35,1336991710,1336991770,0,1,60
23,2777,35,1337033994,1337034054,0,1,60
23,2778,35,1337173620,1337173680,0,1,60
23,2779,2142,1337209841,1337209901,0,1,60
23,2780,1154,1337248007,1337261032,0,2,13025
23,2780,35,1337261032,1337261092,0,2,60
23,2781,2148,1337344696,1337347933,0,2,3237
23,2781,35,1337347933,1337347993,0,2,60
23,2782,590,1337604411,1337604471,0,1,60
23,2783,35,1337639223,1337639283,0,1,60
23,2784,35,1337686953,1337687013,0,1,60
23,2785,35,1338157193,1338157253,0,1,60
23,2786,590,1338209327,1338209387,0,1,60
23,2787,35,1338244007,1338265116,0,2,21109
23,2787,2141,1338265116,1338265176,0,2,60
23,2788,35,1338330464,1338330524,0,1,60
23,2789,2149,1338474160,1338474220,0,1,60
23,2790,35,1338503081,1338503141,0,1,60
23,2791,35,1338556301,1338556600,0,2,299
23,2791,590,1338556600,1338556660,0,2,60
23,2792,35,1338762286,1338762346,0,1,60
23,2793,35,1338815942,1338816002,0,1,60
23,2794,35,1338989781,1338989841,0,1,60
23,2795,35,1339076780,1339076840,0,1,60
23,2796,35,1339158401,1339158461,0,1,60
23,2797,590,1339368698,1339368758,0,1,60
23,2798,35,1339417386,1339417446,0,1,60
23,2799,35,1339453553,1339453613,0,1,60
23,2800,35,1339539958,1339540018,0,1,60
23,2801,35,1339586283,1339586343,0,1,60
23,2802,35,1339626266,1339626326,0,1,60
23,2803,35,1340025983,1340026002,0,2,19
23,2803,590,1340026002,1340026062,0,2,60
23,2804,35,1340102066,1340102126,0,1,60
23,2805,35,1340622219,1340622279,0,1,60
23,2806,35,1340750765,1340750825,0,1,60
23,2807,35,1340803548,1340803608,0,1,60
23,2808,2150,1341216302,1341217211,0,2,909
23,2808,2151,1341217211,1341217271,0,2,60
23,2809,35,1341318488,1341318548,0,1,60
23,2810,35,1341440706,1341440766,0,1,60
23,2811,35,1341526961,1341527021,0,1,60
23,2812,2141,1341787650,1341787710,0,1,60
23,2813,2152,1341827284,1341836044,0,2,8760
23,2813,35,1341836044,1341836104,0,2,60
23,2814,35,1341873315,1341873375,0,1,60
23,2815,35,1341959031,1341959091,0,1,60
23,2816,35,1342007817,1342007877,0,1,60
23,2817,35,1342045465,1342045525,0,1,60
23,2818,2141,1342479183,1342479243,0,1,60
23,2819,35,1342563779,1342563859,0,2,80
23,2819,2149,1342563859,1342563919,0,2,60
23,2820,35,1342650310,1342650370,0,1,60
23,2821,284,1343465269,1343465547,0,5,278
23,2821,2153,1343465547,1343466439,0,5,892
23,2821,2154,1343466439,1343472130,0,5,5691
23,2821,2155,1343472130,1343472144,0,5,14
23,2821,1155,1343472144,1343472204,0,5,60
23,2822,2141,1343601271,1343601331,0,1,60
23,2823,35,1344205029,1344205089,0,1,60
23,2824,2156,1344227120,1344227180,0,1,60
23,2825,35,1344675927,1344678754,0,2,2827
23,2825,2157,1344678754,1344678814,0,2,60
23,2826,35,1344896615,1344896675,0,1,60
23,2827,35,1344983111,1344983171,0,1,60
23,2828,35,1345414637,1345414697,0,1,60
23,2829,35,1347229104,1347229164,0,1,60
23,2830,21,1350050622,1350051887,0,3,1265
23,2830,35,1350051887,1350053078,0,3,1191
23,2830,590,1350053078,1350053138,0,3,60
23,2831,35,1350137486,1350137546,0,1,60
23,2832,2158,1351771195,1351771255,0,1,60
23,2833,2141,1351809688,1351809748,0,1,60
23,2834,2146,1351854183,1351854243,0,1,60
23,2835,2159,1352453687,1352453747,0,1,60
23,2836,2160,1353148117,1353148142,0,2,25
23,2836,590,1353148142,1353148202,0,2,60
23,2837,2161,1354954987,1354955047,0,1,60
23,2838,2141,1356647170,1356647230,0,1,60
23,2839,35,1358259064,1358259124,0,1,60
24,2840,2141,1359412061,1359412121,0,1,60
24,2841,35,1334053012,1334053751,0,7,739
24,2841,284,1334053751,1334054616,0,7,865
24,2841,2162,1334054616,1334055619,0,7,1003
24,2841,2163,1334055619,1334065089,0,7,9470
24,2841,2164,1334065089,1334070726,0,7,5637
24,2841,287,1334070726,1334071140,0,7,414
24,2841,2165,1334071140,1334071200,0,7,60
24,2842,35,1334317244,1334319445,0,3,2201
24,2842,2166,1334319445,1334329628,0,3,10183
24,2842,2165,1334329628,1334329688,0,3,60
24,2843,2165,1334372598,1334372658,0,1,60
24,2844,2167,1334466612,1334485337,0,2,18725
24,2844,2168,1334485337,1334485397,0,2,60
24,2845,35,1334496170,1334496230,0,1,60
24,2846,2169,1334754077,1334756386,0,2,2309
24,2846,21,1334756386,1334756446,0,2,60
24,2847,35,1335243980,1335245859,0,3,1879
24,2847,2170,1335245859,1335250008,0,3,4149
24,2847,954,1335250008,1335250068,0,3,60
24,2848,35,1335275224,1335275284,0,1,60
24,2849,35,1335526008,1335527572,0,4,1564
24,2849,297,1335527572,1335531921,0,4,4349
24,2849,1871,1335531921,1335535175,0,4,3254
24,2849,2171,1335535175,1335535235,0,4,60
24,2850,2172,1335688783,1335689553,0,4,770
24,2850,1871,1335689553,1335690645,0,4,1092
24,2850,297,1335690645,1335692419,0,4,1774
24,2850,35,1335692419,1335692479,0,4,60
24,2851,2173,1336042525,1336051617,0,2,9092
24,2851,35,1336051617,1336051677,0,2,60
24,2852,2165,1336390528,1336391349,0,3,821
24,2852,35,1336391349,1336397432,0,3,6083
24,2852,637,1336397432,1336397492,0,3,60
24,2853,272,1336717070,1336717737,0,3,667
24,2853,959,1336717737,1336721630,0,3,3893
24,2853,2174,1336721630,1336721690,0,3,60
24,2854,21,1336830225,1336830285,0,1,60
24,2855,35,1337076972,1337078485,0,2,1513
24,2855,2163,1337078485,1337078545,0,2,60
24,2856,35,1337166093,1337166380,0,3,287
24,2856,637,1337166380,1337177691,0,3,11311
24,2856,35,1337177691,1337177751,0,3,60
24,2857,35,1337682722,1337683137,0,3,415
24,2857,637,1337683137,1337684048,0,3,911
24,2857,284,1337684048,1337684108,0,3,60
24,2858,35,1339902569,1339903615,0,5,1046
24,2858,480,1339903615,1339908826,0,5,5211
24,2858,50,1339908826,1339909389,0,5,563
24,2858,573,1339909389,1339910015,0,5,626
24,2858,2175,1339910015,1339910075,0,5,60
24,2859,2176,1339933422,1339941936,0,3,8514
24,2859,464,1339941936,1339943616,0,3,1680
24,2859,727,1339943616,1339943676,0,3,60
24,2860,2165,1340011480,1340012243,0,2,763
24,2860,35,1340012243,1340012303,0,2,60
24,2861,2177,1341216397,1341216457,0,1,60
24,2862,480,1341559408,1341559876,0,4,468
24,2862,2178,1341559876,1341563015,0,4,3139
24,2862,1037,1341563015,1341568386,0,4,5371
24,2862,35,1341568386,1341568446,0,4,60
24,2863,1629,1342004826,1342004886,0,1,60
24,2864,287,1342076709,1342086994,0,3,10285
24,2864,2179,1342086994,1342087809,0,3,815
24,2864,2162,1342087809,1342087869,0,3,60
24,2865,284,1342178368,1342190130,0,2,11762
24,2865,2165,1342190130,1342190190,0,2,60
24,2866,35,1342492354,1342492414,0,1,60
24,2867,28,1343124074,1343125469,0,2,1395
24,2867,35,1343125469,1343125529,0,2,60
24,2868,2180,1344152334,1344170745,0,4,18411
24,2868,2180,1344170745,1344172589,0,4,1844
24,2868,284,1344172589,1344173434,0,4,845
24,2868,2165,1344173434,1344173494,0,4,60
24,2869,1555,1344237442,1344237502,0,1,60
24,2870,253,1345259742,1345265091,0,4,5349
24,2870,732,1345265091,1345265304,0,4,213
24,2870,2181,1345265304,1345275396,0,4,10092
24,2870,2182,1345275396,1345275456,0,4,60
24,2871,2183,1345379988,1345382862,0,2,2874
24,2871,359,1345382862,1345382922,0,2,60
24,2872,284,1346840467,1346841214,0,2,747
24,2872,2179,1346841214,1346841274,0,2,60
24,2873,1629,1350127463,1350127500,0,2,37
24,2873,2184,1350127500,1350127560,0,2,60
24,2874,11,1350382233,1350383366,0,2,1133
24,2874,2185,1350383366,1350383426,0,2,60
24,2875,2186,1350469459,1350469519,0,1,60
24,2876,260,1351149428,1351150685,0,3,1257
24,2876,2187,1351150685,1351154666,0,3,3981
24,2876,2188,1351154666,1351154726,0,3,60
24,2877,2189,1351234633,1351234693,0,1,60
24,2878,35,1351753307,1351757922,0,3,4615
24,2878,2177,1351757922,1351760118,0,3,2196
24,2878,931,1351760118,1351760178,0,3,60
24,2879,21,1352368128,1352368188,0,1,60
24,2880,1555,1353551606,1353568037,0,2,16431
24,2880,637,1353568037,1353568097,0,2,60
24,2881,449,1353636809,1353656536,0,2,19727
24,2881,2190,1353656536,1353656596,0,2,60
24,2882,727,1353709920,1353709980,0,1,60
24,2883,21,1353740423,1353740483,0,1,60
24,2884,35,1353914359,1353915180,0,3,821
24,2884,1555,1353915180,1353928946,0,3,13766
24,2884,2191,1353928946,1353929006,0,3,60
24,2885,637,1354874583,1354879068,0,2,4485
24,2885,2192,1354879068,1354879128,0,2,60
24,2886,1103,1355480545,1355480605,0,1,60
24,2887,516,1356759695,1356760593,0,3,898
24,2887,289,1356760593,1356763315,0,3,2722
24,2887,2193,1356763315,1356763375,0,3,60
24,2888,2194,1357125117,1357128570,0,3,3453
24,2888,35,1357128570,1357129837,0,3,1267
24,2888,1629,1357129837,1357129897,0,3,60
24,2889,35,1357623249,1357628148,0,3,4899
24,2889,2177,1357628148,1357628814,0,3,666
24,2889,2195,1357628814,1357628874,0,3,60
24,2890,2095,1357968089,1357973078,0,2,4989
24,2890,35,1357973078,1357973138,0,2,60
24,2891,253,1358244745,1358244805,0,1,60
24,2892,2196,1358331410,1358331470,0,1,60
24,2893,2197,1359557121,1359557167,0,5,46
24,2893,2198,1359557167,1359557186,0,5,19
24,2893,2199,1359557186,1359557405,0,5,219
24,2893,2200,1359557405,1359557433,0,5,28
24,2893,2201,1359557433,1359557493,0,5,60
24,2894,2202,1359792642,1359792702,0,1,60
25,2895,1629,1360572800,1360572860,0,1,60
25,2896,2203,1333533809,1333533869,0,1,60
25,2897,2204,1333883858,1333887341,0,2,3483
25,2897,2205,1333887341,1333887401,0,2,60
25,2898,2206,1334056804,1334056864,0,1,60
25,2899,2206,1334229328,1334229388,0,1,60
25,2900,351,1334305181,1334317207,0,2,12026
25,2900,2204,1334317207,1334317267,0,2,60
25,2901,710,1334655958,1334655978,0,3,20
25,2901,2207,1334655978,1334657054,0,3,1076
25,2901,2204,1334657054,1334657114,0,3,60
25,2902,2208,1334834064,1334834124,0,1,60
25,2903,2209,1334972847,1334972907,0,1,60
25,2904,2204,1335094249,1335094309,0,1,60
25,2905,2204,1335180637,1335180697,0,1,60
25,2906,2210,1335402434,1335402494,0,1,60
25,2907,2204,1335526700,1335526760,0,1,60
25,2908,2204,1335614618,1335614678,0,1,60
25,2909,2204,1336054418,1336054478,0,1,60
25,2910,2211,1336096906,1336097980,0,4,1074
25,2910,2212,1336097980,1336098391,0,4,411
25,2910,5,1336098391,1336103170,0,4,4779
25,2910,770,1336103170,1336103230,0,4,60
25,2911,2213,1336131838,1336131898,0,1,60
25,2912,2214,1336191401,1336195711,0,2,4310
25,2912,2215,1336195711,1336195771,0,2,60
25,2913,2204,1336217672,1336217732,0,1,60
25,2914,2216,1336261992,1336262052,0,1,60
25,2915,2206,1336476077,1336476137,0,1,60
25,2916,2206,1336735653,1336735713,0,1,60
25,2917,710,1336810424,1336813538,0,4,3114
25,2917,403,1336813538,1336822054,0,4,8516
25,2917,21,1336822054,1336824363,0,4,2309
25,2917,2217,1336824363,1336824423,0,4,60
25,2918,2206,1336896619,1336906703,0,2,10084
25,2918,2204,1336906703,1336906763,0,2,60
25,2919,2206,1337166149,1337166209,0,1,60
25,2920,2211,1337413987,1337416455,0,3,2468
25,2920,8,1337416455,1337417467,0,3,1012
25,2920,770,1337417467,1337417527,0,3,60
25,2921,710,1337595601,1337606266,0,2,10665
25,2921,2204,1337606266,1337606326,0,2,60
25,2922,2218,1337996599,1337997491,0,2,892
25,2922,2219,1337997491,1337997551,0,2,60
25,2923,2220,1338023979,1338024039,0,1,60
25,2924,2206,1338087862,1338103782,0,3,15920
25,2924,2221,1338103782,1338107796,0,3,4014
25,2924,2204,1338107796,1338107856,0,3,60
25,2925,2206,1338290570,1338290630,0,1,60
25,2926,2205,1338725704,1338725764,0,1,60
25,2927,2206,1338895380,1338895440,0,1,60
25,2928,2206,1339067854,1339067914,0,1,60
25,2929,2206,1339231482,1339240575,0,2,9093
25,2929,2204,1339240575,1339240635,0,2,60
25,2930,2206,1339305494,1339317748,0,2,12254
25,2930,2204,1339317748,1339317808,0,2,60
25,2931,2206,1339498738,1339498798,0,1,60
25,2932,2206,1339672508,1339672568,0,1,60
25,2933,2206,1340017224,1340017284,0,1,60
25,2934,2206,1340795766,1340795826,0,1,60
25,2935,2206,1341121426,1341121486,0,1,60
25,2936,2206,1341320019,1341320079,0,1,60
25,2937,2204,1341400387,1341400447,0,1,60
25,2938,2204,1341487393,1341487453,0,1,60
25,2939,2211,1341560291,1341560351,0,1,60
25,2940,2204,1341656466,1341656526,0,1,60
25,2941,2204,1341734574,1341734634,0,1,60
25,2942,2222,1341988103,1341999333,0,2,11230
25,2942,2223,1341999333,1341999393,0,2,60
25,2943,2224,1342230827,1342230887,0,1,60
25,2944,2225,1342431945,1342432336,0,2,391
25,2944,2204,1342432336,1342432396,0,2,60
25,2945,2206,1342524335,1342524395,0,1,60
25,2946,2204,1343466143,1343466203,0,1,60
25,2947,2226,1343543678,1343543738,0,1,60
25,2948,2204,1344161213,1344161273,0,1,60
25,2949,2204,1344607333,1344607393,0,1,60
25,2950,2206,1344756606,1344761379,0,2,4773
25,2950,2204,1344761379,1344761439,0,2,60
25,2951,2227,1345263275,1345263335,0,1,60
25,2952,2204,1345296772,1345296832,0,1,60
25,2953,2204,1345462709,1345462769,0,1,60
25,2954,2206,1346843747,1346843807,0,1,60
25,2955,2218,1350096020,1350096080,0,1,60
25,2956,2206,1350473641,1350473701,0,1,60
25,2957,2206,1351077745,1351077805,0,1,60
25,2958,2228,1351216787,1351216847,0,1,60
25,2959,2229,1351681921,1351681981,0,1,60
25,2960,2204,1351857391,1351857451,0,1,60
25,2961,2230,1352196155,1352198002,0,2,1847
25,2961,2231,1352198002,1352198062,0,2,60
25,2962,2204,1352365724,1352367528,0,2,1804
25,2962,2223,1352367528,1352367588,0,2,60
25,2963,2206,1352805230,1352805290,0,1,60
25,2964,2206,1353134039,1353142799,0,3,8760
25,2964,2232,1353142799,1353143823,0,3,1024
25,2964,2204,1353143823,1353143883,0,3,60
25,2965,2233,1353209176,1353209236,0,1,60
25,2966,2234,1353384964,1353385024,0,1,60
25,2967,2203,1353406584,1353406644,0,1,60
25,2968,2204,1353574950,1353575010,0,1,60
25,2969,2235,1353728494,1353728554,0,1,60
25,2970,2236,1354349437,1354358697,0,2,9260
25,2970,2204,1354358697,1354358757,0,2,60
25,2971,2206,1354619939,1354619999,0,1,60
25,2972,2206,1355029907,1355040413,0,2,10506
25,2972,2204,1355040413,1355040473,0,2,60
25,2973,2204,1355487284,1355487344,0,1,60
25,2974,2204,1355653483,1355653543,0,1,60
25,2975,2206,1355916936,1355916996,0,1,60
25,2976,2206,1356606916,1356606976,0,1,60
25,2977,2204,1356684570,1356684630,0,1,60
25,2978,2204,1357287304,1357287364,0,1,60
25,2979,2206,1358054308,1358069318,0,4,15010
25,2979,8,1358069318,1358073222,0,4,3904
25,2979,2237,1358073222,1358074811,0,4,1589
25,2979,2204,1358074811,1358074871,0,4,60
25,2980,2206,1358507486,1358507546,0,1,60
25,2981,2204,1359112450,1359112510,0,1,60
25,2982,2204,1359273905,1359273965,0,1,60
25,2983,2204,1359630969,1359631029,0,1,60
25,2984,2204,1359714090,1359714150,0,1,60
25,2985,2238,1359859938,1359867271,0,2,7333
25,2985,2239,1359867271,1359867331,0,2,60
25,2986,2204,1360235974,1360236034,0,1,60
25,2987,2240,1360285066,1360285126,0,1,60
25,2988,2206,1360321701,1360321761,0,1,60
25,2989,2204,1360509700,1360509760,0,1,60
26,2990,2206,1360754316,1360754376,0,1,60
26,2991,2241,1333505374,1333506268,0,6,894
26,2991,612,1333506268,1333507035,0,6,767
26,2991,2242,1333507035,1333507752,0,6,717
26,2991,2243,1333507752,1333514000,0,6,6248
26,2991,2244,1333514000,1333515476,0,6,1476
26,2991,284,1333515476,1333515536,0,6,60
26,2992,253,1333541131,1333542186,0,4,1055
26,2992,284,1333542186,1333542718,0,4,532
26,2992,612,1333542718,1333543424,0,4,706
26,2992,2241,1333543424,1333543484,0,4,60
26,2993,2245,1333616940,1333617293,0,7,353
26,2993,2246,1333617293,1333617944,0,7,651
26,2993,2247,1333617944,1333618006,0,7,62
26,2993,2248,1333618006,1333618641,0,7,635
26,2993,2241,1333618641,1333619175,0,7,534
26,2993,2249,1333619175,1333619552,0,7,377
26,2993,2250,1333619552,1333619612,0,7,60
26,2994,284,1333856464,1333857583,0,13,1119
26,2994,11,1333857583,1333858225,0,13,642
26,2994,737,1333858225,1333862722,0,13,4497
26,2994,2251,1333862722,1333864381,0,13,1659
26,2994,2252,1333864381,1333867312,0,13,2931
26,2994,2253,1333867312,1333867597,0,13,285
26,2994,939,1333867597,1333868810,0,13,1213
26,2994,1,1333868810,1333870608,0,13,1798
26,2994,737,1333870608,1333872266,0,13,1658
26,2994,737,1333872266,1333872881,0,13,615
26,2994,11,1333872881,1333873748,0,13,867
26,2994,1799,1333873748,1333875254,0,13,1506
26,2994,2254,1333875254,1333875314,0,13,60
26,2995,2255,1333979368,1333984121,0,3,4753
26,2995,73,1333984121,1333986434,0,3,2313
26,2995,2241,1333986434,1333986494,0,3,60
26,2996,2241,1334015633,1334018410,0,2,2777
26,2996,2256,1334018410,1334018470,0,2,60
26,2997,2257,1334045181,1334045613,0,5,432
26,2997,73,1334045613,1334047661,0,5,2048
26,2997,2241,1334047661,1334047993,0,5,332
26,2997,2258,1334047993,1334048324,0,5,331
26,2997,2259,1334048324,1334048384,0,5,60
26,2998,2241,1334102072,1334104352,0,3,2280
26,2998,2257,1334104352,1334104687,0,3,335
26,2998,2256,1334104687,1334104747,0,3,60
26,2999,2257,1334131655,1334132202,0,8,547
26,2999,73,1334132202,1334134427,0,8,2225
26,2999,2241,1334134427,1334134514,0,8,87
26,2999,2260,1334134514,1334134998,0,8,484
26,2999,2261,1334134998,1334135168,0,8,170
26,2999,2262,1334135168,1334135711,0,8,543
26,2999,2263,1334135711,1334141243,0,8,5532
26,2999,2264,1334141243,1334141303,0,8,60
26,3000,2241,1334188341,1334190158,0,3,1817
26,3000,73,1334190158,1334191208,0,3,1050
26,3000,2256,1334191208,1334191268,0,3,60
26,3001,2257,1334218138,1334218590,0,3,452
26,3001,73,1334218590,1334220450,0,3,1860
26,3001,2241,1334220450,1334220510,0,3,60
26,3002,2241,1334290454,1334291710,0,4,1256
26,3002,284,1334291710,1334293957,0,4,2247
26,3002,2265,1334293957,1334302718,0,4,8761
26,3002,2243,1334302718,1334302778,0,4,60
26,3003,2266,1334313806,1334315549,0,7,1743
26,3003,595,1334315549,1334317640,0,7,2091
26,3003,284,1334317640,1334318854,0,7,1214
26,3003,2241,1334318854,1334319110,0,7,256
26,3003,2258,1334319110,1334319523,0,7,413
26,3003,2267,1334319523,1334319912,0,7,389
26,3003,2268,1334319912,1334319972,0,7,60
26,3004,284,1334359367,1334359792,0,2,425
26,3004,640,1334359792,1334359852,0,2,60
26,3005,2269,1334487092,1334488072,0,4,980
26,3005,2270,1334488072,1334489563,0,4,1491
26,3005,2271,1334489563,1334490081,0,4,518
26,3005,2272,1334490081,1334490141,0,4,60
26,3006,2257,1334563681,1334564075,0,4,394
26,3006,73,1334564075,1334566137,0,4,2062
26,3006,375,1334566137,1334566465,0,4,328
26,3006,2241,1334566465,1334566525,0,4,60
26,3007,2255,1334653563,1334663311,0,5,9748
26,3007,73,1334663311,1334664585,0,5,1274
26,3007,612,1334664585,1334665737,0,5,1152
26,3007,2241,1334665737,1334666083,0,5,346
26,3007,2259,1334666083,1334666143,0,5,60
26,3008,2257,1334710978,1334711126,0,2,148
26,3008,2273,1334711126,1334711186,0,2,60
26,3009,21,1334753486,1334754404,0,3,918
26,3009,73,1334754404,1334756399,0,3,1995
26,3009,375,1334756399,1334756459,0,3,60
26,3010,73,1334795639,1334796212,0,3,573
26,3010,2257,1334796212,1334805048,0,3,8836
26,3010,2274,1334805048,1334805108,0,3,60
26,3011,2257,1334822716,1334823114,0,8,398
26,3011,73,1334823114,1334825286,0,8,2172
26,3011,2241,1334825286,1334827338,0,8,2052
26,3011,2248,1334827338,1334827622,0,8,284
26,3011,2275,1334827622,1334833846,0,8,6224
26,3011,2245,1334833846,1334835327,0,8,1481
26,3011,2261,1334835327,1334835827,0,8,500
26,3011,2264,1334835827,1334835887,0,8,60
26,3012,2241,1334896040,1334897816,0,9,1776
26,3012,73,1334897816,1334898400,0,9,584
26,3012,2257,1334898400,1334898751,0,9,351
26,3012,2256,1334898751,1334901619,0,9,2868
26,3012,2276,1334901619,1334902794,0,9,1175
26,3012,2257,1334902794,1334903191,0,9,397
26,3012,73,1334903191,1334904397,0,9,1206
26,3012,612,1334904397,1334905305,0,9,908
26,3012,2241,1334905305,1334905365,0,9,60
26,3013,2277,1334918812,1334919429,0,2,617
26,3013,2278,1334919429,1334919489,0,2,60
26,3014,2241,1335138813,1335141079,0,5,2266
26,3014,73,1335141079,1335141483,0,5,404
26,3014,2257,1335141483,1335141735,0,5,252
26,3014,2279,1335141735,1335150867,0,5,9132
26,3014,2256,1335150867,1335150927,0,5,60
26,3015,2257,1335169563,1335169971,0,10,408
26,3015,73,1335169971,1335171628,0,10,1657
26,3015,375,1335171628,1335172036,0,10,408
26,3015,2241,1335172036,1335172244,0,10,208
26,3015,2262,1335172244,1335172722,0,10,478
26,3015,2261,1335172722,1335173087,0,10,365
26,3015,2264,1335173087,1335175990,0,10,2903
26,3015,2280,1335175990,1335178888,0,10,2898
26,3015,2267,1335178888,1335179538,0,10,650
26,3015,2259,1335179538,1335179598,0,10,60
26,3016,612,1335227251,1335228340,0,3,1089
26,3016,73,1335228340,1335228849,0,3,509
26,3016,2257,1335228849,1335228909,0,3,60
26,3017,2281,1335257722,1335264169,0,5,6447
26,3017,2282,1335264169,1335265747,0,5,1578
26,3017,73,1335265747,1335267239,0,5,1492
26,3017,612,1335267239,1335267860,0,5,621
26,3017,2241,1335267860,1335267920,0,5,60
26,3018,2257,1335360121,1335362057,0,4,1936
26,3018,612,1335362057,1335362813,0,4,756
26,3018,2241,1335362813,1335363235,0,4,422
26,3018,2259,1335363235,1335363295,0,4,60
26,3019,2241,1335398018,1335399883,0,5,1865
26,3019,73,1335399883,1335400457,0,5,574
26,3019,2257,1335400457,1335400650,0,5,193
26,3019,2256,1335400650,1335410345,0,5,9695
26,3019,2283,1335410345,1335410405,0,5,60
26,3020,1019,1335429613,1335450408,0,2,20795
26,3020,589,1335450408,1335450468,0,2,60
26,3021,2284,1335451586,1335451646,0,1,60
26,3022,375,1335531817,1335532044,0,2,227
26,3022,2241,1335532044,1335532104,0,2,60
26,3023,2285,1335616276,1335616336,0,1,60
26,3024,2241,1335658137,1335659544,0,2,1407
26,3024,284,1335659544,1335659604,0,2,60
26,3025,284,1335689898,1335690696,0,4,798
26,3025,375,1335690696,1335691018,0,4,322
26,3025,2241,1335691018,1335691564,0,4,546
26,3025,2264,1335691564,1335691624,0,4,60
26,3026,2286,1335936282,1335936651,0,11,369
26,3026,2241,1335936651,1335937278,0,11,627
26,3026,375,1335937278,1335939088,0,11,1810
26,3026,73,1335939088,1335940001,0,11,913
26,3026,2287,1335940001,1335941684,0,11,1683
26,3026,2257,1335941684,1335951180,0,11,9496
26,3026,47,1335951180,1335952195,0,11,1015
26,3026,35,1335952195,1335952855,0,11,660
26,3026,284,1335952855,1335954367,0,11,1512
26,3026,595,1335954367,1335956280,0,11,1913
26,3026,2288,1335956280,1335956340,0,11,60
26,3027,284,1335957997,1335959418,0,3,1421
26,3027,2241,1335959418,1335959726,0,3,308
26,3027,2258,1335959726,1335959786,0,3,60
26,3028,284,1336180217,1336180277,0,1,60
26,3029,425,1336478395,1336478753,0,6,358
26,3029,2289,1336478753,1336478753,0,6,0
26,3029,2289,1336478753,1336488385,0,6,9632
26,3029,425,1336488385,1336489116,0,6,731
26,3029,253,1336489116,1336498830,0,6,9714
26,3029,2290,1336498830,1336498890,0,6,60
26,3030,598,1336508116,1336509416,0,4,1300
26,3030,284,1336509416,1336510342,0,4,926
26,3030,375,1336510342,1336510606,0,4,264
26,3030,2241,1336510606,1336510666,0,4,60
26,3031,2241,1336710306,1336712431,0,10,2125
26,3031,241,1336712431,1336713037,0,10,606
26,3031,231,1336713037,1336713334,0,10,297
26,3031,2291,1336713334,1336717493,0,10,4159
26,3031,2292,1336717493,1336720134,0,10,2641
26,3031,2293,1336720134,1336721474,0,10,1340
26,3031,2294,1336721474,1336722431,0,10,957
26,3031,1112,1336722431,1336722716,0,10,285
26,3031,253,1336722716,1336724625,0,10,1909
26,3031,425,1336724625,1336724685,0,10,60
26,3032,2289,1336748648,1336748708,0,1,60
26,3033,253,1336774719,1336776025,0,3,1306
26,3033,284,1336776025,1336777665,0,3,1640
26,3033,2241,1336777665,1336777725,0,3,60
26,3034,2295,1336801770,1336808080,0,7,6310
26,3034,2296,1336808080,1336810629,0,7,2549
26,3034,2297,1336810629,1336812393,0,7,1764
26,3034,2298,1336812393,1336814432,0,7,2039
26,3034,2299,1336814432,1336814497,0,7,65
26,3034,2300,1336814497,1336816756,0,7,2259
26,3034,2301,1336816756,1336816816,0,7,60
26,3035,2302,1336832182,1336832242,0,1,60
26,3036,2302,1336885089,1336889868,0,5,4779
26,3036,2303,1336889868,1336894004,0,5,4136
26,3036,2304,1336894004,1336899477,0,5,5473
26,3036,2305,1336899477,1336904808,0,5,5331
26,3036,2295,1336904808,1336904868,0,5,60
26,3037,2306,1337164579,1337164639,0,1,60
26,3038,284,1337221457,1337222341,0,5,884
26,3038,2243,1337222341,1337224100,0,5,1759
26,3038,284,1337224100,1337225004,0,5,904
26,3038,253,1337225004,1337225969,0,5,965
26,3038,425,1337225969,1337226029,0,5,60
26,3039,253,1337252738,1337253218,0,3,480
26,3039,253,1337253218,1337256358,0,3,3140
26,3039,2241,1337256358,1337256418,0,3,60
26,3040,2307,1337383219,1337387601,0,2,4382
26,3040,2307,1337387601,1337387661,0,2,60
26,3041,2307,1337423268,1337423328,0,1,60
26,3042,2241,1337648361,1337649416,0,7,1055
26,3042,284,1337649416,1337650537,0,7,1121
26,3042,253,1337650537,1337656467,0,7,5930
26,3042,253,1337656467,1337658054,0,7,1587
26,3042,425,1337658054,1337659115,0,7,1061
26,3042,2308,1337659115,1337665606,0,7,6491
26,3042,2309,1337665606,1337665666,0,7,60
26,3043,425,1337687036,1337689988,0,3,2952
26,3043,284,1337689988,1337691040,0,3,1052
26,3043,2241,1337691040,1337691100,0,3,60
26,3044,2241,1338011077,1338011403,0,3,326
26,3044,375,1338011403,1338011870,0,3,467
26,3044,284,1338011870,1338011930,0,3,60
26,3045,2241,1338169080,1338170027,0,6,947
26,3045,284,1338170027,1338170686,0,6,659
26,3045,35,1338170686,1338175403,0,6,4717
26,3045,2310,1338175403,1338181021,0,6,5618
26,3045,2311,1338181021,1338187652,0,6,6631
26,3045,824,1338187652,1338187712,0,6,60
26,3046,856,1338192004,1338194474,0,6,2470
26,3046,35,1338194474,1338200839,0,6,6365
26,3046,2241,1338200839,1338201555,0,6,716
26,3046,2250,1338201555,1338203646,0,6,2091
26,3046,2264,1338203646,1338203943,0,6,297
26,3046,2259,1338203943,1338204003,0,6,60
26,3047,2241,1338262265,1338263812,0,3,1547
26,3047,284,1338263812,1338270505,0,3,6693
26,3047,425,1338270505,1338270565,0,3,60
26,3048,2312,1338291158,1338302134,0,4,10976
26,3048,2241,1338302134,1338302545,0,4,411
26,3048,2258,1338302545,1338303353,0,4,808
26,3048,2267,1338303353,1338303413,0,4,60
26,3049,2313,1338703852,1338704285,0,12,433
26,3049,2314,1338704285,1338704464,0,12,179
26,3049,2315,1338704464,1338706871,0,12,2407
26,3049,634,1338706871,1338707693,0,12,822
26,3049,2316,1338707693,1338708002,0,12,309
26,3049,2300,1338708002,1338708153,0,12,151
26,3049,2317,1338708153,1338711267,0,12,3114
26,3049,2318,1338711267,1338713864,0,12,2597
26,3049,2319,1338713864,1338714526,0,12,662
26,3049,2277,1338714526,1338715285,0,12,759
26,3049,2320,1338715285,1338718770,0,12,3485
26,3049,2278,1338718770,1338718830,0,12,60
26,3050,2241,1338784006,1338784397,0,4,391
26,3050,375,1338784397,1338784996,0,4,599
26,3050,284,1338784996,1338785679,0,4,683
26,3050,2243,1338785679,1338785739,0,4,60
26,3051,35,1338815156,1338816410,0,4,1254
26,3051,284,1338816410,1338817709,0,4,1299
26,3051,2321,1338817709,1338818812,0,4,1103
26,3051,375,1338818812,1338818872,0,4,60
26,3052,2322,1338873862,1338873922,0,1,60
26,3053,2323,1338970957,1338971017,0,1,60
26,3054,2324,1339038788,1339038848,0,1,60
26,3055,1235,1339154754,1339155069,0,5,315
26,3055,253,1339155069,1339156108,0,5,1039
26,3055,2325,1339156108,1339166265,0,5,10157
26,3055,253,1339166265,1339169565,0,5,3300
26,3055,2241,1339169565,1339169625,0,5,60
26,3056,2241,1339282081,1339284711,0,7,2630
26,3056,253,1339284711,1339285177,0,7,466
26,3056,2326,1339285177,1339285338,0,7,161
26,3056,2327,1339285338,1339295594,0,7,10256
26,3056,2328,1339295594,1339298164,0,7,2570
26,3056,1799,1339298164,1339300464,0,7,2300
26,3056,2329,1339300464,1339300524,0,7,60
26,3057,2330,1339318429,1339320614,0,7,2185
26,3057,2331,1339320614,1339329039,0,7,8425
26,3057,1799,1339329039,1339329649,0,7,610
26,3057,284,1339329649,1339330643,0,7,994
26,3057,375,1339330643,1339331041,0,7,398
26,3057,2241,1339331041,1339331524,0,7,483
26,3057,2259,1339331524,1339331584,0,7,60
26,3058,2241,1339389378,1339390381,0,4,1003
26,3058,284,1339390381,1339391220,0,4,839
26,3058,35,1339391220,1339392555,0,4,1335
26,3058,824,1339392555,1339392615,0,4,60
26,3059,2332,1339418430,1339420699,0,3,2269
26,3059,284,1339420699,1339422269,0,3,1570
26,3059,2241,1339422269,1339422329,0,3,60
26,3060,2241,1339460299,1339461015,0,7,716
26,3060,375,1339461015,1339461601,0,7,586
26,3060,284,1339461601,1339462009,0,7,408
26,3060,640,1339462009,1339462450,0,7,441
26,3060,2333,1339462450,1339462639,0,7,189
26,3060,2334,1339462639,1339473636,0,7,10997
26,3060,2335,1339473636,1339473696,0,7,60
26,3061,2336,1339485149,1339492107,0,2,6958
26,3061,2241,1339492107,1339492167,0,2,60
26,3062,375,1339645255,1339646850,0,4,1595
26,3062,253,1339646850,1339647818,0,4,968
26,3062,425,1339647818,1339650559,0,4,2741
26,3062,2337,1339650559,1339650619,0,4,60
26,3063,2338,1339670537,1339671215,0,3,678
26,3063,73,1339671215,1339672985,0,3,1770
26,3063,612,1339672985,1339673045,0,3,60
26,3064,2339,1339757793,1339757853,0,1,60
26,3065,2340,1339884182,1339884242,0,1,60
26,3066,2321,1339924485,1339925070,0,3,585
26,3066,2340,1339925070,1339926441,0,3,1371
26,3066,2341,1339926441,1339926501,0,3,60
26,3067,2241,1340000602,1340001364,0,8,762
26,3067,284,1340001364,1340002409,0,8,1045
26,3067,253,1340002409,1340004577,0,8,2168
26,3067,2342,1340004577,1340008968,0,8,4391
26,3067,425,1340008968,1340009412,0,8,444
26,3067,2343,1340009412,1340011888,0,8,2476
26,3067,2344,1340011888,1340012705,0,8,817
26,3067,2345,1340012705,1340012765,0,8,60
26,3068,2346,1340036034,1340036094,0,1,60
26,3069,284,1340270381,1340271146,0,3,765
26,3069,375,1340271146,1340271499,0,3,353
26,3069,2241,1340271499,1340271559,0,3,60
26,3070,284,1340617210,1340617913,0,4,703
26,3070,375,1340617913,1340618427,0,4,514
26,3070,2241,1340618427,1340618942,0,4,515
26,3070,2267,1340618942,1340619002,0,4,60
26,3071,253,1340723246,1340725182,0,3,1936
26,3071,375,1340725182,1340725644,0,3,462
26,3071,2241,1340725644,1340725704,0,3,60
26,3072,284,1340762014,1340763059,0,16,1045
26,3072,28,1340763059,1340764755,0,16,1696
26,3072,1,1340764755,1340765888,0,16,1133
26,3072,2347,1340765888,1340768892,0,16,3004
26,3072,28,1340768892,1340769122,0,16,230
26,3072,1799,1340769122,1340769628,0,16,506
26,3072,307,1340769628,1340770481,0,16,853
26,3072,2348,1340770481,1340774215,0,16,3734
26,3072,2349,1340774215,1340775051,0,16,836
26,3072,1799,1340775051,1340776282,0,16,1231
26,3072,35,1340776282,1340776997,0,16,715
26,3072,2350,1340776997,1340777770,0,16,773
26,3072,824,1340777770,1340782657,0,16,4887
26,3072,35,1340782657,1340783384,0,16,727
26,3072,2257,1340783384,1340783428,0,16,44
26,3072,47,1340783428,1340783488,0,16,60
26,3073,2351,1340783706,1340784272,0,4,566
26,3073,555,1340784272,1340801463,0,4,17191
26,3073,612,1340801463,1340802510,0,4,1047
26,3073,2241,1340802510,1340802570,0,4,60
26,3074,284,1341117542,1341117602,0,1,60
26,3075,2241,1341284096,1341285563,0,6,1467
26,3075,284,1341285563,1341287610,0,6,2047
26,3075,425,1341287610,1341300019,0,6,12409
26,3075,253,1341300019,1341301905,0,6,1886
26,3075,284,1341301905,1341304225,0,6,2320
26,3075,377,1341304225,1341304285,0,6,60
26,3076,2352,1341307442,1341311140,0,4,3698
26,3076,2353,1341311140,1341318759,0,4,7619
26,3076,284,1341318759,1341320025,0,4,1266
26,3076,2241,1341320025,1341320085,0,4,60
26,3077,284,1341467238,1341467967,0,5,729
26,3077,2243,1341467967,1341470688,0,5,2721
26,3077,284,1341470688,1341471620,0,5,932
26,3077,253,1341471620,1341482573,0,5,10953
26,3077,2354,1341482573,1341482633,0,5,60
26,3078,425,1341493247,1341493307,0,1,60
26,3079,2294,1341568101,1341568555,0,4,454
26,3079,2355,1341568555,1341571024,0,4,2469
26,3079,2241,1341571024,1341571312,0,4,288
26,3079,2267,1341571312,1341571372,0,4,60
26,3080,2356,1341636533,1341639905,0,6,3372
26,3080,2357,1341639905,1341640678,0,6,773
26,3080,2358,1341640678,1341643005,0,6,2327
26,3080,2359,1341643005,1341643263,0,6,258
26,3080,2360,1341643263,1341646656,0,6,3393
26,3080,2361,1341646656,1341646716,0,6,60
26,3081,284,1341701035,1341701774,0,2,739
26,3081,35,1341701774,1341701834,0,2,60
26,3082,2362,1341738796,1341742671,0,3,3875
26,3082,284,1341742671,1341744253,0,3,1582
26,3082,2241,1341744253,1341744313,0,3,60
26,3083,2241,1341969920,1341973300,0,5,3380
26,3083,21,1341973300,1341976910,0,5,3610
26,3083,21,1341976910,1341976974,0,5,64
26,3083,2363,1341976974,1341979026,0,5,2052
26,3083,336,1341979026,1341979086,0,5,60
26,3084,2364,1342006438,1342008432,0,4,1994
26,3084,425,1342008432,1342009386,0,4,954
26,3084,253,1342009386,1342011723,0,4,2337
26,3084,375,1342011723,1342011783,0,4,60
26,3085,2241,1342157520,1342158442,0,13,922
26,3085,284,1342158442,1342158961,0,13,519
26,3085,2243,1342158961,1342162813,0,13,3852
26,3085,2365,1342162813,1342165025,0,13,2212
26,3085,2366,1342165025,1342166439,0,13,1414
26,3085,2367,1342166439,1342167534,0,13,1095
26,3085,284,1342167534,1342168042,0,13,508
26,3085,375,1342168042,1342168466,0,13,424
26,3085,2241,1342168466,1342168677,0,13,211
26,3085,2258,1342168677,1342168968,0,13,291
26,3085,2368,1342168968,1342169253,0,13,285
26,3085,2369,1342169253,1342169846,0,13,593
26,3085,2370,1342169846,1342169906,0,13,60
26,3086,2320,1342255593,1342257954,0,8,2361
26,3086,2371,1342257954,1342258168,0,8,214
26,3086,2317,1342258168,1342259512,0,8,1344
26,3086,2299,1342259512,1342260208,0,8,696
26,3086,2300,1342260208,1342260363,0,8,155
26,3086,634,1342260363,1342262166,0,8,1803
26,3086,2372,1342262166,1342263646,0,8,1480
26,3086,2373,1342263646,1342263706,0,8,60
26,3087,1434,1342339098,1342339534,0,13,436
26,3087,732,1342339534,1342340791,0,13,1257
26,3087,284,1342340791,1342342881,0,13,2090
26,3087,2244,1342342881,1342343769,0,13,888
26,3087,2374,1342343769,1342344339,0,13,570
26,3087,2375,1342344339,1342345153,0,13,814
26,3087,2266,1342345153,1342345847,0,13,694
26,3087,2376,1342345847,1342348091,0,13,2244
26,3087,2377,1342348091,1342356161,0,13,8070
26,3087,2378,1342356161,1342357103,0,13,942
26,3087,284,1342357103,1342358210,0,13,1107
26,3087,375,1342358210,1342358644,0,13,434
26,3087,2241,1342358644,1342358704,0,13,60
26,3088,2241,1342486149,1342488643,0,3,2494
26,3088,21,1342488643,1342489012,0,3,369
26,3088,2379,1342489012,1342489072,0,3,60
26,3089,284,1342536425,1342536485,0,1,60
26,3090,35,1342796401,1342796977,0,2,576
26,3090,284,1342796977,1342797037,0,2,60
26,3091,2380,1342963054,1342967713,0,4,4659
26,3091,284,1342967713,1342968660,0,4,947
26,3091,375,1342968660,1342969011,0,4,351
26,3091,2241,1342969011,1342969071,0,4,60
26,3092,2241,1343461098,1343461645,0,11,547
26,3092,375,1343461645,1343462207,0,11,562
26,3092,284,1343462207,1343463680,0,11,1473
26,3092,2381,1343463680,1343464212,0,11,532
26,3092,2382,1343464212,1343466231,0,11,2019
26,3092,2383,1343466231,1343466907,0,11,676
26,3092,2384,1343466907,1343467576,0,11,669
26,3092,2385,1343467576,1343468377,0,11,801
26,3092,2386,1343468377,1343471379,0,11,3002
26,3092,2387,1343471379,1343480495,0,11,9116
26,3092,2388,1343480495,1343480555,0,11,60
26,3093,2241,1343486843,1343486903,0,1,60
26,3094,2241,1343613414,1343614560,0,19,1146
26,3094,284,1343614560,1343615705,0,19,1145
26,3094,2389,1343615705,1343616577,0,19,872
26,3094,2390,1343616577,1343618359,0,19,1782
26,3094,2391,1343618359,1343621168,0,19,2809
26,3094,377,1343621168,1343621720,0,19,552
26,3094,2392,1343621720,1343622816,0,19,1096
26,3094,2393,1343622816,1343624695,0,19,1879
26,3094,2394,1343624695,1343626166,0,19,1471
26,3094,2367,1343626166,1343626699,0,19,533
26,3094,2395,1343626699,1343628134,0,19,1435
26,3094,2396,1343628134,1343629899,0,19,1765
26,3094,2366,1343629899,1343630703,0,19,804
26,3094,284,1343630703,1343631429,0,19,726
26,3094,375,1343631429,1343631785,0,19,356
26,3094,2241,1343631785,1343632400,0,19,615
26,3094,2267,1343632400,1343632543,0,19,143
26,3094,2264,1343632543,1343632953,0,19,410
26,3094,2259,1343632953,1343633013,0,19,60
26,3095,2397,1343647032,1343647092,0,1,60
26,3096,2398,1344669568,1344669628,0,1,60
26,3097,2241,1344753024,1344753291,0,14,267
26,3097,375,1344753291,1344754097,0,14,806
26,3097,284,1344754097,1344754669,0,14,572
26,3097,2399,1344754669,1344754943,0,14,274
26,3097,2400,1344754943,1344760930,0,14,5987
26,3097,2383,1344760930,1344762313,0,14,1383
26,3097,2382,1344762313,1344762682,0,14,369
26,3097,2401,1344762682,1344767802,0,14,5120
26,3097,2402,1344767802,1344768427,0,14,625
26,3097,2403,1344768427,1344768644,0,14,217
26,3097,284,1344768644,1344769706,0,14,1062
26,3097,375,1344769706,1344769851,0,14,145
26,3097,2404,1344769851,1344770424,0,14,573
26,3097,2405,1344770424,1344770484,0,14,60
26,3098,375,1344775181,1344775659,0,3,478
26,3098,2241,1344775659,1344776309,0,3,650
26,3098,2267,1344776309,1344776369,0,3,60
26,3099,375,1344826074,1344827008,0,2,934
26,3099,284,1344827008,1344827068,0,2,60
26,3100,2241,1356834002,1356836323,0,2,2321
26,3100,253,1356836323,1356836383,0,2,60
26,3101,284,1356875572,1356877143,0,3,1571
26,3101,2241,1356877143,1356877399,0,3,256
26,3101,2258,1356877399,1356877459,0,3,60
26,3102,2241,1356939779,1356940831,0,8,1052
26,3102,284,1356940831,1356941985,0,8,1154
26,3102,2406,1356941985,1356944295,0,8,2310
26,3102,2374,1356944295,1356946084,0,8,1789
26,3102,2244,1356946084,1356947755,0,8,1671
26,3102,2407,1356947755,1356959036,0,8,11281
26,3102,1369,1356959036,1356959705,0,8,669
26,3102,284,1356959705,1356959765,0,8,60
26,3103,2267,1356998084,1356998173,0,4,89
26,3103,2241,1356998173,1356999594,0,4,1421
26,3103,284,1356999594,1357000207,0,4,613
26,3103,595,1357000207,1357000267,0,4,60
26,3104,284,1357108290,1357111579,0,7,3289
26,3104,2408,1357111579,1357113234,0,7,1655
26,3104,2402,1357113234,1357117320,0,7,4086
26,3104,2409,1357117320,1357117895,0,7,575
26,3104,2378,1357117895,1357121866,0,7,3971
26,3104,2410,1357121866,1357125608,0,7,3742
26,3104,2312,1357125608,1357125668,0,7,60
26,3105,284,1357139645,1357139705,0,1,60
26,3106,2264,1357188577,1357195020,0,2,6443
26,3106,284,1357195020,1357195080,0,2,60
26,3107,2411,1357210246,1357218116,0,2,7870
26,3107,2241,1357218116,1357218176,0,2,60
27,3108,2241,1357253725,1357259216,0,2,5491
27,3108,2412,1357259216,1357259276,0,2,60
27,3109,2413,1333500496,1333500556,0,1,60
27,3110,2414,1333532968,1333534060,0,2,1092
27,3110,2415,1333534060,1333534120,0,2,60
27,3111,2416,1333585392,1333585452,0,1,60
27,3112,2415,1333620531,1333627422,0,2,6891
27,3112,2414,1333627422,1333627482,0,2,60
27,3113,2417,1333870505,1333870852,0,4,347
27,3113,1706,1333870852,1333876099,0,4,5247
27,3113,2418,1333876099,1333880205,0,4,4106
27,3113,2419,1333880205,1333880265,0,4,60
27,3114,1093,1333972320,1333979533,0,2,7213
27,3114,2420,1333979533,1333979593,0,2,60
27,3115,2413,1334018599,1334018659,0,1,60
27,3116,2421,1334050369,1334050521,0,5,152
27,3116,2415,1334050521,1334052215,0,5,1694
27,3116,2422,1334052215,1334054175,0,5,1960
27,3116,104,1334054175,1334055159,0,5,984
27,3116,2423,1334055159,1334055219,0,5,60
27,3117,2415,1334138274,1334138334,0,1,60
27,3118,2424,1334223617,1334224292,0,5,675
27,3118,2425,1334224292,1334225124,0,5,832
27,3118,2426,1334225124,1334232960,0,5,7836
27,3118,2414,1334232960,1334234123,0,5,1163
27,3118,2415,1334234123,1334234183,0,5,60
27,3119,2427,1334275879,1334276035,0,3,156
27,3119,2424,1334276035,1334280280,0,3,4245
27,3119,2413,1334280280,1334280340,0,3,60
27,3120,2098,1334310383,1334312442,0,3,2059
27,3120,2414,1334312442,1334313586,0,3,1144
27,3120,2415,1334313586,1334313646,0,3,60
27,3121,2428,1334464337,1334465311,0,2,974
27,3121,1294,1334465311,1334465371,0,2,60
27,3122,2429,1334492544,1334492604,0,1,60
27,3123,2414,1334569973,1334570892,0,2,919
27,3123,2415,1334570892,1334570952,0,2,60
27,3124,2415,1334658328,1334658388,0,1,60
27,3125,2421,1334794885,1334806272,0,2,11387
27,3125,2430,1334806272,1334806332,0,2,60
27,3126,2414,1334828579,1334829308,0,2,729
27,3126,2415,1334829308,1334829368,0,2,60
27,3127,2421,1334881322,1334892005,0,2,10683
27,3127,2431,1334892005,1334892065,0,2,60
27,3128,2414,1334915703,1334916396,0,2,693
27,3128,2415,1334916396,1334916456,0,2,60
27,3129,2432,1334973547,1334979086,0,2,5539
27,3129,2429,1334979086,1334979146,0,2,60
27,3130,2414,1335078493,1335080955,0,6,2462
27,3130,2429,1335080955,1335083190,0,6,2235
27,3130,2433,1335083190,1335083835,0,6,645
27,3130,2415,1335083835,1335084146,0,6,311
27,3130,2424,1335084146,1335084404,0,6,258
27,3130,2414,1335084404,1335084464,0,6,60
27,3131,2413,1335142206,1335142266,0,1,60
27,3132,2414,1335178807,1335180284,0,2,1477
27,3132,2415,1335180284,1335180344,0,2,60
27,3133,2413,1335231253,1335237290,0,2,6037
27,3133,2428,1335237290,1335237350,0,2,60
27,3134,2434,1335262009,1335262213,0,3,204
27,3134,2414,1335262213,1335262947,0,3,734
27,3134,2415,1335262947,1335263007,0,3,60
27,3135,2414,1335351731,1335351791,0,1,60
27,3136,2413,1335403271,1335403331,0,1,60
27,3137,2414,1335434136,1335434196,0,1,60
27,3138,2414,1335521542,1335522636,0,2,1094
27,3138,2415,1335522636,1335522696,0,2,60
27,3139,2414,1335608941,1335610232,0,2,1291
27,3139,2415,1335610232,1335610292,0,2,60
27,3140,2425,1335663388,1335663645,0,10,257
27,3140,1708,1335663645,1335664383,0,10,738
27,3140,2426,1335664383,1335673080,0,10,8697
27,3140,2426,1335673080,1335674276,0,10,1196
27,3140,2435,1335674276,1335675294,0,10,1018
27,3140,2436,1335675294,1335680315,0,10,5021
27,3140,1176,1335680315,1335680953,0,10,638
27,3140,1774,1335680953,1335681684,0,10,731
27,3140,2437,1335681684,1335683361,0,10,1677
27,3140,917,1335683361,1335683421,0,10,60
27,3141,2414,1336116361,1336117545,0,2,1184
27,3141,2415,1336117545,1336117605,0,2,60
27,3142,2432,1336180754,1336182232,0,5,1478
27,3142,2429,1336182232,1336182695,0,5,463
27,3142,2438,1336182695,1336188155,0,5,5460
27,3142,138,1336188155,1336195163,0,5,7008
27,3142,2439,1336195163,1336195223,0,5,60
27,3143,2440,1336208726,1336217215,0,2,8489
27,3143,2441,1336217215,1336217275,0,2,60
27,3144,2414,1336384563,1336385319,0,3,756
27,3144,2442,1336385319,1336385713,0,3,394
27,3144,2415,1336385713,1336385773,0,3,60
27,3145,2415,1336559180,1336559240,0,1,60
27,3146,2413,1336610110,1336610170,0,1,60
27,3147,2413,1336696627,1336696687,0,1,60
27,3148,2414,1336730090,1336731657,0,2,1567
27,3148,2415,1336731657,1336731717,0,2,60
27,3149,2443,1336801111,1336801311,0,6,200
27,3149,2444,1336801311,1336802240,0,6,929
27,3149,2438,1336802240,1336805710,0,6,3470
27,3149,2428,1336805710,1336810006,0,6,4296
27,3149,2414,1336810006,1336810722,0,6,716
27,3149,2415,1336810722,1336810782,0,6,60
27,3150,2415,1336954834,1336956081,0,2,1247
27,3150,2413,1336956081,1336956141,0,2,60
27,3151,2414,1336989311,1336989371,0,1,60
27,3152,2413,1337041839,1337041899,0,1,60
27,3153,2413,1337128115,1337128175,0,1,60
27,3154,2414,1337163408,1337164354,0,2,946
27,3154,2415,1337164354,1337164414,0,2,60
27,3155,2413,1337214749,1337214809,0,1,60
27,3156,2098,1337248012,1337249318,0,7,1306
27,3156,2445,1337249318,1337251706,0,7,2388
27,3156,2446,1337251706,1337252344,0,7,638
27,3156,790,1337252344,1337252605,0,7,261
27,3156,834,1337252605,1337255829,0,7,3224
27,3156,2414,1337255829,1337257112,0,7,1283
27,3156,2415,1337257112,1337257172,0,7,60
27,3157,2415,1337431125,1337431185,0,1,60
27,3158,2447,1337593165,1337593225,0,1,60
27,3159,2413,1337649405,1337649465,0,1,60
27,3160,2448,1337945772,1337946945,0,4,1173
27,3160,2449,1337946945,1337947334,0,4,389
27,3160,2415,1337947334,1337947606,0,4,272
27,3160,2414,1337947606,1337947666,0,4,60
27,3161,1712,1337993113,1338003317,0,7,10204
27,3161,2450,1338003317,1338004174,0,7,857
27,3161,2451,1338004174,1338004781,0,7,607
27,3161,253,1338004781,1338005425,0,7,644
27,3161,370,1338005425,1338006877,0,7,1452
27,3161,2452,1338006877,1338007441,0,7,564
27,3161,1761,1338007441,1338007501,0,7,60
27,3162,2453,1338095463,1338095912,0,5,449
27,3162,2429,1338095912,1338099344,0,5,3432
27,3162,2454,1338099344,1338100128,0,5,784
27,3162,2415,1338100128,1338100459,0,5,331
27,3162,2414,1338100459,1338100519,0,5,60
27,3163,2413,1338168149,1338168209,0,1,60
27,3164,2413,1338252004,1338252064,0,1,60
27,3165,2424,1338285054,1338285097,0,3,43
27,3165,2414,1338285097,1338286008,0,3,911
27,3165,2415,1338286008,1338286068,0,3,60
27,3166,2413,1338338169,1338338229,0,1,60
27,3167,2414,1338544966,1338546165,0,2,1199
27,3167,2415,1338546165,1338546225,0,2,60
27,3168,2414,1338718908,1338720357,0,2,1449
27,3168,2415,1338720357,1338720417,0,2,60
27,3169,2413,1338770348,1338770408,0,1,60
27,3170,2455,1338803953,1338805093,0,5,1140
27,3170,2456,1338805093,1338807667,0,5,2574
27,3170,2457,1338807667,1338807747,0,5,80
27,3170,2458,1338807747,1338816711,0,5,8964
27,3170,138,1338816711,1338816771,0,5,60
27,3171,2414,1338889618,1338890404,0,2,786
27,3171,2442,1338890404,1338890464,0,2,60
27,3172,2415,1338975597,1338975725,0,3,128
27,3172,2424,1338975725,1338976285,0,3,560
27,3172,2414,1338976285,1338976345,0,3,60
27,3173,2415,1339062555,1339062615,0,1,60
27,3174,2415,1339112498,1339116545,0,2,4047
27,3174,2413,1339116545,1339116605,0,2,60
27,3175,2459,1339303563,1339306255,0,4,2692
27,3175,347,1339306255,1339306901,0,4,646
27,3175,2428,1339306901,1339315505,0,4,8604
27,3175,2414,1339315505,1339315565,0,4,60
27,3176,2413,1339374510,1339374570,0,1,60
27,3177,2415,1339408483,1339408543,0,1,60
27,3178,2414,1339495671,1339496619,0,2,948
27,3178,2415,1339496619,1339496679,0,2,60
27,3179,2413,1339551292,1339551352,0,1,60
27,3180,2414,1339582686,1339584067,0,2,1381
27,3180,2415,1339584067,1339584127,0,2,60
27,3181,2413,1339635274,1339635334,0,1,60
27,3182,2415,1339667069,1339667583,0,3,514
27,3182,2438,1339667583,1339670900,0,3,3317
27,3182,2429,1339670900,1339670960,0,3,60
27,3183,2414,1339754575,1339755366,0,2,791
27,3183,2415,1339755366,1339755426,0,2,60
27,3184,2450,1340763258,1340763318,0,1,60
27,3185,2414,1340788898,1340790352,0,2,1454
27,3185,2415,1340790352,1340790412,0,2,60
27,3186,2460,1341102453,1341102513,0,1,60
27,3187,647,1341278049,1341278180,0,5,131
27,3187,2461,1341278180,1341281273,0,5,3093
27,3187,2462,1341281273,1341292326,0,5,11053
27,3187,2414,1341292326,1341294516,0,5,2190
27,3187,2415,1341294516,1341294576,0,5,60
27,3188,2413,1341362282,1341362342,0,1,60
27,3189,2463,1341399250,1341399794,0,2,544
27,3189,2415,1341399794,1341399854,0,2,60
27,3190,1706,1341534581,1341534641,0,1,60
27,3191,2464,1341620308,1341620368,0,1,60
27,3192,2414,1341643184,1341656470,0,3,13286
27,3192,2465,1341656470,1341659312,0,3,2842
27,3192,2466,1341659312,1341659372,0,3,60
27,3193,2429,1341717790,1341731290,0,5,13500
27,3193,2415,1341731290,1341734650,0,5,3360
27,3193,2413,1341734650,1341736827,0,5,2177
27,3193,2466,1341736827,1341738089,0,5,1262
27,3193,2414,1341738089,1341738149,0,5,60
27,3194,2467,1341789073,1341789133,0,1,60
27,3195,400,1341873123,1341873183,0,1,60
27,3196,2450,1341970205,1341970265,0,1,60
27,3197,2414,1342087932,1342088122,0,2,190
27,3197,2415,1342088122,1342088182,0,2,60
27,3198,2468,1342147753,1342155398,0,2,7645
27,3198,2469,1342155398,1342155458,0,2,60
27,3199,2414,1342174639,1342175308,0,2,669
27,3199,2415,1342175308,1342175368,0,2,60
27,3200,2470,1342220034,1342220094,0,1,60
27,3201,2471,1342249250,1342259143,0,4,9893
27,3201,2463,1342259143,1342259828,0,4,685
27,3201,2414,1342259828,1342261090,0,4,1262
27,3201,2415,1342261090,1342261150,0,4,60
27,3202,2443,1342341073,1342342733,0,3,1660
27,3202,2414,1342342733,1342344130,0,3,1397
27,3202,2415,1342344130,1342344190,0,3,60
27,3203,1710,1342393551,1342393611,0,1,60
27,3204,2472,1342488745,1342496866,0,2,8121
27,3204,2415,1342496866,1342496926,0,2,60
27,3205,2473,1343116460,1343119924,0,2,3464
27,3205,2455,1343119924,1343119984,0,2,60
27,3206,2414,1344937814,1344937874,0,1,60
27,3207,2474,1345166132,1345166192,0,1,60
27,3208,2414,1345290116,1345291496,0,2,1380
27,3208,2415,1345291496,1345291556,0,2,60
27,3209,2475,1345425324,1345432528,0,2,7204
27,3209,2413,1345432528,1345432588,0,2,60
27,3210,2434,1345458963,1345459078,0,3,115
27,3210,2414,1345459078,1345460016,0,3,938
27,3210,2415,1345460016,1345460076,0,3,60
27,3211,2474,1347524904,1347538376,0,3,13472
27,3211,2414,1347538376,1347539040,0,3,664
27,3211,2415,1347539040,1347539100,0,3,60
27,3212,2476,1347624371,1347624806,0,3,435
27,3212,2414,1347624806,1347625504,0,3,698
27,3212,2415,1347625504,1347625564,0,3,60
27,3213,2477,1347723832,1347723892,0,1,60
27,3214,2474,1347758828,1347758888,0,1,60
27,3215,2465,1349685123,1349685183,0,1,60
27,3216,2478,1350000941,1350001001,0,1,60
27,3217,2479,1350028383,1350030246,0,2,1863
27,3217,2414,1350030246,1350030306,0,2,60
27,3218,2474,1350091964,1350092024,0,1,60
27,3219,2480,1350130177,1350130237,0,1,60
27,3220,2474,1350893082,1350896802,0,4,3720
27,3220,2481,1350896802,1350899994,0,4,3192
27,3220,2482,1350899994,1350900880,0,4,886
27,3220,2483,1350900880,1350900940,0,4,60
27,3221,2478,1350950924,1350950984,0,1,60
27,3222,2415,1350980031,1350980091,0,1,60
27,3223,2478,1351037409,1351037469,0,1,60
27,3224,2474,1351065926,1351080369,0,2,14443
27,3224,2415,1351080369,1351080429,0,2,60
27,3225,2478,1351210551,1351210611,0,1,60
27,3226,2446,1351237800,1351238321,0,2,521
27,3226,2484,1351238321,1351238381,0,2,60
27,3227,2485,1351310271,1351312029,0,6,1758
27,3227,2486,1351312029,1351312300,0,6,271
27,3227,2487,1351312300,1351318320,0,6,6020
27,3227,2488,1351318320,1351326946,0,6,8626
27,3227,253,1351326946,1351330521,0,6,3575
27,3227,2489,1351330521,1351330581,0,6,60
27,3228,2448,1351334311,1351334371,0,1,60
27,3229,2414,1351498360,1351499166,0,2,806
27,3229,2415,1351499166,1351499226,0,2,60
27,3230,2415,1351671007,1351671067,0,1,60
27,3231,2415,1352188310,1352188370,0,1,60
27,3232,2490,1352276046,1352281319,0,5,5273
27,3232,2453,1352281319,1352282020,0,5,701
27,3232,2424,1352282020,1352282134,0,5,114
27,3232,2415,1352282134,1352282490,0,5,356
27,3232,2414,1352282490,1352282550,0,5,60
27,3233,347,1352609279,1352613355,0,2,4076
27,3233,2491,1352613355,1352613415,0,2,60
27,3234,2414,1352721678,1352723056,0,2,1378
27,3234,2415,1352723056,1352723116,0,2,60
27,3235,2478,1352764918,1352764978,0,1,60
27,3236,2431,1353023998,1353024611,0,2,613
27,3236,2478,1353024611,1353024671,0,2,60
27,3237,2492,1353052730,1353052980,0,3,250
27,3237,2490,1353052980,1353054588,0,3,1608
27,3237,2491,1353054588,1353054648,0,3,60
27,3238,2414,1353151674,1353153141,0,2,1467
27,3238,2415,1353153141,1353153201,0,2,60
27,3239,2415,1353239716,1353239776,0,1,60
27,3240,2414,1353397787,1353398653,0,2,866
27,3240,2415,1353398653,1353398713,0,2,60
27,3241,2478,1353456153,1353456213,0,1,60
27,3242,2453,1353664406,1353665624,0,5,1218
27,3242,2493,1353665624,1353666227,0,5,603
27,3242,2438,1353666227,1353670026,0,5,3799
27,3242,2414,1353670026,1353671066,0,5,1040
27,3242,2415,1353671066,1353671126,0,5,60
27,3243,2432,1353721701,1353728262,0,3,6561
27,3243,2494,1353728262,1353729710,0,3,1448
27,3243,2414,1353729710,1353729770,0,3,60
27,3244,2495,1353835981,1353836976,0,3,995
27,3244,2496,1353836976,1353838263,0,3,1287
27,3244,2458,1353838263,1353838323,0,3,60
27,3245,2478,1353888438,1353888498,0,1,60
27,3246,2018,1353915808,1353918912,0,2,3104
27,3246,1499,1353918912,1353918972,0,2,60
27,3247,2414,1354521980,1354522040,0,1,60
27,3248,2414,1354608143,1354609176,0,2,1033
27,3248,2415,1354609176,1354609236,0,2,60
27,3249,2414,1354696841,1354696861,0,4,20
27,3249,2434,1354696861,1354697109,0,4,248
27,3249,2414,1354697109,1354697822,0,4,713
27,3249,2415,1354697822,1354697882,0,4,60
27,3250,2414,1354872264,1354873344,0,2,1080
27,3250,2415,1354873344,1354873404,0,2,60
27,3251,2445,1355016101,1355016161,0,1,60
27,3252,2414,1355394934,1355394994,0,1,60
27,3253,2414,1355740672,1355740732,0,1,60
27,3254,2414,1355827258,1355827318,0,1,60
27,3255,2497,1356253804,1356253864,0,1,60
27,3256,2498,1356598110,1356598170,0,1,60
27,3257,2463,1356682087,1356682760,0,3,673
27,3257,2414,1356682760,1356684183,0,3,1423
27,3257,2415,1356684183,1356684243,0,3,60
27,3258,2498,1357133167,1357133227,0,1,60
27,3259,171,1357279128,1357280830,0,5,1702
27,3259,104,1357280830,1357281922,0,5,1092
27,3259,2499,1357281922,1357292172,0,5,10250
27,3259,2500,1357292172,1357292427,0,5,255
27,3259,2501,1357292427,1357292487,0,5,60
27,3260,2478,1357517902,1357517962,0,1,60
27,3261,2414,1357547107,1357547167,0,1,60
27,3262,2454,1357632991,1357633051,0,1,60
27,3263,2478,1357776628,1357776688,0,1,60
27,3264,2463,1357890847,1357892252,0,2,1405
27,3264,2415,1357892252,1357892312,0,2,60
27,3265,2460,1357948756,1357950191,0,3,1435
27,3265,2414,1357950191,1357951114,0,3,923
27,3265,2415,1357951114,1357951174,0,3,60
27,3266,2413,1358413208,1358413268,0,1,60
27,3267,2414,1358498447,1358498507,0,1,60
27,3268,2414,1358762635,1358763407,0,2,772
27,3268,2415,1358763407,1358763467,0,2,60
27,3269,2478,1358812706,1358812766,0,1,60
27,3270,2498,1358844719,1358844779,0,1,60
27,3271,2414,1359273248,1359274476,0,2,1228
27,3271,2415,1359274476,1359274536,0,2,60
27,3272,2478,1359331127,1359331187,0,1,60
27,3273,2498,1359359579,1359359639,0,1,60
27,3274,2450,1359454580,1359454640,0,1,60
27,3275,2478,1359504732,1359504792,0,1,60
27,3276,2415,1359533498,1359533558,0,1,60
27,3277,2478,1359590885,1359590945,0,1,60
27,3278,2502,1359616796,1359616856,0,1,60
27,3279,2414,1359706725,1359707719,0,2,994
27,3279,2415,1359707719,1359707779,0,2,60
27,3280,2478,1360022899,1360022959,0,1,60
27,3281,2474,1360052016,1360061822,0,4,9806
27,3281,347,1360061822,1360062551,0,4,729
27,3281,2415,1360062551,1360062766,0,4,215
27,3281,2414,1360062766,1360062826,0,4,60
27,3282,2478,1360195812,1360195872,0,1,60
27,3283,2479,1360224046,1360224106,0,1,60
27,3284,2478,1360282002,1360282062,0,1,60
27,3285,2474,1360311226,1360311286,0,1,60
27,3286,2503,1360572051,1360585089,0,2,13038
27,3286,2458,1360585089,1360585149,0,2,60
27,3287,2478,1360628033,1360628093,0,1,60
27,3288,2478,1360714052,1360714112,0,1,60
28,3289,2474,1360831595,1360844496,0,3,12901
28,3289,2414,1360844496,1360844525,0,3,29
28,3289,2415,1360844525,1360844585,0,3,60
28,3290,35,1334306502,1334310427,0,3,3925
28,3290,231,1334310427,1334326484,0,3,16057
28,3290,35,1334326484,1334326544,0,3,60
28,3291,2504,1335521752,1335521812,0,1,60
28,3292,35,1335611103,1335611237,0,4,134
28,3292,2505,1335611237,1335618769,0,4,7532
28,3292,2019,1335618769,1335619350,0,4,581
28,3292,2506,1335619350,1335619410,0,4,60
28,3293,35,1336132973,1336134060,0,5,1087
28,3293,2098,1336134060,1336135387,0,5,1327
28,3293,2507,1336135387,1336138079,0,5,2692
28,3293,2508,1336138079,1336144128,0,5,6049
28,3293,35,1336144128,1336144188,0,5,60
28,3294,35,1336734649,1336735914,0,2,1265
28,3294,2509,1336735914,1336735974,0,2,60
28,3295,35,1336942393,1336942453,0,1,60
28,3296,35,1337247745,1337247805,0,1,60
28,3297,2510,1337389827,1337389887,0,1,60
28,3298,35,1337939515,1337939575,0,1,60
28,3299,35,1338090013,1338093362,0,2,3349
28,3299,2511,1338093362,1338093422,0,2,60
28,3300,287,1338564233,1338564293,0,1,60
28,3301,35,1339159920,1339162087,0,2,2167
28,3301,2512,1339162087,1339162147,0,2,60
28,3302,35,1339358887,1339358947,0,1,60
28,3303,2513,1339925720,1339940677,0,2,14957
28,3303,253,1339940677,1339940737,0,2,60
28,3304,715,1341218189,1341218249,0,1,60
28,3305,35,1341640276,1341641220,0,2,944
28,3305,2018,1341641220,1341641280,0,2,60
28,3306,802,1341711153,1341711213,0,1,60
28,3307,35,1342229372,1342231943,0,7,2571
28,3307,1315,1342231943,1342236736,0,7,4793
28,3307,541,1342236736,1342237951,0,7,1215
28,3307,23,1342237951,1342238211,0,7,260
28,3307,21,1342238211,1342243695,0,7,5484
28,3307,1110,1342243695,1342246767,0,7,3072
28,3307,2514,1342246767,1342246827,0,7,60
28,3308,802,1342258420,1342263258,0,4,4838
28,3308,2515,1342263258,1342270294,0,4,7036
28,3308,2512,1342270294,1342270602,0,4,308
28,3308,2516,1342270602,1342270662,0,4,60
28,3309,2517,1343123878,1343133212,0,3,9334
28,3309,287,1343133212,1343134016,0,3,804
28,3309,267,1343134016,1343134076,0,3,60
28,3310,35,1343483224,1343484640,0,2,1416
28,3310,21,1343484640,1343484700,0,2,60
28,3311,35,1345281106,1345281691,0,3,585
28,3311,1555,1345281691,1345284957,0,3,3266
28,3311,2518,1345284957,1345285017,0,3,60
28,3312,35,1345322099,1345335326,0,4,13227
28,3312,2155,1345335326,1345336296,0,4,970
28,3312,2153,1345336296,1345337187,0,4,891
28,3312,2519,1345337187,1345337247,0,4,60
28,3313,2520,1346902055,1346904209,0,6,2154
28,3313,1434,1346904209,1346905845,0,6,1636
28,3313,2521,1346905845,1346910401,0,6,4556
28,3313,8,1346910401,1346911183,0,6,782
28,3313,5,1346911183,1346912582,0,6,1399
28,3313,2522,1346912582,1346912642,0,6,60
28,3314,35,1347678366,1347680307,0,6,1941
28,3314,2195,1347680307,1347685676,0,6,5369
28,3314,28,1347685676,1347685868,0,6,192
28,3314,684,1347685868,1347687842,0,6,1974
28,3314,1505,1347687842,1347695095,0,6,7253
28,3314,2523,1347695095,1347695155,0,6,60
28,3315,2524,1347701151,1347701211,0,1,60
28,3316,35,1350037001,1350047030,0,2,10029
28,3316,2525,1350047030,1350047090,0,2,60
28,3317,2526,1350085257,1350100725,0,2,15468
28,3317,284,1350100725,1350100785,0,2,60
28,3318,2395,1350109638,1350112639,0,4,3001
28,3318,2517,1350112639,1350114964,0,4,2325
28,3318,2527,1350114964,1350118214,0,4,3250
28,3318,875,1350118214,1350118274,0,4,60
28,3319,2528,1350132077,1350138513,0,2,6436
28,3319,2529,1350138513,1350138573,0,2,60
28,3320,35,1351855190,1351856128,0,2,938
28,3320,480,1351856128,1351856188,0,2,60
28,3321,1555,1352714600,1352725954,0,2,11354
28,3321,35,1352725954,1352726014,0,2,60
28,3322,1555,1353094777,1353113654,0,3,18877
28,3322,35,1353113654,1353114949,0,3,1295
28,3322,902,1353114949,1353115009,0,3,60
28,3323,35,1353362989,1353363049,0,1,60
28,3324,2530,1353922045,1353924060,0,4,2015
28,3324,2531,1353924060,1353936880,0,4,12820
28,3324,2532,1353936880,1353939489,0,4,2609
28,3324,480,1353939489,1353939549,0,4,60
28,3325,2533,1354335658,1354338533,0,3,2875
28,3325,2020,1354338533,1354341407,0,3,2874
28,3325,21,1354341407,1354341467,0,3,60
28,3326,2534,1354378257,1354396809,0,2,18552
28,3326,35,1354396809,1354396869,0,2,60
28,3327,35,1354519016,1354519076,0,1,60
28,3328,284,1354583713,1354583773,0,1,60
28,3329,2535,1355053162,1355054619,0,3,1457
28,3329,2536,1355054619,1355055215,0,3,596
28,3329,2537,1355055215,1355055275,0,3,60
28,3330,284,1355118664,1355119845,0,9,1181
28,3330,2535,1355119845,1355120231,0,9,386
28,3330,703,1355120231,1355124994,0,9,4763
28,3330,253,1355124994,1355125056,0,9,62
28,3330,2538,1355125056,1355126176,0,9,1120
28,3330,2539,1355126176,1355127817,0,9,1641
28,3330,2540,1355127817,1355127993,0,9,176
28,3330,917,1355127993,1355128510,0,9,517
28,3330,2541,1355128510,1355128570,0,9,60
28,3331,802,1355637502,1355639565,0,4,2063
28,3331,2542,1355639565,1355647124,0,4,7559
28,3331,2395,1355647124,1355657492,0,4,10368
28,3331,2543,1355657492,1355657552,0,4,60
28,3332,2533,1355732811,1355732871,0,1,60
28,3333,99,1357453497,1357453557,0,1,60
28,3334,802,1358067502,1358067855,0,2,353
28,3334,2544,1358067855,1358067915,0,2,60
28,3335,802,1358499342,1358503148,0,4,3806
28,3335,2018,1358503148,1358504088,0,4,940
28,3335,2545,1358504088,1358504172,0,4,84
28,3335,2546,1358504172,1358504232,0,4,60
28,3336,802,1359101476,1359102191,0,3,715
28,3336,598,1359102191,1359107651,0,3,5460
28,3336,2547,1359107651,1359107711,0,3,60
28,3337,802,1359278253,1359293044,0,2,14791
28,3337,2517,1359293044,1359293104,0,2,60
28,3338,23,1359518856,1359519810,0,2,954
28,3338,2548,1359519810,1359519870,0,2,60
28,3339,2018,1359607567,1359607627,0,1,60
28,3340,2549,1359714854,1359717878,0,2,3024
28,3340,2550,1359717878,1359717938,0,2,60
28,3341,2551,1360148679,1360154846,0,2,6167
28,3341,1550,1360154846,1360154906,0,2,60
28,3342,802,1360236823,1360237345,0,3,522
28,3342,2533,1360237345,1360237805,0,3,460
28,3342,2552,1360237805,1360237865,0,3,60
28,3343,2553,1360317691,1360317720,0,2,29
28,3343,1799,1360317720,1360317780,0,2,60
28,3344,802,1360576527,1360577352,0,3,825
28,3344,2554,1360577352,1360585548,0,3,8196
28,3344,2555,1360585548,1360585608,0,3,60
28,3345,28,1360676706,1360676766,0,1,60
29,3346,284,1360703723,1360703783,0,1,60
29,3347,2556,1333493208,1333493268,0,1,60
29,3348,2557,1333532111,1333537148,0,7,5037
29,3348,2558,1333537148,1333538037,0,7,889
29,3348,253,1333538037,1333540290,0,7,2253
29,3348,2559,1333540290,1333540303,0,7,13
29,3348,100,1333540303,1333541299,0,7,996
29,3348,2560,1333541299,1333543828,0,7,2529
29,3348,254,1333543828,1333543888,0,7,60
29,3349,253,1333581000,1333581060,0,1,60
29,3350,2561,1333803388,1333803448,0,1,60
29,3351,2562,1333845029,1333845089,0,1,60
29,3352,2563,1333871566,1333871786,0,3,220
29,3352,288,1333871786,1333883439,0,3,11653
29,3352,2564,1333883439,1333883499,0,3,60
29,3353,2321,1333925613,1333925673,0,1,60
29,3354,253,1333975177,1333976370,0,3,1193
29,3354,2560,1333976370,1333983790,0,3,7420
29,3354,2565,1333983790,1333983850,0,3,60
29,3355,375,1334012187,1334013851,0,3,1664
29,3355,253,1334013851,1334015952,0,3,2101
29,3355,2557,1334015952,1334016012,0,3,60
29,3356,2558,1334055240,1334055300,0,1,60
29,3357,253,1334100708,1334102420,0,2,1712
29,3357,2557,1334102420,1334102480,0,2,60
29,3358,2557,1334140099,1334140906,0,4,807
29,3358,253,1334140906,1334141858,0,4,952
29,3358,100,1334141858,1334150316,0,4,8458
29,3358,2566,1334150316,1334150376,0,4,60
29,3359,2567,1334188584,1334188644,0,1,60
29,3360,253,1334227888,1334235050,0,2,7162
29,3360,651,1334235050,1334235110,0,2,60
29,3361,2557,1334291365,1334308533,0,2,17168
29,3361,2558,1334308533,1334308593,0,2,60
29,3362,2561,1334313219,1334313279,0,1,60
29,3363,2568,1334374842,1334377766,0,3,2924
29,3363,253,1334377766,1334378400,0,3,634
29,3363,2560,1334378400,1334378460,0,3,60
29,3364,284,1334454054,1334455209,0,3,1155
29,3364,5,1334455209,1334466220,0,3,11011
29,3364,242,1334466220,1334466280,0,3,60
29,3365,284,1334490707,1334490767,0,1,60
29,3366,2558,1334569153,1334569213,0,1,60
29,3367,2558,1334655952,1334655985,0,5,33
29,3367,2569,1334655985,1334658548,0,5,2563
29,3367,651,1334658548,1334666948,0,5,8400
29,3367,2570,1334666948,1334667266,0,5,318
29,3367,288,1334667266,1334667326,0,5,60
29,3368,253,1334705886,1334705946,0,1,60
29,3369,375,1334790035,1334790095,0,1,60
29,3370,2557,1334820272,1334829427,0,3,9155
29,3370,253,1334829427,1334840303,0,3,10876
29,3370,254,1334840303,1334840363,0,3,60
29,3371,2562,1334875468,1334877964,0,4,2496
29,3371,253,1334877964,1334879001,0,4,1037
29,3371,2567,1334879001,1334880326,0,4,1325
29,3371,2557,1334880326,1334880386,0,4,60
29,3372,284,1334916241,1334916257,0,2,16
29,3372,288,1334916257,1334916317,0,2,60
29,3373,2568,1334986112,1334986332,0,8,220
29,3373,2566,1334986332,1334987307,0,8,975
29,3373,2248,1334987307,1334987448,0,8,141
29,3373,2571,1334987448,1335000875,0,8,13427
29,3373,284,1335000875,1335002008,0,8,1133
29,3373,253,1335002008,1335002324,0,8,316
29,3373,2560,1335002324,1335005049,0,8,2725
29,3373,2572,1335005049,1335005109,0,8,60
29,3374,254,1335015962,1335019900,0,3,3938
29,3374,253,1335019900,1335022829,0,3,2929
29,3374,2566,1335022829,1335022889,0,3,60
29,3375,2557,1335149936,1335149996,0,1,60
29,3376,253,1335174767,1335188145,0,4,13378
29,3376,2248,1335188145,1335188158,0,4,13
29,3376,2571,1335188158,1335194900,0,4,6742
29,3376,2562,1335194900,1335194960,0,4,60
29,3377,2567,1335224423,1335225801,0,4,1378
29,3377,2557,1335225801,1335226339,0,4,538
29,3377,2557,1335226339,1335237636,0,4,11297
29,3377,2573,1335237636,1335237696,0,4,60
29,3378,2558,1335262351,1335269055,0,2,6704
29,3378,2569,1335269055,1335269115,0,2,60
29,3379,2558,1335354904,1335354958,0,4,54
29,3379,2567,1335354958,1335355400,0,4,442
29,3379,2326,1335355400,1335355554,0,4,154
29,3379,2574,1335355554,1335355614,0,4,60
29,3380,2568,1335393999,1335397244,0,4,3245
29,3380,253,1335397244,1335403562,0,4,6318
29,3380,2557,1335403562,1335415538,0,4,11976
29,3380,2573,1335415538,1335415598,0,4,60
29,3381,2558,1335432772,1335432794,0,5,22
29,3381,2569,1335432794,1335433714,0,5,920
29,3381,253,1335433714,1335453337,0,5,19623
29,3381,2575,1335453337,1335453365,0,5,28
29,3381,2556,1335453365,1335453425,0,5,60
29,3382,253,1335520958,1335521422,0,4,464
29,3382,100,1335521422,1335522412,0,4,990
29,3382,2559,1335522412,1335528073,0,4,5661
29,3382,2575,1335528073,1335528133,0,4,60
29,3383,2576,1335577475,1335577968,0,6,493
29,3383,2575,1335577968,1335578164,0,6,196
29,3383,2566,1335578164,1335579171,0,6,1007
29,3383,375,1335579171,1335581818,0,6,2647
29,3383,2577,1335581818,1335582102,0,6,284
29,3383,12,1335582102,1335582162,0,6,60
29,3384,2578,1335599372,1335600064,0,5,692
29,3384,253,1335600064,1335600683,0,5,619
29,3384,2579,1335600683,1335609487,0,5,8804
29,3384,254,1335609487,1335614883,0,5,5396
29,3384,2580,1335614883,1335614943,0,5,60
29,3385,253,1335624784,1335624844,0,1,60
29,3386,2576,1335657214,1335657235,0,4,21
29,3386,2566,1335657235,1335657553,0,4,318
29,3386,2321,1335657553,1335660793,0,4,3240
29,3386,12,1335660793,1335660853,0,4,60
29,3387,32,1335686621,1335686753,0,6,132
29,3387,598,1335686753,1335686776,0,6,23
29,3387,5,1335686776,1335687081,0,6,305
29,3387,242,1335687081,1335696398,0,6,9317
29,3387,2581,1335696398,1335708050,0,6,11652
29,3387,284,1335708050,1335708110,0,6,60
29,3388,2566,1335709572,1335710156,0,3,584
29,3388,2576,1335710156,1335710486,0,3,330
29,3388,2576,1335710486,1335710546,0,3,60
29,3389,2575,1335913484,1335914199,0,6,715
29,3389,2321,1335914199,1335914960,0,6,761
29,3389,375,1335914960,1335917577,0,6,2617
29,3389,253,1335917577,1335919411,0,6,1834
29,3389,2557,1335919411,1335928003,0,6,8592
29,3389,2582,1335928003,1335928063,0,6,60
29,3390,2557,1335938599,1335950620,0,4,12021
29,3390,2558,1335950620,1335951639,0,4,1019
29,3390,253,1335951639,1335951931,0,4,292
29,3390,2560,1335951931,1335951991,0,4,60
29,3391,2583,1336045676,1336054859,0,2,9183
29,3391,2576,1336054859,1336054919,0,2,60
29,3392,2571,1336115898,1336116435,0,7,537
29,3392,2584,1336116435,1336117109,0,7,674
29,3392,284,1336117109,1336117146,0,7,37
29,3392,288,1336117146,1336118789,0,7,1643
29,3392,2585,1336118789,1336132911,0,7,14122
29,3392,2586,1336132911,1336134112,0,7,1201
29,3392,2564,1336134112,1336134172,0,7,60
29,3393,266,1336139901,1336144258,0,4,4357
29,3393,284,1336144258,1336145865,0,4,1607
29,3393,2566,1336145865,1336145882,0,4,17
29,3393,2575,1336145882,1336145942,0,4,60
29,3394,2576,1336192259,1336195155,0,8,2896
29,3394,572,1336195155,1336195360,0,8,205
29,3394,284,1336195360,1336195732,0,8,372
29,3394,1235,1336195732,1336196955,0,8,1223
29,3394,2587,1336196955,1336198017,0,8,1062
29,3394,256,1336198017,1336198017,0,8,0
29,3394,256,1336198017,1336198376,0,8,359
29,3394,2588,1336198376,1336198436,0,8,60
29,3395,2589,1336223282,1336223376,0,4,94
29,3395,2590,1336223376,1336229256,0,4,5880
29,3395,35,1336229256,1336232239,0,4,2983
29,3395,2575,1336232239,1336232299,0,4,60
29,3396,2576,1336261858,1336264039,0,3,2181
29,3396,2575,1336264039,1336264083,0,3,44
29,3396,2566,1336264083,1336264143,0,3,60
29,3397,2566,1336344154,1336345250,0,6,1096
29,3397,375,1336345250,1336346879,0,6,1629
29,3397,253,1336346879,1336348338,0,6,1459
29,3397,2591,1336348338,1336350288,0,6,1950
29,3397,2557,1336350288,1336364248,0,6,13960
29,3397,2582,1336364248,1336364308,0,6,60
29,3398,2557,1336381730,1336382921,0,9,1191
29,3398,2558,1336382921,1336383432,0,9,511
29,3398,2567,1336383432,1336384349,0,9,917
29,3398,253,1336384349,1336393621,0,9,9272
29,3398,2560,1336393621,1336399091,0,9,5470
29,3398,2580,1336399091,1336401886,0,9,2795
29,3398,2566,1336401886,1336401911,0,9,25
29,3398,2575,1336401911,1336402396,0,9,485
29,3398,2576,1336402396,1336402456,0,9,60
29,3399,2576,1336430578,1336430638,0,1,60
29,3400,2567,1336485009,1336489113,0,4,4104
29,3400,2566,1336489113,1336489128,0,4,15
29,3400,2568,1336489128,1336489685,0,4,557
29,3400,2576,1336489685,1336489745,0,4,60
29,3401,2576,1336516346,1336517177,0,8,831
29,3401,2575,1336517177,1336517662,0,8,485
29,3401,2321,1336517662,1336518823,0,8,1161
29,3401,284,1336518823,1336519647,0,8,824
29,3401,253,1336519647,1336521979,0,8,2332
29,3401,2592,1336521979,1336522225,0,8,246
29,3401,2593,1336522225,1336523201,0,8,976
29,3401,2557,1336523201,1336523261,0,8,60
29,3402,2558,1336560805,1336560945,0,10,140
29,3402,2593,1336560945,1336562343,0,10,1398
29,3402,253,1336562343,1336562458,0,10,115
29,3402,100,1336562458,1336566058,0,10,3600
29,3402,2594,1336566058,1336567127,0,10,1069
29,3402,2559,1336567127,1336571640,0,10,4513
29,3402,253,1336571640,1336574598,0,10,2958
29,3402,2566,1336574598,1336574789,0,10,191
29,3402,2556,1336574789,1336575335,0,10,546
29,3402,2576,1336575335,1336575395,0,10,60
29,3403,2576,1336603702,1336603721,0,6,19
29,3403,2561,1336603721,1336604432,0,6,711
29,3403,375,1336604432,1336606419,0,6,1987
29,3403,253,1336606419,1336607766,0,6,1347
29,3403,2593,1336607766,1336608322,0,6,556
29,3403,2557,1336608322,1336608382,0,6,60
29,3404,2576,1336686038,1336689773,0,8,3735
29,3404,2566,1336689773,1336690552,0,8,779
29,3404,375,1336690552,1336691428,0,8,876
29,3404,2595,1336691428,1336692215,0,8,787
29,3404,253,1336692215,1336693431,0,8,1216
29,3404,2567,1336693431,1336693494,0,8,63
29,3404,2593,1336693494,1336706401,0,8,12907
29,3404,2582,1336706401,1336706461,0,8,60
29,3405,2557,1336712908,1336728788,0,6,15880
29,3405,2558,1336728788,1336732489,0,6,3701
29,3405,2569,1336732489,1336733433,0,6,944
29,3405,253,1336733433,1336734256,0,6,823
29,3405,314,1336734256,1336734272,0,6,16
29,3405,428,1336734272,1336734332,0,6,60
29,3406,449,1336739886,1336742226,0,4,2340
29,3406,2596,1336742226,1336756784,0,4,14558
29,3406,2597,1336756784,1336758872,0,4,2088
29,3406,2576,1336758872,1336758932,0,4,60
29,3407,2575,1336788013,1336788739,0,6,726
29,3407,2571,1336788739,1336789101,0,6,362
29,3407,284,1336789101,1336790007,0,6,906
29,3407,2598,1336790007,1336790552,0,6,545
29,3407,5,1336790552,1336790656,0,6,104
29,3407,242,1336790656,1336790716,0,6,60
29,3408,2599,1336831356,1336832402,0,6,1046
29,3408,5,1336832402,1336834192,0,6,1790
29,3408,284,1336834192,1336835723,0,6,1531
29,3408,798,1336835723,1336836671,0,6,948
29,3408,2600,1336836671,1336852833,0,6,16162
29,3408,2601,1336852833,1336852893,0,6,60
29,3409,2602,1336853898,1336857047,0,4,3149
29,3409,284,1336857047,1336858979,0,4,1932
29,3409,2566,1336858979,1336859013,0,4,34
29,3409,2568,1336859013,1336859073,0,4,60
29,3410,2603,1336948878,1336948899,0,8,21
29,3410,2575,1336948899,1336949441,0,8,542
29,3410,2321,1336949441,1336949752,0,8,311
29,3410,375,1336949752,1336951529,0,8,1777
29,3410,253,1336951529,1336952931,0,8,1402
29,3410,2567,1336952931,1336953285,0,8,354
29,3410,2593,1336953285,1336953899,0,8,614
29,3410,2557,1336953899,1336953959,0,8,60
29,3411,2557,1336978927,1336987405,0,3,8478
29,3411,2558,1336987405,1336988271,0,3,866
29,3411,2569,1336988271,1336988331,0,3,60
29,3412,624,1337006969,1337009903,0,3,2934
29,3412,2566,1337009903,1337009931,0,3,28
29,3412,2575,1337009931,1337009991,0,3,60
29,3413,2321,1337035805,1337036260,0,9,455
29,3413,375,1337036260,1337037994,0,9,1734
29,3413,253,1337037994,1337039477,0,9,1483
29,3413,2567,1337039477,1337039499,0,9,22
29,3413,2593,1337039499,1337040403,0,9,904
29,3413,2604,1337040403,1337040495,0,9,92
29,3413,2557,1337040495,1337051471,0,9,10976
29,3413,2605,1337051471,1337055531,0,9,4060
29,3413,2557,1337055531,1337055591,0,9,60
29,3414,2558,1337074420,1337092678,0,3,18258
29,3414,2569,1337092678,1337094862,0,3,2184
29,3414,284,1337094862,1337094922,0,3,60
29,3415,2561,1337097263,1337097323,0,1,60
29,3416,253,1337125426,1337126687,0,3,1261
29,3416,2593,1337126687,1337137450,0,3,10763
29,3416,2605,1337137450,1337137510,0,3,60
29,3417,2557,1337148909,1337165015,0,5,16106
29,3417,2558,1337165015,1337165430,0,5,415
29,3417,2567,1337165430,1337166382,0,5,952
29,3417,253,1337166382,1337166832,0,5,450
29,3417,100,1337166832,1337166892,0,5,60
29,3418,2559,1337173391,1337174307,0,5,916
29,3418,59,1337174307,1337178026,0,5,3719
29,3418,2566,1337178026,1337178063,0,5,37
29,3418,2606,1337178063,1337178534,0,5,471
29,3418,2575,1337178534,1337178594,0,5,60
29,3419,375,1337209009,1337210686,0,5,1677
29,3419,2580,1337210686,1337210710,0,5,24
29,3419,253,1337210710,1337211707,0,5,997
29,3419,2593,1337211707,1337212059,0,5,352
29,3419,2592,1337212059,1337212119,0,5,60
29,3420,2558,1337245476,1337245916,0,8,440
29,3420,2591,1337245916,1337247237,0,8,1321
29,3420,253,1337247237,1337248958,0,8,1721
29,3420,651,1337248958,1337255501,0,8,6543
29,3420,2560,1337255501,1337261561,0,8,6060
29,3420,375,1337261561,1337262658,0,8,1097
29,3420,2566,1337262658,1337262696,0,8,38
29,3420,2556,1337262696,1337262756,0,8,60
29,3421,2561,1337296737,1337296751,0,2,14
29,3421,2566,1337296751,1337296811,0,2,60
29,3422,2607,1337341900,1337354139,0,3,12239
29,3422,2566,1337354139,1337354346,0,3,207
29,3422,2603,1337354346,1337354406,0,3,60
29,3423,2576,1337380346,1337393796,0,5,13450
29,3423,2566,1337393796,1337394217,0,5,421
29,3423,2571,1337394217,1337394274,0,5,57
29,3423,2608,1337394274,1337395856,0,5,1582
29,3423,253,1337395856,1337395916,0,5,60
29,3424,2580,1337407669,1337408158,0,11,489
29,3424,1070,1337408158,1337409209,0,11,1051
29,3424,2560,1337409209,1337410552,0,11,1343
29,3424,284,1337410552,1337414261,0,11,3709
29,3424,2609,1337414261,1337420377,0,11,6116
29,3424,288,1337420377,1337421277,0,11,900
29,3424,2610,1337421277,1337426259,0,11,4982
29,3424,284,1337426259,1337427515,0,11,1256
29,3424,2566,1337427515,1337427550,0,11,35
29,3424,2556,1337427550,1337428252,0,11,702
29,3424,2611,1337428252,1337428312,0,11,60
29,3425,2558,1337592790,1337593274,0,6,484
29,3425,2612,1337593274,1337593326,0,6,52
29,3425,2567,1337593326,1337594334,0,6,1008
29,3425,253,1337594334,1337610037,0,6,15703
29,3425,2566,1337610037,1337612138,0,6,2101
29,3425,2576,1337612138,1337612198,0,6,60
29,3426,2576,1337639329,1337642728,0,6,3399
29,3426,253,1337642728,1337643297,0,6,569
29,3426,2326,1337643297,1337644563,0,6,1266
29,3426,2593,1337644563,1337645285,0,6,722
29,3426,2557,1337645285,1337659917,0,6,14632
29,3426,2582,1337659917,1337659977,0,6,60
29,3427,2605,1337678451,1337679561,0,7,1110
29,3427,2613,1337679561,1337680754,0,7,1193
29,3427,2558,1337680754,1337682180,0,7,1426
29,3427,2569,1337682180,1337686335,0,7,4155
29,3427,2566,1337686335,1337686486,0,7,151
29,3427,2575,1337686486,1337689133,0,7,2647
29,3427,2603,1337689133,1337689193,0,7,60
29,3428,2576,1337788617,1337788677,0,1,60
29,3429,2561,1337812055,1337812433,0,7,378
29,3429,2566,1337812433,1337815716,0,7,3283
29,3429,253,1337815716,1337816926,0,7,1210
29,3429,2567,1337816926,1337816942,0,7,16
29,3429,2614,1337816942,1337818142,0,7,1200
29,3429,2557,1337818142,1337828722,0,7,10580
29,3429,2615,1337828722,1337828782,0,7,60
29,3430,2582,1337836011,1337846443,0,6,10432
29,3430,2557,1337846443,1337851285,0,6,4842
29,3430,2558,1337851285,1337851811,0,6,526
29,3430,2592,1337851811,1337851829,0,6,18
29,3430,2567,1337851829,1337852617,0,6,788
29,3430,253,1337852617,1337852677,0,6,60
29,3431,2558,1337938724,1337938755,0,10,31
29,3431,2593,1337938755,1337939032,0,10,277
29,3431,2567,1337939032,1337939723,0,10,691
29,3431,253,1337939723,1337939930,0,10,207
29,3431,253,1337939930,1337940188,0,10,258
29,3431,100,1337940188,1337944042,0,10,3854
29,3431,2559,1337944042,1337947337,0,10,3295
29,3431,2566,1337947337,1337947365,0,10,28
29,3431,2575,1337947365,1337947562,0,10,197
29,3431,2562,1337947562,1337947622,0,10,60
29,3432,2576,1337990759,1338008542,0,2,17783
29,3432,2616,1338008542,1338008602,0,2,60
29,3433,2603,1338014802,1338015097,0,12,295
29,3433,2575,1338015097,1338015123,0,12,26
29,3433,2566,1338015123,1338016416,0,12,1293
29,3433,284,1338016416,1338017831,0,12,1415
29,3433,5,1338017831,1338017986,0,12,155
29,3433,242,1338017986,1338018652,0,12,666
29,3433,230,1338018652,1338018855,0,12,203
29,3433,235,1338018855,1338020094,0,12,1239
29,3433,237,1338020094,1338020450,0,12,356
29,3433,42,1338020450,1338022833,0,12,2383
29,3433,2617,1338022833,1338023373,0,12,540
29,3433,46,1338023373,1338023433,0,12,60
29,3434,2576,1338081458,1338088922,0,7,7464
29,3434,2561,1338088922,1338089112,0,7,190
29,3434,2575,1338089112,1338089329,0,7,217
29,3434,2566,1338089329,1338091511,0,7,2182
29,3434,1235,1338091511,1338091890,0,7,379
29,3434,2589,1338091890,1338091920,0,7,30
29,3434,2588,1338091920,1338091980,0,7,60
29,3435,257,1338120777,1338122986,0,4,2209
29,3435,2566,1338122986,1338123259,0,4,273
29,3435,2575,1338123259,1338131314,0,4,8055
29,3435,2576,1338131314,1338131374,0,4,60
29,3436,375,1338159653,1338162097,0,6,2444
29,3436,253,1338162097,1338162571,0,6,474
29,3436,2567,1338162571,1338162594,0,6,23
29,3436,2612,1338162594,1338164001,0,6,1407
29,3436,2582,1338164001,1338173890,0,6,9889
29,3436,2557,1338173890,1338173950,0,6,60
29,3437,2558,1338197203,1338197789,0,6,586
29,3437,2567,1338197789,1338199401,0,6,1612
29,3437,253,1338199401,1338208755,0,6,9354
29,3437,2580,1338208755,1338212433,0,6,3678
29,3437,2566,1338212433,1338212459,0,6,26
29,3437,2575,1338212459,1338212519,0,6,60
29,3438,253,1338247911,1338248893,0,6,982
29,3438,2612,1338248893,1338248954,0,6,61
29,3438,2593,1338248954,1338250068,0,6,1114
29,3438,2582,1338250068,1338250157,0,6,89
29,3438,2557,1338250157,1338264982,0,6,14825
29,3438,2557,1338264982,1338265042,0,6,60
29,3439,2558,1338288876,1338289173,0,8,297
29,3439,2618,1338289173,1338289498,0,8,325
29,3439,2567,1338289498,1338290053,0,8,555
29,3439,253,1338290053,1338290620,0,8,567
29,3439,2560,1338290620,1338301945,0,8,11325
29,3439,2340,1338301945,1338302908,0,8,963
29,3439,2566,1338302908,1338302974,0,8,66
29,3439,2619,1338302974,1338303034,0,8,60
29,3440,2568,1338332106,1338332136,0,7,30
29,3440,2566,1338332136,1338335135,0,7,2999
29,3440,253,1338335135,1338335873,0,7,738
29,3440,2567,1338335873,1338335910,0,7,37
29,3440,2612,1338335910,1338350061,0,7,14151
29,3440,2605,1338350061,1338350562,0,7,501
29,3440,2582,1338350562,1338350622,0,7,60
29,3441,2557,1338354078,1338354138,0,1,60
29,3442,2580,1338470952,1338474118,0,3,3166
29,3442,2566,1338474118,1338474162,0,3,44
29,3442,2619,1338474162,1338474222,0,3,60
29,3443,2576,1338503379,1338503439,0,1,60
29,3444,2557,1338542811,1338543410,0,6,599
29,3444,2558,1338543410,1338546195,0,6,2785
29,3444,2573,1338546195,1338547287,0,6,1092
29,3444,253,1338547287,1338551582,0,6,4295
29,3444,2575,1338551582,1338552214,0,6,632
29,3444,2611,1338552214,1338552274,0,6,60
29,3445,2576,1338684304,1338684851,0,7,547
29,3445,2575,1338684851,1338684934,0,7,83
29,3445,2611,1338684934,1338685733,0,7,799
29,3445,375,1338685733,1338686992,0,7,1259
29,3445,1235,1338686992,1338687395,0,7,403
29,3445,762,1338687395,1338690219,0,7,2824
29,3445,2620,1338690219,1338690279,0,7,60
29,3446,256,1338706688,1338707699,0,13,1011
29,3446,35,1338707699,1338708608,0,13,909
29,3446,284,1338708608,1338708937,0,13,329
29,3446,266,1338708937,1338716852,0,13,7915
29,3446,2621,1338716852,1338717472,0,13,620
29,3446,2563,1338717472,1338717518,0,13,46
29,3446,2622,1338717518,1338722198,0,13,4680
29,3446,2623,1338722198,1338724414,0,13,2216
29,3446,2624,1338724414,1338724960,0,13,546
29,3446,2321,1338724960,1338725588,0,13,628
29,3446,2566,1338725588,1338725628,0,13,40
29,3446,2575,1338725628,1338725814,0,13,186
29,3446,2603,1338725814,1338725874,0,13,60
29,3447,2576,1338763323,1338765909,0,5,2586
29,3447,253,1338765909,1338766945,0,5,1036
29,3447,2567,1338766945,1338767500,0,5,555
29,3447,2591,1338767500,1338769344,0,5,1844
29,3447,2582,1338769344,1338769404,0,5,60
29,3448,2605,1338802247,1338802558,0,7,311
29,3448,2593,1338802558,1338802764,0,7,206
29,3448,2612,1338802764,1338802779,0,7,15
29,3448,2567,1338802779,1338804734,0,7,1955
29,3448,253,1338804734,1338819306,0,7,14572
29,3448,2620,1338819306,1338819773,0,7,467
29,3448,2588,1338819773,1338819833,0,7,60
29,3449,2576,1338849128,1338850999,0,8,1871
29,3449,2562,1338850999,1338851012,0,8,13
29,3449,2566,1338851012,1338853864,0,8,2852
29,3449,253,1338853864,1338854625,0,8,761
29,3449,2612,1338854625,1338855031,0,8,406
29,3449,2582,1338855031,1338855280,0,8,249
29,3449,2557,1338855280,1338865332,0,8,10052
29,3449,2605,1338865332,1338865392,0,8,60
29,3450,2557,1338887159,1338889042,0,10,1883
29,3450,2613,1338889042,1338890237,0,10,1195
29,3450,2625,1338890237,1338890623,0,10,386
29,3450,2558,1338890623,1338891055,0,10,432
29,3450,2569,1338891055,1338891757,0,10,702
29,3450,253,1338891757,1338891850,0,10,93
29,3450,2560,1338891850,1338892544,0,10,694
29,3450,254,1338892544,1338898390,0,10,5846
29,3450,2626,1338898390,1338903459,0,10,5069
29,3450,2566,1338903459,1338903519,0,10,60
29,3451,2557,1338985153,1338988780,0,8,3627
29,3451,2582,1338988780,1338989265,0,8,485
29,3451,2558,1338989265,1338991341,0,8,2076
29,3451,253,1338991341,1338993763,0,8,2422
29,3451,2566,1338993763,1338993938,0,8,175
29,3451,2562,1338993938,1338994179,0,8,241
29,3451,2611,1338994179,1338994773,0,8,594
29,3451,2576,1338994773,1338994833,0,8,60
29,3452,2576,1339022162,1339022464,0,6,302
29,3452,2566,1339022464,1339023383,0,6,919
29,3452,375,1339023383,1339025106,0,6,1723
29,3452,253,1339025106,1339026328,0,6,1222
29,3452,2567,1339026328,1339027031,0,6,703
29,3452,2627,1339027031,1339027091,0,6,60
29,3453,2605,1339061945,1339062157,0,7,212
29,3453,2573,1339062157,1339062603,0,7,446
29,3453,2612,1339062603,1339062621,0,7,18
29,3453,2567,1339062621,1339077088,0,7,14467
29,3453,2628,1339077088,1339078961,0,7,1873
29,3453,2566,1339078961,1339078988,0,7,27
29,3453,2619,1339078988,1339079048,0,7,60
29,3454,2576,1339108532,1339108879,0,5,347
29,3454,2575,1339108879,1339109008,0,5,129
29,3454,2566,1339109008,1339112963,0,5,3955
29,3454,2627,1339112963,1339113816,0,5,853
29,3454,2582,1339113816,1339113876,0,5,60
29,3455,2564,1339162807,1339168235,0,6,5428
29,3455,284,1339168235,1339169472,0,6,1237
29,3455,2321,1339169472,1339170146,0,6,674
29,3455,2566,1339170146,1339170283,0,6,137
29,3455,2603,1339170283,1339170582,0,6,299
29,3455,2611,1339170582,1339170642,0,6,60
29,3456,2568,1339207333,1339207393,0,1,60
29,3457,2603,1339233460,1339245327,0,2,11867
29,3457,2576,1339245327,1339245387,0,2,60
29,3458,2576,1339255310,1339255370,0,1,60
29,3459,2619,1339306290,1339306711,0,4,421
29,3459,2562,1339306711,1339307019,0,4,308
29,3459,2603,1339307019,1339310797,0,4,3778
29,3459,2611,1339310797,1339310857,0,4,60
29,3460,2576,1339339537,1339339597,0,1,60
29,3461,2576,1339368396,1339368406,0,8,10
29,3461,2566,1339368406,1339369201,0,8,795
29,3461,375,1339369201,1339371191,0,8,1990
29,3461,253,1339371191,1339372300,0,8,1109
29,3461,2612,1339372300,1339373374,0,8,1074
29,3461,2591,1339373374,1339373437,0,8,63
29,3461,2627,1339373437,1339374522,0,8,1085
29,3461,2557,1339374522,1339374582,0,8,60
29,3462,2605,1339392792,1339393978,0,7,1186
29,3462,2582,1339393978,1339394375,0,7,397
29,3462,2557,1339394375,1339406805,0,7,12430
29,3462,2558,1339406805,1339407206,0,7,401
29,3462,2593,1339407206,1339407518,0,7,312
29,3462,2567,1339407518,1339407975,0,7,457
29,3462,253,1339407975,1339408035,0,7,60
29,3463,2560,1339421812,1339422132,0,5,320
29,3463,2629,1339422132,1339423245,0,5,1113
29,3463,253,1339423245,1339426245,0,5,3000
29,3463,2561,1339426245,1339430288,0,5,4043
29,3463,2576,1339430288,1339430348,0,5,60
29,3464,2575,1339454558,1339454610,0,8,52
29,3464,2566,1339454610,1339455405,0,8,795
29,3464,375,1339455405,1339457086,0,8,1681
29,3464,253,1339457086,1339458082,0,8,996
29,3464,2612,1339458082,1339458233,0,8,151
29,3464,2627,1339458233,1339459667,0,8,1434
29,3464,2557,1339459667,1339471231,0,8,11564
29,3464,2605,1339471231,1339471291,0,8,60
29,3465,2557,1339484546,1339493405,0,11,8859
29,3465,2613,1339493405,1339494420,0,11,1015
29,3465,2618,1339494420,1339495586,0,11,1166
29,3465,2593,1339495586,1339495720,0,11,134
29,3465,2612,1339495720,1339495928,0,11,208
29,3465,2614,1339495928,1339498302,0,11,2374
29,3465,253,1339498302,1339500519,0,11,2217
29,3465,2566,1339500519,1339500805,0,11,286
29,3465,2575,1339500805,1339501066,0,11,261
29,3465,2603,1339501066,1339501808,0,11,742
29,3465,2611,1339501808,1339501868,0,11,60
29,3466,2576,1339527280,1339543496,0,7,16216
29,3466,2576,1339543496,1339544211,0,7,715
29,3466,2562,1339544211,1339544225,0,7,14
29,3466,2566,1339544225,1339546433,0,7,2208
29,3466,253,1339546433,1339547399,0,7,966
29,3466,2567,1339547399,1339547415,0,7,16
29,3466,2612,1339547415,1339547475,0,7,60
29,3467,2605,1339556488,1339557607,0,3,1119
29,3467,2582,1339557607,1339563353,0,3,5746
29,3467,2557,1339563353,1339563413,0,3,60
29,3468,2614,1339579773,1339579793,0,14,20
29,3468,2567,1339579793,1339581020,0,14,1227
29,3468,253,1339581020,1339581377,0,14,357
29,3468,100,1339581377,1339582396,0,14,1019
29,3468,2630,1339582396,1339582821,0,14,425
29,3468,2631,1339582821,1339584308,0,14,1487
29,3468,2594,1339584308,1339584949,0,14,641
29,3468,2559,1339584949,1339587657,0,14,2708
29,3468,253,1339587657,1339591197,0,14,3540
29,3468,2566,1339591197,1339591528,0,14,331
29,3468,2632,1339591528,1339592613,0,14,1085
29,3468,2556,1339592613,1339593015,0,14,402
29,3468,2568,1339593015,1339596593,0,14,3578
29,3468,2576,1339596593,1339596653,0,14,60
29,3469,2576,1339626889,1339627265,0,11,376
29,3469,2561,1339627265,1339627292,0,11,27
29,3469,2568,1339627292,1339627303,0,11,11
29,3469,2566,1339627303,1339629975,0,11,2672
29,3469,253,1339629975,1339630771,0,11,796
29,3469,2567,1339630771,1339630835,0,11,64
29,3469,2612,1339630835,1339631182,0,11,347
29,3469,2627,1339631182,1339642887,0,11,11705
29,3469,2573,1339642887,1339643023,0,11,136
29,3469,2633,1339643023,1339643254,0,11,231
29,3469,2592,1339643254,1339643314,0,11,60
29,3470,2634,1339654879,1339656032,0,7,1153
29,3470,2557,1339656032,1339666956,0,7,10924
29,3470,2558,1339666956,1339666986,0,7,30
29,3470,2569,1339666986,1339668248,0,7,1262
29,3470,253,1339668248,1339668291,0,7,43
29,3470,254,1339668291,1339670460,0,7,2169
29,3470,2560,1339670460,1339670520,0,7,60
29,3471,2558,1339754694,1339756080,0,7,1386
29,3471,2567,1339756080,1339756958,0,7,878
29,3471,253,1339756958,1339763641,0,7,6683
29,3471,253,1339763641,1339767209,0,7,3568
29,3471,2566,1339767209,1339767457,0,7,248
29,3471,2635,1339767457,1339769192,0,7,1735
29,3471,2603,1339769192,1339769252,0,7,60
29,3472,2566,1339899882,1339900753,0,4,871
29,3472,284,1339900753,1339901611,0,4,858
29,3472,35,1339901611,1339902578,0,4,967
29,3472,257,1339902578,1339902638,0,4,60
29,3473,1680,1339929845,1339940312,0,5,10467
29,3473,35,1339940312,1339941595,0,5,1283
29,3473,1235,1339941595,1339944148,0,5,2553
29,3473,2566,1339944148,1339944337,0,5,189
29,3473,2556,1339944337,1339944397,0,5,60
29,3474,2566,1339972949,1339973128,0,9,179
29,3474,2575,1339973128,1339974098,0,9,970
29,3474,375,1339974098,1339976047,0,9,1949
29,3474,253,1339976047,1339977250,0,9,1203
29,3474,2567,1339977250,1339977267,0,9,17
29,3474,2612,1339977267,1339977771,0,9,504
29,3474,2557,1339977771,1339993729,0,9,15958
29,3474,2582,1339993729,1339994072,0,9,343
29,3474,2605,1339994072,1339994132,0,9,60
29,3475,2591,1339996660,1340007095,0,6,10435
29,3475,2557,1340007095,1340011060,0,6,3965
29,3475,2633,1340011060,1340011142,0,6,82
29,3475,2558,1340011142,1340012039,0,6,897
29,3475,253,1340012039,1340012253,0,6,214
29,3475,2560,1340012253,1340012313,0,6,60
29,3476,2629,1340027295,1340027834,0,4,539
29,3476,2580,1340027834,1340028109,0,4,275
29,3476,253,1340028109,1340032247,0,4,4138
29,3476,2636,1340032247,1340032307,0,4,60
29,3477,2634,1340100960,1340101011,0,3,51
29,3477,2558,1340101011,1340101862,0,3,851
29,3477,253,1340101862,1340101922,0,3,60
29,3478,2566,1340233085,1340235705,0,8,2620
29,3478,253,1340235705,1340236893,0,8,1188
29,3478,2567,1340236893,1340236906,0,8,13
29,3478,2612,1340236906,1340237457,0,8,551
29,3478,2627,1340237457,1340237858,0,8,401
29,3478,2582,1340237858,1340251347,0,8,13489
29,3478,2573,1340251347,1340252669,0,8,1322
29,3478,2605,1340252669,1340252729,0,8,60
29,3479,2557,1340265250,1340271276,0,9,6026
29,3479,2591,1340271276,1340271599,0,9,323
29,3479,2614,1340271599,1340271687,0,9,88
29,3479,2567,1340271687,1340272733,0,9,1046
29,3479,253,1340272733,1340272749,0,9,16
29,3479,2560,1340272749,1340283651,0,9,10902
29,3479,253,1340283651,1340285449,0,9,1798
29,3479,375,1340285449,1340285729,0,9,280
29,3479,2248,1340285729,1340285789,0,9,60
29,3480,2566,1340292402,1340292462,0,1,60
29,3481,2558,1340617019,1340618639,0,3,1620
29,3481,2580,1340618639,1340618666,0,3,27
29,3481,253,1340618666,1340618726,0,3,60
29,3482,2562,1340751347,1340751370,0,8,23
29,3482,2575,1340751370,1340751379,0,8,9
29,3482,2566,1340751379,1340753973,0,8,2594
29,3482,253,1340753973,1340755122,0,8,1149
29,3482,2591,1340755122,1340755510,0,8,388
29,3482,2582,1340755510,1340757618,0,8,2108
29,3482,2557,1340757618,1340765895,0,8,8277
29,3482,2605,1340765895,1340765955,0,8,60
29,3483,2614,1340792770,1340793554,0,5,784
29,3483,253,1340793554,1340794814,0,5,1260
29,3483,2637,1340794814,1340794838,0,5,24
29,3483,260,1340794838,1340812114,0,5,17276
29,3483,2562,1340812114,1340812174,0,5,60
29,3484,2576,1340816234,1340816294,0,1,60
29,3485,2638,1341116450,1341116510,0,1,60
29,3486,2613,1341220296,1341220458,0,6,162
29,3486,2558,1341220458,1341220670,0,6,212
29,3486,2569,1341220670,1341221742,0,6,1072
29,3486,253,1341221742,1341222862,0,6,1120
29,3486,2560,1341222862,1341237082,0,6,14220
29,3486,2566,1341237082,1341237142,0,6,60
29,3487,2561,1341262049,1341262392,0,9,343
29,3487,2575,1341262392,1341263212,0,9,820
29,3487,2566,1341263212,1341263967,0,9,755
29,3487,2248,1341263967,1341268447,0,9,4480
29,3487,2567,1341268447,1341268914,0,9,467
29,3487,2593,1341268914,1341269607,0,9,693
29,3487,2605,1341269607,1341274068,0,9,4461
29,3487,2582,1341274068,1341276559,0,9,2491
29,3487,2557,1341276559,1341276619,0,9,60
29,3488,2582,1341300023,1341300033,0,9,10
29,3488,2557,1341300033,1341307980,0,9,7947
29,3488,2627,1341307980,1341308403,0,9,423
29,3488,2558,1341308403,1341309261,0,9,858
29,3488,253,1341309261,1341310117,0,9,856
29,3488,1235,1341310117,1341311107,0,9,990
29,3488,35,1341311107,1341312122,0,9,1015
29,3488,2544,1341312122,1341315044,0,9,2922
29,3488,2590,1341315044,1341315104,0,9,60
29,3489,2576,1341350304,1341355606,0,5,5302
29,3489,2566,1341355606,1341358288,0,5,2682
29,3489,253,1341358288,1341359597,0,5,1309
29,3489,2567,1341359597,1341371147,0,5,11550
29,3489,2605,1341371147,1341371207,0,5,60
29,3490,2558,1341395698,1341396276,0,6,578
29,3490,2567,1341396276,1341397664,0,6,1388
29,3490,2630,1341397664,1341400075,0,6,2411
29,3490,2631,1341400075,1341404385,0,6,4310
29,3490,2559,1341404385,1341411757,0,6,7372
29,3490,253,1341411757,1341411817,0,6,60
29,3491,2619,1341418202,1341438686,0,2,20484
29,3491,2576,1341438686,1341438746,0,2,60
29,3492,2639,1341441122,1341444445,0,5,3323
29,3492,2567,1341444445,1341444585,0,5,140
29,3492,2614,1341444585,1341445331,0,5,746
29,3492,2612,1341445331,1341446419,0,5,1088
29,3492,2582,1341446419,1341446479,0,5,60
29,3493,2557,1341482850,1341483609,0,11,759
29,3493,2558,1341483609,1341484299,0,11,690
29,3493,2569,1341484299,1341485653,0,11,1354
29,3493,253,1341485653,1341486065,0,11,412
29,3493,100,1341486065,1341487597,0,11,1532
29,3493,2630,1341487597,1341489059,0,11,1462
29,3493,2631,1341489059,1341490178,0,11,1119
29,3493,253,1341490178,1341494535,0,11,4357
29,3493,2566,1341494535,1341495367,0,11,832
29,3493,2562,1341495367,1341495383,0,11,16
29,3493,2575,1341495383,1341495443,0,11,60
29,3494,2576,1341526497,1341529357,0,8,2860
29,3494,2590,1341529357,1341529787,0,8,430
29,3494,253,1341529787,1341530880,0,8,1093
29,3494,2567,1341530880,1341530897,0,8,17
29,3494,2640,1341530897,1341531104,0,8,207
29,3494,2593,1341531104,1341531985,0,8,881
29,3494,2582,1341531985,1341544793,0,8,12808
29,3494,2605,1341544793,1341544853,0,8,60
29,3495,2615,1341548354,1341559150,0,4,10796
29,3495,2557,1341559150,1341569823,0,4,10673
29,3495,2627,1341569823,1341569866,0,4,43
29,3495,2558,1341569866,1341569926,0,4,60
29,3496,253,1341571054,1341578212,0,4,7158
29,3496,314,1341578212,1341579350,0,4,1138
29,3496,253,1341579350,1341582691,0,4,3341
29,3496,2566,1341582691,1341582751,0,4,60
29,3497,2641,1341641780,1341645167,0,10,3387
29,3497,2566,1341645167,1341645941,0,10,774
29,3497,2571,1341645941,1341645957,0,10,16
29,3497,375,1341645957,1341647151,0,10,1194
29,3497,35,1341647151,1341647184,0,10,33
29,3497,2590,1341647184,1341647698,0,10,514
29,3497,762,1341647698,1341647808,0,10,110
29,3497,2588,1341647808,1341648698,0,10,890
29,3497,256,1341648698,1341655235,0,10,6537
29,3497,256,1341655235,1341655295,0,10,60
29,3498,2590,1341664588,1341672926,0,6,8338
29,3498,2589,1341672926,1341673972,0,6,1046
29,3498,284,1341673972,1341674264,0,6,292
29,3498,2623,1341674264,1341674283,0,6,19
29,3498,284,1341674283,1341676234,0,6,1951
29,3498,2566,1341676234,1341676294,0,6,60
29,3499,2576,1341687349,1341687409,0,1,60
29,3500,2562,1341711501,1341713319,0,8,1818
29,3500,2321,1341713319,1341714275,0,8,956
29,3500,284,1341714275,1341716282,0,8,2007
29,3500,288,1341716282,1341716726,0,8,444
29,3500,285,1341716726,1341727108,0,8,10382
29,3500,266,1341727108,1341727749,0,8,641
29,3500,2564,1341727749,1341732288,0,8,4539
29,3500,2642,1341732288,1341732348,0,8,60
29,3501,2622,1341738774,1341749136,0,5,10362
29,3501,284,1341749136,1341751157,0,5,2021
29,3501,2566,1341751157,1341751207,0,5,50
29,3501,2632,1341751207,1341752812,0,5,1605
29,3501,2576,1341752812,1341752872,0,5,60
29,3502,2575,1341787266,1341787279,0,7,13
29,3502,2566,1341787279,1341789098,0,7,1819
29,3502,284,1341789098,1341789916,0,7,818
29,3502,253,1341789916,1341791429,0,7,1513
29,3502,2627,1341791429,1341791769,0,7,340
29,3502,2582,1341791769,1341792945,0,7,1176
29,3502,2557,1341792945,1341793005,0,7,60
29,3503,2605,1341809299,1341826227,0,4,16928
29,3503,2557,1341826227,1341827355,0,4,1128
29,3503,2558,1341827355,1341828538,0,4,1183
29,3503,253,1341828538,1341828598,0,4,60
29,3504,2566,1341843512,1341843572,0,1,60
29,3505,2636,1341865721,1341870231,0,2,4510
29,3505,2576,1341870231,1341870291,0,2,60
29,3506,2576,1341957278,1341960106,0,5,2828
29,3506,2566,1341960106,1341962746,0,5,2640
29,3506,253,1341962746,1341964355,0,5,1609
29,3506,2627,1341964355,1341965039,0,5,684
29,3506,2592,1341965039,1341965099,0,5,60
29,3507,2557,1341998676,1342002370,0,7,3694
29,3507,2558,1342002370,1342013118,0,7,10748
29,3507,2569,1342013118,1342014015,0,7,897
29,3507,253,1342014015,1342018365,0,7,4350
29,3507,2566,1342018365,1342018502,0,7,137
29,3507,2561,1342018502,1342019091,0,7,589
29,3507,2562,1342019091,1342019151,0,7,60
29,3508,2576,1342045198,1342046511,0,4,1313
29,3508,2566,1342046511,1342050119,0,4,3608
29,3508,2567,1342050119,1342051024,0,4,905
29,3508,2593,1342051024,1342051084,0,4,60
29,3509,2557,1342084563,1342085724,0,5,1161
29,3509,2558,1342085724,1342087099,0,5,1375
29,3509,253,1342087099,1342101114,0,5,14015
29,3509,2566,1342101114,1342101289,0,5,175
29,3509,2575,1342101289,1342101349,0,5,60
29,3510,2566,1342132913,1342135505,0,6,2592
29,3510,253,1342135505,1342136447,0,6,942
29,3510,2567,1342136447,1342136460,0,6,13
29,3510,2640,1342136460,1342137434,0,6,974
29,3510,2557,1342137434,1342148123,0,6,10689
29,3510,2605,1342148123,1342148183,0,6,60
29,3511,2557,1342168554,1342175554,0,6,7000
29,3511,2558,1342175554,1342176050,0,6,496
29,3511,2567,1342176050,1342176916,0,6,866
29,3511,253,1342176916,1342177196,0,6,280
29,3511,600,1342177196,1342183872,0,6,6676
29,3511,2643,1342183872,1342183932,0,6,60
29,3512,2566,1342190638,1342190948,0,2,310
29,3512,2562,1342190948,1342191008,0,2,60
29,3513,2576,1342224843,1342234355,0,4,9512
29,3513,1235,1342234355,1342244693,0,4,10338
29,3513,256,1342244693,1342245883,0,4,1190
29,3513,2590,1342245883,1342245943,0,4,60
29,3514,1465,1342246703,1342252466,0,4,5763
29,3514,2644,1342252466,1342256670,0,4,4204
29,3514,480,1342256670,1342256710,0,4,40
29,3514,673,1342256710,1342256770,0,4,60
29,3515,2645,1342271624,1342271684,0,1,60
29,3516,756,1342340442,1342341097,0,8,655
29,3516,266,1342341097,1342345526,0,8,4429
29,3516,2564,1342345526,1342352572,0,8,7046
29,3516,288,1342352572,1342357539,0,8,4967
29,3516,2646,1342357539,1342357965,0,8,426
29,3516,284,1342357965,1342359447,0,8,1482
29,3516,2566,1342359447,1342359793,0,8,346
29,3516,2575,1342359793,1342359853,0,8,60
29,3517,2566,1342448465,1342448525,0,1,60
29,3518,2566,1342478908,1342479299,0,4,391
29,3518,375,1342479299,1342493951,0,4,14652
29,3518,2557,1342493951,1342497865,0,4,3914
29,3518,2582,1342497865,1342497925,0,4,60
29,3519,2637,1342519844,1342519930,0,6,86
29,3519,651,1342519930,1342529579,0,6,9649
29,3519,2590,1342529579,1342529593,0,6,14
29,3519,1235,1342529593,1342532487,0,6,2894
29,3519,2566,1342532487,1342533057,0,6,570
29,3519,2575,1342533057,1342533117,0,6,60
29,3520,2566,1342564709,1342564892,0,6,183
29,3520,2562,1342564892,1342568376,0,6,3484
29,3520,2567,1342568376,1342568388,0,6,12
29,3520,2614,1342568388,1342568990,0,6,602
29,3520,2627,1342568990,1342569712,0,6,722
29,3520,2557,1342569712,1342569772,0,6,60
29,3521,2566,1342617323,1342617460,0,2,137
29,3521,2562,1342617460,1342617520,0,2,60
29,3522,2566,1342651820,1342655044,0,4,3224
29,3522,253,1342655044,1342655789,0,4,745
29,3522,2567,1342655789,1342656250,0,4,461
29,3522,2627,1342656250,1342656310,0,4,60
29,3523,253,1342794539,1342794599,0,1,60
29,3524,2566,1342834424,1342834484,0,1,60
29,3525,2647,1342962088,1342962148,0,1,60
29,3526,2569,1343121451,1343121468,0,6,17
29,3526,2558,1343121468,1343123397,0,6,1929
29,3526,253,1343123397,1343124146,0,6,749
29,3526,1235,1343124146,1343124241,0,6,95
29,3526,1465,1343124241,1343130139,0,6,5898
29,3526,2566,1343130139,1343130199,0,6,60
29,3527,1235,1343344560,1343345000,0,3,440
29,3527,253,1343345000,1343346120,0,3,1120
29,3527,2637,1343346120,1343346180,0,3,60
29,3528,2648,1343444489,1343448473,0,5,3984
29,3528,2649,1343448473,1343450755,0,5,2282
29,3528,2650,1343450755,1343451641,0,5,886
29,3528,563,1343451641,1343452004,0,5,363
29,3528,2651,1343452004,1343452064,0,5,60
29,3529,2576,1343468140,1343470743,0,2,2603
29,3529,2652,1343470743,1343470803,0,2,60
29,3530,2576,1343523628,1343524781,0,4,1153
29,3530,2321,1343524781,1343525599,0,4,818
29,3530,284,1343525599,1343526372,0,4,773
29,3530,266,1343526372,1343526432,0,4,60
29,3531,2653,1343547850,1343548636,0,6,786
29,3531,288,1343548636,1343548991,0,6,355
29,3531,284,1343548991,1343550403,0,6,1412
29,3531,2566,1343550403,1343550826,0,6,423
29,3531,2566,1343550826,1343550845,0,6,19
29,3531,2632,1343550845,1343550905,0,6,60
29,3532,2576,1343600787,1343604260,0,5,3473
29,3532,253,1343604260,1343605441,0,5,1181
29,3532,2567,1343605441,1343605695,0,5,254
29,3532,2593,1343605695,1343621463,0,5,15768
29,3532,2605,1343621463,1343621523,0,5,60
29,3533,2557,1343641236,1343642324,0,7,1088
29,3533,2614,1343642324,1343642680,0,7,356
29,3533,2613,1343642680,1343643316,0,7,636
29,3533,2558,1343643316,1343646046,0,7,2730
29,3533,2654,1343646046,1343648012,0,7,1966
29,3533,253,1343648012,1343651786,0,7,3774
29,3533,624,1343651786,1343651846,0,7,60
29,3534,2576,1343687083,1343687143,0,1,60
29,3535,624,1344157640,1344160302,0,5,2662
29,3535,269,1344160302,1344165463,0,5,5161
29,3535,2655,1344165463,1344176061,0,5,10598
29,3535,2321,1344176061,1344176545,0,5,484
29,3535,2566,1344176545,1344176605,0,5,60
29,3536,284,1344208015,1344210066,0,4,2051
29,3536,2567,1344210066,1344211073,0,4,1007
29,3536,2593,1344211073,1344211515,0,4,442
29,3536,2557,1344211515,1344211575,0,4,60
29,3537,2656,1344235187,1344251738,0,5,16551
29,3537,2558,1344251738,1344252612,0,5,874
29,3537,253,1344252612,1344256342,0,5,3730
29,3537,2566,1344256342,1344256688,0,5,346
29,3537,2562,1344256688,1344256748,0,5,60
29,3538,2576,1344261224,1344261284,0,1,60
29,3539,2557,1344503148,1344503481,0,7,333
29,3539,2613,1344503481,1344509966,0,7,6485
29,3539,2630,1344509966,1344510190,0,7,224
29,3539,2631,1344510190,1344513432,0,7,3242
29,3539,2559,1344513432,1344513807,0,7,375
29,3539,1259,1344513807,1344514228,0,7,421
29,3539,253,1344514228,1344514288,0,7,60
29,3540,2566,1344552077,1344552094,0,5,17
29,3540,2575,1344552094,1344554419,0,5,2325
29,3540,253,1344554419,1344555724,0,5,1305
29,3540,2591,1344555724,1344555828,0,5,104
29,3540,2582,1344555828,1344555888,0,5,60
29,3541,2605,1344579313,1344586248,0,7,6935
29,3541,2656,1344586248,1344591825,0,7,5577
29,3541,2582,1344591825,1344591843,0,7,18
29,3541,2613,1344591843,1344593575,0,7,1732
29,3541,2558,1344593575,1344594644,0,7,1069
29,3541,253,1344594644,1344598916,0,7,4272
29,3541,2566,1344598916,1344598976,0,7,60
29,3542,2576,1344601963,1344602023,0,1,60
29,3543,2576,1344651761,1344652744,0,5,983
29,3543,2575,1344652744,1344657634,0,5,4890
29,3543,2657,1344657634,1344667595,0,5,9961
29,3543,2580,1344667595,1344667816,0,5,221
29,3543,254,1344667816,1344667876,0,5,60
29,3544,2658,1344676879,1344677108,0,5,229
29,3544,254,1344677108,1344678342,0,5,1234
29,3544,2659,1344678342,1344691049,0,5,12707
29,3544,2579,1344691049,1344697205,0,5,6156
29,3544,253,1344697205,1344697265,0,5,60
29,3545,2652,1344748869,1344749767,0,11,898
29,3545,2566,1344749767,1344750540,0,11,773
29,3545,2647,1344750540,1344751970,0,11,1430
29,3545,284,1344751970,1344752571,0,11,601
29,3545,2610,1344752571,1344752742,0,11,171
29,3545,266,1344752742,1344761728,0,11,8986
29,3545,756,1344761728,1344763880,0,11,2152
29,3545,284,1344763880,1344766323,0,11,2443
29,3545,35,1344766323,1344766446,0,11,123
29,3545,2660,1344766446,1344766917,0,11,471
29,3545,2661,1344766917,1344766977,0,11,60
29,3546,2566,1344812262,1344816012,0,2,3750
29,3546,2557,1344816012,1344816072,0,2,60
29,3547,2593,1344834454,1344834514,0,1,60
29,3548,2566,1344898523,1344899358,0,4,835
29,3548,375,1344899358,1344902524,0,4,3166
29,3548,2557,1344902524,1344913804,0,4,11280
29,3548,2605,1344913804,1344913864,0,4,60
29,3549,2656,1344935083,1344935702,0,7,619
29,3549,2662,1344935702,1344936006,0,7,304
29,3549,2558,1344936006,1344936259,0,7,253
29,3549,2633,1344936259,1344938356,0,7,2097
29,3549,254,1344938356,1344947866,0,7,9510
29,3549,2566,1344947866,1344948346,0,7,480
29,3549,2663,1344948346,1344948406,0,7,60
29,3550,2566,1344984111,1344986479,0,5,2368
29,3550,253,1344986479,1344987418,0,5,939
29,3550,2567,1344987418,1344987615,0,5,197
29,3550,2664,1344987615,1344988974,0,5,1359
29,3550,2557,1344988974,1344989034,0,5,60
29,3551,375,1345157681,1345160658,0,2,2977
29,3551,2567,1345160658,1345160718,0,2,60
29,3552,2576,1345264007,1345265157,0,9,1150
29,3552,2566,1345265157,1345265837,0,9,680
29,3552,375,1345265837,1345267250,0,9,1413
29,3552,253,1345267250,1345275120,0,9,7870
29,3552,2665,1345275120,1345276921,0,9,1801
29,3552,254,1345276921,1345282085,0,9,5164
29,3552,253,1345282085,1345284908,0,9,2823
29,3552,2566,1345284908,1345285430,0,9,522
29,3552,2666,1345285430,1345285490,0,9,60
29,3553,2576,1345330878,1345331988,0,5,1110
29,3553,2566,1345331988,1345332922,0,5,934
29,3553,375,1345332922,1345335147,0,5,2225
29,3553,434,1345335147,1345336842,0,5,1695
29,3553,2667,1345336842,1345336902,0,5,60
29,3554,2575,1345386868,1345391205,0,2,4337
29,3554,2576,1345391205,1345391265,0,2,60
29,3555,2566,1345416065,1345416939,0,6,874
29,3555,375,1345416939,1345418646,0,6,1707
29,3555,253,1345418646,1345419692,0,6,1046
29,3555,2567,1345419692,1345420289,0,6,597
29,3555,2633,1345420289,1345421183,0,6,894
29,3555,2656,1345421183,1345421243,0,6,60
29,3556,253,1345457846,1345460384,0,3,2538
29,3556,651,1345460384,1345473801,0,3,13417
29,3556,2566,1345473801,1345473861,0,3,60
29,3557,2569,1346839696,1346843059,0,4,3363
29,3557,100,1346843059,1346846830,0,4,3771
29,3557,253,1346846830,1346850220,0,4,3390
29,3557,2566,1346850220,1346850280,0,4,60
29,3558,2566,1346884943,1346889889,0,2,4946
29,3558,2557,1346889889,1346889949,0,2,60
29,3559,2605,1346914638,1346914698,0,1,60
29,3560,2566,1347196876,1347196936,0,1,60
29,3561,375,1347231334,1347236713,0,2,5379
29,3561,2557,1347236713,1347236773,0,2,60
29,3562,2579,1347530956,1347544393,0,2,13437
29,3562,2566,1347544393,1347544453,0,2,60
29,3563,651,1347623806,1347629459,0,3,5653
29,3563,2566,1347629459,1347638885,0,3,9426
29,3563,2566,1347638885,1347638945,0,3,60
29,3564,2647,1347686938,1347688509,0,7,1571
29,3564,375,1347688509,1347690521,0,7,2012
29,3564,253,1347690521,1347701961,0,7,11440
29,3564,284,1347701961,1347702754,0,7,793
29,3564,266,1347702754,1347703323,0,7,569
29,3564,288,1347703323,1347706680,0,7,3357
29,3564,756,1347706680,1347706740,0,7,60
29,3565,35,1347710872,1347710887,0,4,15
29,3565,257,1347710887,1347711659,0,4,772
29,3565,1680,1347711659,1347717937,0,4,6278
29,3565,35,1347717937,1347717997,0,4,60
29,3566,2566,1349962474,1349962534,0,1,60
29,3567,2576,1349994390,1349996135,0,5,1745
29,3567,375,1349996135,1349997909,0,5,1774
29,3567,253,1349997909,1349999557,0,5,1648
29,3567,2557,1349999557,1350014802,0,5,15245
29,3567,2605,1350014802,1350014862,0,5,60
29,3568,2558,1350038104,1350040751,0,4,2647
29,3568,253,1350040751,1350042182,0,4,1431
29,3568,2668,1350042182,1350045678,0,4,3496
29,3568,2566,1350045678,1350045738,0,4,60
29,3569,2566,1350092242,1350110053,0,3,17811
29,3569,2576,1350110053,1350113541,0,3,3488
29,3569,2647,1350113541,1350113601,0,3,60
29,3570,284,1350114846,1350116294,0,6,1448
29,3570,2669,1350116294,1350118978,0,6,2684
29,3570,2609,1350118978,1350122881,0,6,3903
29,3570,288,1350122881,1350130496,0,6,7615
29,3570,288,1350130496,1350136439,0,6,5943
29,3570,2646,1350136439,1350136499,0,6,60
29,3571,2566,1350138127,1350138187,0,1,60
29,3572,2567,1350381344,1350390830,0,5,9486
29,3572,253,1350390830,1350391730,0,5,900
29,3572,2665,1350391730,1350391740,0,5,10
29,3572,624,1350391740,1350396461,0,5,4721
29,3572,2321,1350396461,1350396521,0,5,60
29,3573,2557,1350464164,1350465979,0,5,1815
29,3573,2567,1350465979,1350466927,0,5,948
29,3573,253,1350466927,1350467693,0,5,766
29,3573,2637,1350467693,1350468075,0,5,382
29,3573,651,1350468075,1350468135,0,5,60
29,3574,2576,1350600627,1350601825,0,4,1198
29,3574,375,1350601825,1350603436,0,4,1611
29,3574,253,1350603436,1350604302,0,4,866
29,3574,2567,1350604302,1350604362,0,4,60
29,3575,2582,1350647537,1350648280,0,4,743
29,3575,2558,1350648280,1350654550,0,4,6270
29,3575,315,1350654550,1350657921,0,4,3371
29,3575,2566,1350657921,1350657981,0,4,60
29,3576,2558,1350897271,1350898847,0,9,1576
29,3576,253,1350898847,1350899136,0,9,289
29,3576,100,1350899136,1350900948,0,9,1812
29,3576,2630,1350900948,1350901842,0,9,894
29,3576,2637,1350901842,1350901854,0,9,12
29,3576,651,1350901854,1350910535,0,9,8681
29,3576,253,1350910535,1350910940,0,9,405
29,3576,254,1350910940,1350915634,0,9,4694
29,3576,2566,1350915634,1350915694,0,9,60
29,3577,375,1350946580,1350949431,0,3,2851
29,3577,2670,1350949431,1350950771,0,3,1340
29,3577,2593,1350950771,1350950831,0,3,60
29,3578,2656,1350979265,1350979555,0,4,290
29,3578,2557,1350979555,1350986589,0,4,7034
29,3578,253,1350986589,1350994826,0,4,8237
29,3578,254,1350994826,1350994886,0,4,60
29,3579,2671,1351032087,1351032099,0,6,12
29,3579,2566,1351032099,1351032970,0,6,871
29,3579,375,1351032970,1351034733,0,6,1763
29,3579,253,1351034733,1351036033,0,6,1300
29,3579,2573,1351036033,1351047739,0,6,11706
29,3579,2605,1351047739,1351047799,0,6,60
29,3580,2582,1351056937,1351056997,0,1,60
29,3581,2558,1351081818,1351085506,0,3,3688
29,3581,253,1351085506,1351088339,0,3,2833
29,3581,2566,1351088339,1351088399,0,3,60
29,3582,2576,1351117606,1351118553,0,4,947
29,3582,2566,1351118553,1351118629,0,4,76
29,3582,2611,1351118629,1351119425,0,4,796
29,3582,375,1351119425,1351119485,0,4,60
29,3583,2605,1351159636,1351161481,0,3,1845
29,3583,253,1351161481,1351164639,0,3,3158
29,3583,2321,1351164639,1351164699,0,3,60
29,3584,2566,1351204862,1351207515,0,4,2653
29,3584,253,1351207515,1351210650,0,4,3135
29,3584,2557,1351210650,1351220505,0,4,9855
29,3584,2573,1351220505,1351220565,0,4,60
29,3585,2558,1351244574,1351244634,0,1,60
29,3586,2566,1351267430,1351267490,0,1,60
29,3587,2576,1351298116,1351299952,0,10,1836
29,3587,2575,1351299952,1351299961,0,10,9
29,3587,2566,1351299961,1351300438,0,10,477
29,3587,2321,1351300438,1351301694,0,10,1256
29,3587,284,1351301694,1351303000,0,10,1306
29,3587,307,1351303000,1351303284,0,10,284
29,3587,2672,1351303284,1351308099,0,10,4815
29,3587,2673,1351308099,1351308323,0,10,224
29,3587,2674,1351308323,1351313326,0,10,5003
29,3587,2675,1351313326,1351313386,0,10,60
29,3588,2676,1351320899,1351341635,0,3,20736
29,3588,2677,1351341635,1351341651,0,3,16
29,3588,563,1351341651,1351341711,0,3,60
29,3589,284,1351342918,1351349264,0,3,6346
29,3589,2678,1351349264,1351352183,0,3,2919
29,3589,2566,1351352183,1351352243,0,3,60
29,3590,253,1351375260,1351376107,0,5,847
29,3590,2567,1351376107,1351376543,0,5,436
29,3590,2614,1351376543,1351377214,0,5,671
29,3590,2634,1351377214,1351377618,0,5,404
29,3590,2656,1351377618,1351377678,0,5,60
29,3591,2557,1351397168,1351400299,0,3,3131
29,3591,2558,1351400299,1351408921,0,3,8622
29,3591,2679,1351408921,1351408981,0,3,60
29,3592,2627,1351423515,1351424349,0,4,834
29,3592,253,1351424349,1351427726,0,4,3377
29,3592,2566,1351427726,1351428280,0,4,554
29,3592,2680,1351428280,1351428340,0,4,60
29,3593,2566,1351465846,1351467690,0,2,1844
29,3593,253,1351467690,1351467750,0,2,60
29,3594,2557,1351496327,1351501601,0,5,5274
29,3594,2558,1351501601,1351502537,0,5,936
29,3594,2664,1351502537,1351503517,0,5,980
29,3594,253,1351503517,1351504557,0,5,1040
29,3594,651,1351504557,1351504617,0,5,60
29,3595,2566,1351517950,1351518010,0,1,60
29,3596,2671,1351605206,1351605266,0,1,60
29,3597,253,1351639505,1351639565,0,1,60
29,3598,2656,1351665964,1351667732,0,5,1768
29,3598,2605,1351667732,1351680812,0,5,13080
29,3598,2557,1351680812,1351687212,0,5,6400
29,3598,2566,1351687212,1351687552,0,5,340
29,3598,2681,1351687552,1351687612,0,5,60
29,3599,2682,1351687941,1351688001,0,1,60
29,3600,375,1351724082,1351727150,0,5,3068
29,3600,2591,1351727150,1351727307,0,5,157
29,3600,2592,1351727307,1351727481,0,5,174
29,3600,2664,1351727481,1351731259,0,5,3778
29,3600,2557,1351731259,1351731319,0,5,60
29,3601,2656,1351760568,1351760924,0,10,356
29,3601,2615,1351760924,1351761499,0,10,575
29,3601,2558,1351761499,1351762726,0,10,1227
29,3601,2683,1351762726,1351763531,0,10,805
29,3601,253,1351763531,1351766190,0,10,2659
29,3601,651,1351766190,1351773520,0,10,7330
29,3601,2684,1351773520,1351780789,0,10,7269
29,3601,2566,1351780789,1351780988,0,10,199
29,3601,2619,1351780988,1351781266,0,10,278
29,3601,2556,1351781266,1351781326,0,10,60
29,3602,2567,1351814053,1351834278,0,2,20225
29,3602,2557,1351834278,1351834338,0,2,60
29,3603,2558,1351847125,1351847825,0,12,700
29,3603,2567,1351847825,1351848504,0,12,679
29,3603,253,1351848504,1351849717,0,12,1213
29,3603,284,1351849717,1351850683,0,12,966
29,3603,2685,1351850683,1351850808,0,12,125
29,3603,266,1351850808,1351853108,0,12,2300
29,3603,288,1351853108,1351854598,0,12,1490
29,3603,2609,1351854598,1351861188,0,12,6590
29,3603,2686,1351861188,1351861403,0,12,215
29,3603,288,1351861403,1351863624,0,12,2221
29,3603,284,1351863624,1351865356,0,12,1732
29,3603,2566,1351865356,1351865416,0,12,60
29,3604,253,1352107825,1352108311,0,6,486
29,3604,100,1352108311,1352108447,0,6,136
29,3604,2630,1352108447,1352110924,0,6,2477
29,3604,2631,1352110924,1352119734,0,6,8810
29,3604,2571,1352119734,1352126594,0,6,6860
29,3604,2247,1352126594,1352126654,0,6,60
29,3605,2321,1352156041,1352156101,0,1,60
29,3606,2605,1352178149,1352192367,0,2,14218
29,3606,2613,1352192367,1352192427,0,2,60
29,3607,2558,1352202276,1352202469,0,6,193
29,3607,2569,1352202469,1352204494,0,6,2025
29,3607,284,1352204494,1352205322,0,6,828
29,3607,756,1352205322,1352206550,0,6,1228
29,3607,2687,1352206550,1352208961,0,6,2411
29,3607,2564,1352208961,1352209021,0,6,60
29,3608,375,1352242536,1352245218,0,5,2682
29,3608,2567,1352245218,1352245905,0,5,687
29,3608,2593,1352245905,1352246663,0,5,758
29,3608,2557,1352246663,1352257875,0,5,11212
29,3608,2573,1352257875,1352257935,0,5,60
29,3609,253,1352280996,1352282350,0,6,1354
29,3609,651,1352282350,1352295387,0,6,13037
29,3609,253,1352295387,1352296636,0,6,1249
29,3609,2560,1352296636,1352298755,0,6,2119
29,3609,2321,1352298755,1352299314,0,6,559
29,3609,2566,1352299314,1352299374,0,6,60
29,3610,2557,1352365901,1352368958,0,4,3057
29,3610,253,1352368958,1352377789,0,4,8831
29,3610,253,1352377789,1352378559,0,4,770
29,3610,2560,1352378559,1352378619,0,4,60
29,3611,253,1352456193,1352459430,0,2,3237
29,3611,2566,1352459430,1352459490,0,2,60
29,3612,2566,1352511031,1352512180,0,2,1149
29,3612,2638,1352512180,1352512240,0,2,60
29,3613,2688,1352607010,1352614702,0,6,7692
29,3613,2619,1352614702,1352615354,0,6,652
29,3613,2566,1352615354,1352616165,0,6,811
29,3613,375,1352616165,1352617614,0,6,1449
29,3613,253,1352617614,1352618184,0,6,570
29,3613,624,1352618184,1352618244,0,6,60
29,3614,2579,1352628851,1352636110,0,4,7259
29,3614,253,1352636110,1352638226,0,4,2116
29,3614,375,1352638226,1352639160,0,4,934
29,3614,2619,1352639160,1352639220,0,4,60
29,3615,2566,1352673683,1352673706,0,6,23
29,3615,2556,1352673706,1352673728,0,6,22
29,3615,2561,1352673728,1352676471,0,6,2743
29,3615,253,1352676471,1352677181,0,6,710
29,3615,2593,1352677181,1352678593,0,6,1412
29,3615,2557,1352678593,1352678653,0,6,60
29,3616,2558,1352711917,1352713793,0,3,1876
29,3616,253,1352713793,1352725269,0,3,11476
29,3616,2248,1352725269,1352725329,0,3,60
29,3617,2566,1352760175,1352762589,0,6,2414
29,3617,253,1352762589,1352763599,0,6,1010
29,3617,2567,1352763599,1352763606,0,6,7
29,3617,2593,1352763606,1352764370,0,6,764
29,3617,2664,1352764370,1352777544,0,6,13174
29,3617,2656,1352777544,1352777604,0,6,60
29,3618,2557,1352786345,1352805412,0,4,19067
29,3618,2558,1352805412,1352806683,0,4,1271
29,3618,253,1352806683,1352806970,0,4,287
29,3618,624,1352806970,1352807030,0,4,60
29,3619,2566,1352814792,1352814983,0,2,191
29,3619,2561,1352814983,1352815043,0,2,60
29,3620,2567,1353023587,1353025752,0,3,2165
29,3620,2557,1353025752,1353030647,0,3,4895
29,3620,2615,1353030647,1353030707,0,3,60
29,3621,2664,1353064079,1353065330,0,4,1251
29,3621,253,1353065330,1353067953,0,4,2623
29,3621,2566,1353067953,1353067982,0,4,29
29,3621,2681,1353067982,1353068042,0,4,60
29,3622,2681,1353118926,1353121649,0,6,2723
29,3622,253,1353121649,1353122505,0,6,856
29,3622,624,1353122505,1353124711,0,6,2206
29,3622,2637,1353124711,1353124720,0,6,9
29,3622,1269,1353124720,1353139000,0,6,14280
29,3622,2684,1353139000,1353139060,0,6,60
29,3623,284,1353140991,1353141898,0,6,907
29,3623,2564,1353141898,1353141907,0,6,9
29,3623,288,1353141907,1353146435,0,6,4528
29,3623,266,1353146435,1353149498,0,6,3063
29,3623,2622,1353149498,1353160213,0,6,10715
29,3623,2566,1353160213,1353160273,0,6,60
29,3624,2576,1353198939,1353202574,0,8,3635
29,3624,2681,1353202574,1353203631,0,8,1057
29,3624,2248,1353203631,1353205421,0,8,1790
29,3624,2586,1353205421,1353207652,0,8,2231
29,3624,2689,1353207652,1353209471,0,8,1819
29,3624,2690,1353209471,1353212985,0,8,3514
29,3624,2691,1353212985,1353214004,0,8,1019
29,3624,2610,1353214004,1353214064,0,8,60
29,3625,284,1353223093,1353225335,0,5,2242
29,3625,2560,1353225335,1353226009,0,5,674
29,3625,253,1353226009,1353233800,0,5,7791
29,3625,2658,1353233800,1353242842,0,5,9042
29,3625,2566,1353242842,1353242902,0,5,60
29,3626,2566,1353364856,1353367335,0,4,2479
29,3626,253,1353367335,1353369130,0,4,1795
29,3626,2656,1353369130,1353381013,0,4,11883
29,3626,2573,1353381013,1353381073,0,4,60
29,3627,253,1353410742,1353413551,0,3,2809
29,3627,2566,1353413551,1353414232,0,3,681
29,3627,2561,1353414232,1353414292,0,3,60
29,3628,2566,1353451307,1353453893,0,3,2586
29,3628,253,1353453893,1353454612,0,3,719
29,3628,2567,1353454612,1353454672,0,3,60
29,3629,2656,1353484173,1353484837,0,4,664
29,3629,2557,1353484837,1353495515,0,4,10678
29,3629,2593,1353495515,1353495847,0,4,332
29,3629,2567,1353495847,1353495907,0,4,60
29,3630,253,1354663242,1354665919,0,3,2677
29,3630,2656,1354665919,1354666321,0,3,402
29,3630,2557,1354666321,1354666381,0,3,60
29,3631,2692,1354700157,1354700844,0,9,687
29,3631,2558,1354700844,1354703147,0,9,2303
29,3631,100,1354703147,1354703947,0,9,800
29,3631,2630,1354703947,1354704494,0,9,547
29,3631,2631,1354704494,1354706380,0,9,1886
29,3631,2693,1354706380,1354708160,0,9,1780
29,3631,253,1354708160,1354711204,0,9,3044
29,3631,375,1354711204,1354712273,0,9,1069
29,3631,2566,1354712273,1354712333,0,9,60
29,3632,2567,1354752549,1354752747,0,3,198
29,3632,2664,1354752747,1354766797,0,3,14050
29,3632,2557,1354766797,1354766857,0,3,60
29,3633,2558,1354788268,1354789776,0,7,1508
29,3633,2694,1354789776,1354790970,0,7,1194
29,3633,253,1354790970,1354791905,0,7,935
29,3633,260,1354791905,1354792576,0,7,671
29,3633,2695,1354792576,1354800566,0,7,7990
29,3633,2696,1354800566,1354804861,0,7,4295
29,3633,2566,1354804861,1354804921,0,7,60
29,3634,2566,1354833674,1354837816,0,3,4142
29,3634,2697,1354837816,1354847097,0,3,9281
29,3634,2656,1354847097,1354847157,0,3,60
29,3635,2557,1354863666,1354871610,0,8,7944
29,3635,2613,1354871610,1354874901,0,8,3291
29,3635,2633,1354874901,1354875538,0,8,637
29,3635,2558,1354875538,1354876204,0,8,666
29,3635,2633,1354876204,1354876223,0,8,19
29,3635,2697,1354876223,1354880236,0,8,4013
29,3635,2566,1354880236,1354880541,0,8,305
29,3635,2611,1354880541,1354880601,0,8,60
29,3636,2566,1354926907,1354926967,0,1,60
29,3637,2576,1354969611,1354969671,0,1,60
29,3638,2566,1355058238,1355058298,0,1,60
29,3639,2566,1355093508,1355093908,0,4,400
29,3639,2566,1355093908,1355096365,0,4,2457
29,3639,35,1355096365,1355096542,0,4,177
29,3639,253,1355096542,1355096602,0,4,60
29,3640,2557,1355131095,1355150824,0,4,19729
29,3640,2247,1355150824,1355152297,0,4,1473
29,3640,2566,1355152297,1355152556,0,4,259
29,3640,2619,1355152556,1355152616,0,4,60
29,3641,2566,1355179241,1355183205,0,2,3964
29,3641,2697,1355183205,1355183265,0,2,60
29,3642,2557,1355218598,1355218620,0,3,22
29,3642,2558,1355218620,1355219768,0,3,1148
29,3642,35,1355219768,1355219828,0,3,60
29,3643,2561,1355260228,1355260288,0,1,60
29,3644,375,1355351986,1355354636,0,3,2650
29,3644,2569,1355354636,1355354986,0,3,350
29,3644,2633,1355354986,1355355046,0,3,60
29,3645,2558,1355390880,1355392798,0,5,1918
29,3645,253,1355392798,1355402637,0,5,9839
29,3645,316,1355402637,1355405053,0,5,2416
29,3645,2248,1355405053,1355411632,0,5,6579
29,3645,2566,1355411632,1355411692,0,5,60
29,3646,284,1355539652,1355539751,0,5,99
29,3646,2563,1355539751,1355540632,0,5,881
29,3646,285,1355540632,1355548813,0,5,8181
29,3646,2698,1355548813,1355554779,0,5,5966
29,3646,266,1355554779,1355554839,0,5,60
29,3647,2564,1355561463,1355581836,0,3,20373
29,3647,284,1355581836,1355582878,0,3,1042
29,3647,2566,1355582878,1355582938,0,3,60
29,3648,2576,1355615039,1355615099,0,1,60
29,3649,2575,1355641949,1355641960,0,8,11
29,3649,2566,1355641960,1355644983,0,8,3023
29,3649,253,1355644983,1355653864,0,8,8881
29,3649,2658,1355653864,1355657755,0,8,3891
29,3649,253,1355657755,1355659777,0,8,2022
29,3649,572,1355659777,1355660704,0,8,927
29,3649,2699,1355660704,1355660738,0,8,34
29,3649,2700,1355660738,1355660798,0,8,60
29,3650,2566,1355698641,1355698701,0,1,60
29,3651,375,1355785847,1355787593,0,3,1746
29,3651,253,1355787593,1355789061,0,3,1468
29,3651,2627,1355789061,1355789121,0,3,60
29,3652,2701,1355823688,1355825095,0,3,1407
29,3652,2558,1355825095,1355831888,0,3,6793
29,3652,2566,1355831888,1355831948,0,3,60
29,3653,2647,1355871330,1355874783,0,5,3453
29,3653,2567,1355874783,1355875352,0,5,569
29,3653,2557,1355875352,1355875835,0,5,483
29,3653,2656,1355875835,1355886499,0,5,10664
29,3653,2573,1355886499,1355886559,0,5,60
29,3654,2567,1355908244,1355908828,0,6,584
29,3654,253,1355908828,1355910364,0,6,1536
29,3654,2630,1355910364,1355912628,0,6,2264
29,3654,2631,1355912628,1355913367,0,6,739
29,3654,651,1355913367,1355922097,0,6,8730
29,3654,2248,1355922097,1355922157,0,6,60
29,3655,301,1355960452,1355961417,0,2,965
29,3655,2664,1355961417,1355961477,0,2,60
29,3656,2647,1356044246,1356044930,0,4,684
29,3656,375,1356044930,1356046947,0,4,2017
29,3656,253,1356046947,1356050752,0,4,3805
29,3656,2557,1356050752,1356050812,0,4,60
29,3657,2702,1356083987,1356084332,0,5,345
29,3657,2703,1356084332,1356099566,0,5,15234
29,3657,253,1356099566,1356102923,0,5,3357
29,3657,2566,1356102923,1356103437,0,5,514
29,3657,2681,1356103437,1356103497,0,5,60
29,3658,2566,1356137304,1356137364,0,1,60
29,3659,2704,1356159289,1356159936,0,2,647
29,3659,2576,1356159936,1356159996,0,2,60
29,3660,2576,1356189463,1356189523,0,1,60
29,3661,2576,1356221499,1356222582,0,3,1083
29,3661,2566,1356222582,1356242237,0,3,19655
29,3661,2658,1356242237,1356242297,0,3,60
29,3662,2668,1356243595,1356248772,0,2,5177
29,3662,2566,1356248772,1356248832,0,2,60
29,3663,2633,1356600236,1356604369,0,5,4133
29,3663,2631,1356604369,1356605009,0,5,640
29,3663,100,1356605009,1356606239,0,5,1230
29,3663,651,1356606239,1356615243,0,5,9004
29,3663,253,1356615243,1356615303,0,5,60
29,3664,2647,1356649673,1356656868,0,2,7195
29,3664,2582,1356656868,1356656928,0,2,60
29,3665,284,1356691799,1356693022,0,4,1223
29,3665,266,1356693022,1356698888,0,4,5866
29,3665,2705,1356698888,1356707175,0,4,8287
29,3665,284,1356707175,1356707235,0,4,60
29,3666,2632,1356752480,1356754175,0,5,1695
29,3666,2566,1356754175,1356755855,0,5,1680
29,3666,284,1356755855,1356756595,0,5,740
29,3666,301,1356756595,1356766648,0,5,10053
29,3666,284,1356766648,1356766708,0,5,60
29,3667,284,1356778302,1356780386,0,4,2084
29,3667,301,1356780386,1356781908,0,4,1522
29,3667,2623,1356781908,1356787490,0,4,5582
29,3667,284,1356787490,1356787550,0,4,60
29,3668,253,1356850370,1356851330,0,2,960
29,3668,425,1356851330,1356851390,0,2,60
29,3669,253,1356877781,1356877841,0,1,60
29,3670,2619,1356929793,1356930939,0,6,1146
29,3670,2681,1356930939,1356934932,0,6,3993
29,3670,875,1356934932,1356936867,0,6,1935
29,3670,2706,1356936867,1356939703,0,6,2836
29,3670,2653,1356939703,1356941329,0,6,1626
29,3670,301,1356941329,1356941389,0,6,60
29,3671,2648,1357152624,1357158381,0,2,5757
29,3671,2680,1357158381,1357158441,0,2,60
29,3672,284,1357192459,1357195437,0,7,2978
29,3672,2707,1357195437,1357196750,0,7,1313
29,3672,253,1357196750,1357207824,0,7,11074
29,3672,5,1357207824,1357209518,0,7,1694
29,3672,2708,1357209518,1357211312,0,7,1794
29,3672,284,1357211312,1357212381,0,7,1069
29,3672,2387,1357212381,1357212441,0,7,60
29,3673,2614,1357256210,1357256270,0,1,60
29,3674,2656,1357290436,1357291328,0,4,892
29,3674,2567,1357291328,1357292192,0,4,864
29,3674,253,1357292192,1357292592,0,4,400
29,3674,2560,1357292592,1357292652,0,4,60
29,3675,2647,1357375521,1357375702,0,6,181
29,3675,2566,1357375702,1357379703,0,6,4001
29,3675,5,1357379703,1357380791,0,6,1088
29,3675,282,1357380791,1357384294,0,6,3503
29,3675,5,1357384294,1357387767,0,6,3473
29,3675,2709,1357387767,1357387827,0,6,60
29,3676,284,1357397454,1357399276,0,2,1822
29,3676,2566,1357399276,1357399336,0,2,60
29,3677,284,1357445239,1357447031,0,6,1792
29,3677,428,1357447031,1357448252,0,6,1221
29,3677,2710,1357448252,1357465127,0,6,16875
29,3677,428,1357465127,1357466337,0,6,1210
29,3677,284,1357466337,1357466816,0,6,479
29,3677,301,1357466816,1357466876,0,6,60
29,3678,288,1357476170,1357476230,0,1,60
29,3679,253,1357514868,1357514928,0,1,60
29,3680,2605,1357549961,1357551097,0,4,1136
29,3680,253,1357551097,1357552563,0,4,1466
29,3680,651,1357552563,1357569796,0,4,17233
29,3680,253,1357569796,1357569856,0,4,60
29,3681,253,1357602199,1357603079,0,3,880
29,3681,2567,1357603079,1357614650,0,3,11571
29,3681,2573,1357614650,1357614710,0,3,60
29,3682,2567,1357637214,1357637274,0,1,60
29,3683,2566,1357684956,1357687613,0,4,2657
29,3683,253,1357687613,1357698239,0,4,10626
29,3683,2656,1357698239,1357700654,0,4,2415
29,3683,2605,1357700654,1357700714,0,4,60
29,3684,651,1357728862,1357738309,0,3,9447
29,3684,253,1357738309,1357741105,0,3,2796
29,3684,2566,1357741105,1357741165,0,3,60
29,3685,2647,1357773124,1357773184,0,1,60
29,3686,2557,1357797674,1357810222,0,3,12548
29,3686,2558,1357810222,1357811322,0,3,1100
29,3686,253,1357811322,1357811382,0,3,60
29,3687,2711,1357823010,1357823268,0,2,258
29,3687,2579,1357823268,1357823328,0,2,60
29,3688,375,1357859464,1357859524,0,1,60
29,3689,2656,1357896271,1357899174,0,6,2903
29,3689,2558,1357899174,1357899465,0,6,291
29,3689,2569,1357899465,1357902486,0,6,3021
29,3689,100,1357902486,1357906198,0,6,3712
29,3689,284,1357906198,1357906521,0,6,323
29,3689,2610,1357906521,1357906581,0,6,60
29,3690,2712,1357961357,1357961432,0,3,75
29,3690,2648,1357961432,1357975981,0,3,14549
29,3690,253,1357975981,1357976041,0,3,60
29,3691,284,1357988832,1357989433,0,5,601
29,3691,266,1357989433,1357990864,0,5,1431
29,3691,288,1357990864,1358003405,0,5,12541
29,3691,284,1358003405,1358005445,0,5,2040
29,3691,2575,1358005445,1358005505,0,5,60
29,3692,253,1358079594,1358080049,0,2,455
29,3692,2713,1358080049,1358080109,0,2,60
29,3693,2603,1358148452,1358149147,0,4,695
29,3693,2666,1358149147,1358151130,0,4,1983
29,3693,2566,1358151130,1358152054,0,4,924
29,3693,2647,1358152054,1358152114,0,4,60
29,3694,2575,1358203695,1358203732,0,4,37
29,3694,2566,1358203732,1358206775,0,4,3043
29,3694,253,1358206775,1358207893,0,4,1118
29,3694,2664,1358207893,1358207953,0,4,60
29,3695,428,1358226759,1358231387,0,4,4628
29,3695,253,1358231387,1358245290,0,4,13903
29,3695,2244,1358245290,1358246321,0,4,1031
29,3695,301,1358246321,1358246381,0,4,60
29,3696,2575,1358289420,1358289806,0,4,386
29,3696,2566,1358289806,1358292312,0,4,2506
29,3696,253,1358292312,1358293816,0,4,1504
29,3696,2593,1358293816,1358293876,0,4,60
29,3697,2558,1358330931,1358332241,0,2,1310
29,3697,253,1358332241,1358332301,0,2,60
29,3698,253,1358380360,1358381731,0,3,1371
29,3698,2664,1358381731,1358391995,0,3,10264
29,3698,2605,1358391995,1358392055,0,3,60
29,3699,2557,1358421291,1358422264,0,3,973
29,3699,2567,1358422264,1358423978,0,3,1714
29,3699,651,1358423978,1358424038,0,3,60
29,3700,651,1358463404,1358465715,0,3,2311
29,3700,253,1358465715,1358466716,0,3,1001
29,3700,2664,1358466716,1358466776,0,3,60
29,3701,2573,1358489357,1358502638,0,3,13281
29,3701,2558,1358502638,1358503482,0,3,844
29,3701,253,1358503482,1358503542,0,3,60
29,3702,2248,1358514104,1358514115,0,3,11
29,3702,2571,1358514115,1358525664,0,3,11549
29,3702,2566,1358525664,1358525724,0,3,60
29,3703,253,1358763949,1358772489,0,2,8540
29,3703,253,1358772489,1358772549,0,2,60
29,3704,253,1358812606,1358813392,0,2,786
29,3704,2567,1358813392,1358813452,0,2,60
29,3705,253,1358847542,1358859861,0,2,12319
29,3705,301,1358859861,1358859921,0,2,60
29,3706,624,1360327483,1360328108,0,2,625
29,3706,2711,1360328108,1360328168,0,2,60
29,3707,2556,1360558797,1360559096,0,6,299
29,3707,2566,1360559096,1360573000,0,6,13904
29,3707,253,1360573000,1360573068,0,6,68
29,3707,2714,1360573068,1360574872,0,6,1804
29,3707,284,1360574872,1360575103,0,6,231
29,3707,301,1360575103,1360575163,0,6,60
29,3708,2646,1360581447,1360581713,0,5,266
29,3708,2715,1360581713,1360582006,0,5,293
29,3708,2716,1360582006,1360584735,0,5,2729
29,3708,301,1360584735,1360597012,0,5,12277
29,3708,2566,1360597012,1360597072,0,5,60
29,3709,2591,1360626268,1360626287,0,4,19
29,3709,2627,1360626287,1360639807,0,4,13520
29,3709,2573,1360639807,1360647542,0,4,7735
29,3709,2656,1360647542,1360647602,0,4,60
29,3710,253,1360679946,1360683217,0,2,3271
29,3710,2566,1360683217,1360683277,0,2,60
29,3711,2567,1360713965,1360724632,0,2,10667
29,3711,2605,1360724632,1360724692,0,2,60
29,3712,2558,1360752569,1360753875,0,5,1306
29,3712,253,1360753875,1360754922,0,5,1047
29,3712,651,1360754922,1360761100,0,5,6178
29,3712,2717,1360761100,1360765957,0,5,4857
29,3712,2321,1360765957,1360766017,0,5,60
29,3713,2566,1360795408,1360796087,0,4,679
29,3713,375,1360796087,1360798641,0,4,2554
29,3713,2664,1360798641,1360798920,0,4,279
29,3713,2614,1360798920,1360798980,0,4,60
30,3714,253,1360834721,1360834781,0,1,60
30,3715,351,1334929811,1334930899,0,3,1088
30,3715,35,1334930899,1334931083,0,3,184
30,3715,258,1334931083,1334931143,0,3,60
30,3716,765,1335095348,1335095851,0,7,503
30,3716,902,1335095851,1335096754,0,7,903
30,3716,5,1335096754,1335096857,0,7,103
30,3716,11,1335096857,1335097300,0,7,443
30,3716,1799,1335097300,1335097538,0,7,238
30,3716,307,1335097538,1335097712,0,7,174
30,3716,727,1335097712,1335097772,0,7,60
30,3717,351,1335585656,1335585685,0,3,29
30,3717,1451,1335585685,1335587061,0,3,1376
30,3717,35,1335587061,1335587121,0,3,60
30,3718,1438,1335929142,1335950385,0,3,21243
30,3718,609,1335950385,1335950423,0,3,38
30,3718,791,1335950423,1335950483,0,3,60
30,3719,2718,1335951907,1335952406,0,6,499
30,3719,284,1335952406,1335952432,0,6,26
30,3719,287,1335952432,1335954109,0,6,1677
30,3719,351,1335954109,1335954125,0,6,16
30,3719,1451,1335954125,1335954172,0,6,47
30,3719,2719,1335954172,1335954232,0,6,60
30,3720,2720,1336039957,1336040004,0,2,47
30,3720,2721,1336040004,1336040064,0,2,60
30,3721,351,1336103711,1336104668,0,9,957
30,3721,35,1336104668,1336104709,0,9,41
30,3721,1155,1336104709,1336105029,0,9,320
30,3721,2722,1336105029,1336105375,0,9,346
30,3721,131,1336105375,1336105445,0,9,70
30,3721,2723,1336105445,1336105668,0,9,223
30,3721,1235,1336105668,1336106078,0,9,410
30,3721,50,1336106078,1336107150,0,9,1072
30,3721,2724,1336107150,1336107210,0,9,60
30,3722,1155,1336382512,1336382528,0,3,16
30,3722,35,1336382528,1336384947,0,3,2419
30,3722,351,1336384947,1336385007,0,3,60
30,3723,1235,1336727678,1336727738,0,1,60
30,3724,2446,1336800692,1336802437,0,4,1745
30,3724,2725,1336802437,1336803053,0,4,616
30,3724,35,1336803053,1336803932,0,4,879
30,3724,1451,1336803932,1336803992,0,4,60
30,3725,35,1336986758,1336988122,0,3,1364
30,3725,351,1336988122,1336988460,0,3,338
30,3725,1451,1336988460,1336988520,0,3,60
30,3726,35,1337245844,1337245865,0,5,21
30,3726,1155,1337245865,1337246564,0,5,699
30,3726,284,1337246564,1337247481,0,5,917
30,3726,1451,1337247481,1337247527,0,5,46
30,3726,351,1337247527,1337247587,0,5,60
30,3727,284,1337351173,1337351958,0,2,785
30,3727,351,1337351958,1337352018,0,2,60
30,3728,351,1337593034,1337593094,0,1,60
30,3729,2446,1337678851,1337679706,0,7,855
30,3729,35,1337679706,1337680356,0,7,650
30,3729,640,1337680356,1337689505,0,7,9149
30,3729,284,1337689505,1337690628,0,7,1123
30,3729,1451,1337690628,1337690685,0,7,57
30,3729,351,1337690685,1337690955,0,7,270
30,3729,2726,1337690955,1337691015,0,7,60
30,3730,284,1338004645,1338004705,0,1,60
30,3731,351,1338106145,1338107319,0,6,1174
30,3731,284,1338107319,1338108101,0,6,782
30,3731,640,1338108101,1338108359,0,6,258
30,3731,2727,1338108359,1338119015,0,6,10656
30,3731,640,1338119015,1338120399,0,6,1384
30,3731,351,1338120399,1338120459,0,6,60
30,3732,1235,1338542328,1338542550,0,5,222
30,3732,2723,1338542550,1338543174,0,5,624
30,3732,791,1338543174,1338544741,0,5,1567
30,3732,35,1338544741,1338546211,0,5,1470
30,3732,351,1338546211,1338546271,0,5,60
30,3733,260,1338731375,1338731815,0,4,440
30,3733,21,1338731815,1338732982,0,4,1167
30,3733,1799,1338732982,1338733528,0,4,546
30,3733,351,1338733528,1338733588,0,4,60
30,3734,640,1339247994,1339248054,0,1,60
30,3735,11,1340012044,1340012153,0,2,109
30,3735,2728,1340012153,1340012213,0,2,60
30,3736,2395,1341394881,1341394941,0,1,60
30,3737,2018,1341457824,1341457884,0,1,60
30,3738,351,1341659560,1341660701,0,2,1141
30,3738,35,1341660701,1341660761,0,2,60
30,3739,351,1341723924,1341724836,0,4,912
30,3739,35,1341724836,1341741511,0,4,16675
30,3739,791,1341741511,1341741978,0,4,467
30,3739,35,1341741978,1341742038,0,4,60
30,3740,2395,1341999961,1342000021,0,1,60
30,3741,351,1342339758,1342340602,0,7,844
30,3741,35,1342340602,1342340741,0,7,139
30,3741,2660,1342340741,1342351826,0,7,11085
30,3741,2729,1342351826,1342352086,0,7,260
30,3741,2730,1342352086,1342352865,0,7,779
30,3741,35,1342352865,1342354261,0,7,1396
30,3741,1451,1342354261,1342354321,0,7,60
30,3742,315,1343125095,1343127200,0,2,2105
30,3742,316,1343127200,1343127260,0,2,60
30,3743,35,1343539891,1343541412,0,2,1521
30,3743,104,1343541412,1343541472,0,2,60
30,3744,284,1343640155,1343640655,0,4,500
30,3744,595,1343640655,1343640681,0,4,26
30,3744,2731,1343640681,1343642653,0,4,1972
30,3744,2395,1343642653,1343642713,0,4,60
30,3745,1155,1344246141,1344247346,0,2,1205
30,3745,351,1344247346,1344247406,0,2,60
30,3746,637,1344590158,1344590218,0,1,60
30,3747,253,1344741156,1344741552,0,3,396
30,3747,428,1344741552,1344748655,0,3,7103
30,3747,21,1344748655,1344748715,0,3,60
30,3748,351,1344926704,1344927157,0,5,453
30,3748,727,1344927157,1344927178,0,5,21
30,3748,284,1344927178,1344927440,0,5,262
30,3748,35,1344927440,1344927787,0,5,347
30,3748,954,1344927787,1344927847,0,5,60
30,3749,2732,1345456035,1345456095,0,1,60
30,3750,253,1347631473,1347632393,0,2,920
30,3750,1155,1347632393,1347632453,0,2,60
30,3751,2733,1347692555,1347694174,0,5,1619
30,3751,1415,1347694174,1347695687,0,5,1513
30,3751,391,1347695687,1347710598,0,5,14911
30,3751,284,1347710598,1347711871,0,5,1273
30,3751,351,1347711871,1347711931,0,5,60
30,3752,2734,1347763743,1347763803,0,1,60
30,3753,2735,1350092846,1350094257,0,2,1411
30,3753,73,1350094257,1350094317,0,2,60
30,3754,351,1350119964,1350121086,0,3,1122
30,3754,284,1350121086,1350121497,0,3,411
30,3754,640,1350121497,1350121557,0,3,60
30,3755,117,1350466625,1350467343,0,3,718
30,3755,2736,1350467343,1350467651,0,3,308
30,3755,2737,1350467651,1350467711,0,3,60
30,3756,35,1350949308,1350949368,0,1,60
30,3757,2738,1350993619,1350994453,0,3,834
30,3757,35,1350994453,1350995817,0,3,1364
30,3757,351,1350995817,1350995877,0,3,60
30,3758,35,1351070265,1351071569,0,2,1304
30,3758,351,1351071569,1351071629,0,2,60
30,3759,21,1351245090,1351252566,0,2,7476
30,3759,1555,1351252566,1351252626,0,2,60
30,3760,351,1351330168,1351331428,0,2,1260
30,3760,640,1351331428,1351331488,0,2,60
30,3761,712,1351407821,1351410115,0,3,2294
30,3761,2165,1351410115,1351410689,0,3,574
30,3761,351,1351410689,1351410749,0,3,60
30,3762,2195,1351676736,1351677384,0,3,648
30,3762,35,1351677384,1351677722,0,3,338
30,3762,640,1351677722,1351677782,0,3,60
30,3763,2195,1351761121,1351761181,0,1,60
30,3764,2739,1352109084,1352109624,0,2,540
30,3764,35,1352109624,1352109684,0,2,60
30,3765,2740,1352198328,1352198388,0,1,60
30,3766,35,1353128047,1353128107,0,1,60
30,3767,2741,1353223131,1353223581,0,3,450
30,3767,603,1353223581,1353223917,0,3,336
30,3767,35,1353223917,1353223977,0,3,60
30,3768,2095,1353402894,1353406050,0,3,3156
30,3768,2742,1353406050,1353406082,0,3,32
30,3768,637,1353406082,1353406142,0,3,60
30,3769,1555,1353575862,1353584623,0,2,8761
30,3769,35,1353584623,1353584683,0,2,60
30,3770,35,1353653082,1353653142,0,1,60
30,3771,35,1353677338,1353677398,0,1,60
30,3772,351,1353712492,1353716074,0,2,3582
30,3772,2743,1353716074,1353716134,0,2,60
30,3773,591,1353799744,1353799804,0,1,60
30,3774,351,1353885943,1353889810,0,2,3867
30,3774,2743,1353889810,1353889870,0,2,60
30,3775,35,1353917128,1353917188,0,1,60
30,3776,351,1354435569,1354437129,0,2,1560
30,3776,284,1354437129,1354437189,0,2,60
30,3777,351,1354614252,1354614312,0,1,60
30,3778,2744,1354698500,1354699796,0,4,1296
30,3778,21,1354699796,1354699896,0,4,100
30,3778,2745,1354699896,1354700401,0,4,505
30,3778,2746,1354700401,1354700461,0,4,60
30,3779,2747,1355479631,1355480035,0,2,404
30,3779,35,1355480035,1355480095,0,2,60
30,3780,2744,1355908154,1355909037,0,9,883
30,3780,732,1355909037,1355909212,0,9,175
30,3780,2221,1355909212,1355910731,0,9,1519
30,3780,2748,1355910731,1355910775,0,9,44
30,3780,1408,1355910775,1355912178,0,9,1403
30,3780,434,1355912178,1355913234,0,9,1056
30,3780,35,1355913234,1355913614,0,9,380
30,3780,2749,1355913614,1355915179,0,9,1565
30,3780,637,1355915179,1355915239,0,9,60
30,3781,2750,1356851595,1356851906,0,3,311
30,3781,834,1356851906,1356873165,0,3,21259
30,3781,351,1356873165,1356873225,0,3,60
30,3782,258,1357101463,1357101969,0,5,506
30,3782,168,1357101969,1357107595,0,5,5626
30,3782,386,1357107595,1357113926,0,5,6331
30,3782,2751,1357113926,1357116044,0,5,2118
30,3782,35,1357116044,1357116104,0,5,60
30,3783,2395,1357639403,1357640100,0,3,697
30,3783,284,1357640100,1357640801,0,3,701
30,3783,351,1357640801,1357640861,0,3,60
30,3784,35,1357722684,1357722744,0,1,60
30,3785,35,1357775321,1357775381,0,1,60
30,3786,2395,1358416911,1358416971,0,1,60
31,3787,1235,1359105211,1359105361,0,3,150
31,3787,35,1359105361,1359106056,0,3,695
31,3787,359,1359106056,1359106116,0,3,60
31,3788,2752,1334224990,1334225050,0,1,60
31,3789,2753,1334285023,1334285083,0,1,60
31,3790,2754,1334912951,1334914459,0,4,1508
31,3790,5,1334914459,1334914718,0,4,259
31,3790,21,1334914718,1334919581,0,4,4863
31,3790,2755,1334919581,1334919641,0,4,60
31,3791,529,1334990621,1334991158,0,5,537
31,3791,71,1334991158,1334991344,0,5,186
31,3791,21,1334991344,1334991808,0,5,464
31,3791,11,1334991808,1334997711,0,5,5903
31,3791,2754,1334997711,1334997771,0,5,60
31,3792,11,1335061851,1335061911,0,1,60
31,3793,529,1335144577,1335146251,0,4,1674
31,3793,21,1335146251,1335148476,0,4,2225
31,3793,2756,1335148476,1335153851,0,4,5375
31,3793,428,1335153851,1335153911,0,4,60
31,3794,428,1335249055,1335250673,0,5,1618
31,3794,21,1335250673,1335251144,0,5,471
31,3794,11,1335251144,1335252094,0,5,950
31,3794,758,1335252094,1335253410,0,5,1316
31,3794,2754,1335253410,1335253470,0,5,60
31,3795,21,1335423551,1335424179,0,3,628
31,3795,11,1335424179,1335427214,0,3,3035
31,3795,2754,1335427214,1335427274,0,3,60
31,3796,2757,1335520890,1335520988,0,5,98
31,3796,2758,1335520988,1335522058,0,5,1070
31,3796,2759,1335522058,1335529311,0,5,7253
31,3796,2760,1335529311,1335536939,0,5,7628
31,3796,21,1335536939,1335536999,0,5,60
31,3797,928,1335582682,1335587759,0,7,5077
31,3797,2761,1335587759,1335590133,0,7,2374
31,3797,2762,1335590133,1335592225,0,7,2092
31,3797,24,1335592225,1335593405,0,7,1180
31,3797,2763,1335593405,1335594148,0,7,743
31,3797,2764,1335594148,1335597035,0,7,2887
31,3797,2765,1335597035,1335597095,0,7,60
31,3798,2766,1335686017,1335686230,0,6,213
31,3798,465,1335686230,1335686900,0,6,670
31,3798,2767,1335686900,1335687159,0,6,259
31,3798,2761,1335687159,1335687870,0,6,711
31,3798,2542,1335687870,1335689250,0,6,1380
31,3798,2754,1335689250,1335689310,0,6,60
31,3799,2755,1335954999,1335955059,0,1,60
31,3800,2768,1336355685,1336355745,0,1,60
31,3801,2754,1336784376,1336784436,0,1,60
31,3802,2769,1336806250,1336806310,0,1,60
31,3803,2755,1336828868,1336828928,0,1,60
31,3804,2754,1337068214,1337074473,0,3,6259
31,3804,11,1337074473,1337083504,0,3,9031
31,3804,2770,1337083504,1337083564,0,3,60
31,3805,2767,1337842275,1337842335,0,1,60
31,3806,2542,1337937270,1337937924,0,2,654
31,3806,2761,1337937924,1337937984,0,2,60
31,3807,11,1338092286,1338092346,0,1,60
31,3808,2756,1338170942,1338174091,0,4,3149
31,3808,2771,1338174091,1338176249,0,4,2158
31,3808,2772,1338176249,1338177926,0,4,1677
31,3808,2773,1338177926,1338177986,0,4,60
31,3809,2542,1338489528,1338489588,0,1,60
31,3810,2754,1338717081,1338717141,0,1,60
31,3811,465,1338808072,1338808132,0,1,60
31,3812,2774,1338979202,1338979262,0,1,60
31,3813,428,1339047851,1339050016,0,2,2165
31,3813,2775,1339050016,1339050076,0,2,60
31,3814,2776,1339388245,1339388305,0,1,60
31,3815,2777,1339504972,1339505032,0,1,60
31,3816,428,1340001849,1340001909,0,1,60
31,3817,2776,1340249425,1340249485,0,1,60
31,3818,2756,1340759451,1340759511,0,1,60
31,3819,2778,1340787803,1340787863,0,1,60
31,3820,2542,1341472098,1341472158,0,1,60
31,3821,2755,1341544487,1341544547,0,1,60
31,3822,21,1341579980,1341580040,0,1,60
31,3823,1429,1342053916,1342060760,0,2,6844
31,3823,21,1342060760,1342060820,0,2,60
31,3824,2755,1342412861,1342412921,0,1,60
31,3825,2779,1342513541,1342513601,0,1,60
31,3826,2754,1342617236,1342617296,0,1,60
31,3827,2777,1343137945,1343138005,0,1,60
31,3828,99,1344760079,1344760139,0,1,60
31,3829,2755,1345280072,1345281151,0,2,1079
31,3829,2770,1345281151,1345281211,0,2,60
31,3830,2755,1345434706,1345434766,0,1,60
31,3831,2768,1347671402,1347671462,0,1,60
31,3832,2755,1350110775,1350110835,0,1,60
31,3833,2755,1350974423,1350975176,0,2,753
31,3833,11,1350975176,1350975236,0,2,60
31,3834,1256,1351055530,1351057204,0,3,1674
31,3834,2776,1351057204,1351072967,0,3,15763
31,3834,2777,1351072967,1351073027,0,3,60
31,3835,2780,1351149334,1351149394,0,1,60
31,3836,11,1351236587,1351236647,0,1,60
31,3837,2755,1351666317,1351666377,0,1,60
31,3838,428,1351765005,1351765065,0,1,60
31,3839,2542,1351840003,1351840063,0,1,60
31,3840,2755,1352270281,1352271803,0,2,1522
31,3840,2542,1352271803,1352271863,0,2,60
31,3841,2758,1353205045,1353205305,0,3,260
31,3841,2781,1353205305,1353207676,0,3,2371
31,3841,2782,1353207676,1353207736,0,3,60
31,3842,2755,1353567280,1353567340,0,1,60
31,3843,2783,1353645702,1353650322,0,2,4620
31,3843,2770,1353650322,1353650382,0,2,60
31,3844,2784,1353748830,1353750973,0,2,2143
31,3844,2779,1353750973,1353751033,0,2,60
31,3845,465,1353828380,1353828440,0,1,60
31,3846,2770,1353926397,1353926457,0,1,60
31,3847,2755,1354584755,1354587981,0,2,3226
31,3847,2756,1354587981,1354588041,0,2,60
31,3848,21,1355641735,1355641795,0,1,60
31,3849,1799,1356204425,1356204485,0,1,60
31,3850,2785,1356242984,1356243044,0,1,60
31,3851,1723,1356767336,1356767396,0,1,60
31,3852,2786,1357259264,1357259324,0,1,60
31,3853,428,1357607784,1357609218,0,4,1434
31,3853,2756,1357609218,1357615253,0,4,6035
31,3853,2787,1357615253,1357619136,0,4,3883
31,3853,2770,1357619136,1357619196,0,4,60
31,3854,2788,1357640974,1357641034,0,1,60
31,3855,2789,1357812809,1357812869,0,1,60
31,3856,2790,1357895644,1357895704,0,1,60
31,3857,2790,1357966249,1357966309,0,1,60
31,3858,59,1359257301,1359262469,0,2,5168
31,3858,2791,1359262469,1359262529,0,2,60
31,3859,428,1359615029,1359615089,0,1,60
31,3860,2778,1359728311,1359728371,0,1,60
31,3861,2770,1359972875,1359972935,0,1,60
31,3862,2792,1360207346,1360208089,0,3,743
31,3862,2793,1360208089,1360219938,0,3,11849
31,3862,2794,1360219938,1360219998,0,3,60
31,3863,2755,1360306447,1360306507,0,1,60
31,3864,11,1360536496,1360538481,0,2,1985
31,3864,538,1360538481,1360538541,0,2,60
31,3865,2794,1360650429,1360660059,0,2,9630
31,3865,2770,1360660059,1360660119,0,2,60
31,3866,428,1360737688,1360738451,0,3,763
31,3866,2755,1360738451,1360739157,0,3,706
31,3866,11,1360739157,1360739217,0,3,60
32,3867,121,1360835065,1360835125,0,1,60
32,3868,455,1336199885,1336199945,0,1,60
32,3869,59,1336386795,1336386855,0,1,60
32,3870,59,1336555744,1336555804,0,1,60
32,3871,59,1336721387,1336721447,0,1,60
32,3872,2795,1336803846,1336803906,0,1,60
32,3873,59,1336987794,1336987854,0,1,60
32,3874,2429,1337161947,1337165315,0,2,3368
32,3874,59,1337165315,1337165375,0,2,60
32,3875,59,1337253185,1337253245,0,1,60
32,3876,59,1337346890,1337346950,0,1,60
32,3877,2795,1337405052,1337415722,0,3,10670
32,3877,2796,1337415722,1337419339,0,3,3617
32,3877,2797,1337419339,1337419399,0,3,60
32,3878,542,1337643795,1337645700,0,4,1905
32,3878,2798,1337645700,1337656259,0,4,10559
32,3878,2799,1337656259,1337656971,0,4,712
32,3878,2800,1337656971,1337657031,0,4,60
32,3879,922,1337677990,1337680220,0,2,2230
32,3879,2801,1337680220,1337680280,0,2,60
32,3880,59,1337957841,1337957901,0,1,60
32,3881,465,1338006318,1338018580,0,2,12262
32,3881,2802,1338018580,1338018640,0,2,60
32,3882,59,1338297269,1338297329,0,1,60
32,3883,59,1338903574,1338903634,0,1,60
32,3884,59,1339068170,1339068230,0,1,60
32,3885,59,1339161588,1339161648,0,1,60
32,3886,2803,1339211529,1339226190,0,2,14661
32,3886,455,1339226190,1339226250,0,2,60
32,3887,59,1339419495,1339419555,0,1,60
32,3888,59,1339503645,1339503705,0,1,60
32,3889,2804,1339538854,1339538914,0,1,60
32,3890,59,1339572990,1339573050,0,1,60
32,3891,59,1339768139,1339768199,0,1,60
32,3892,2805,1339907141,1339907201,0,1,60
32,3893,59,1340016181,1340016241,0,1,60
32,3894,59,1340285572,1340285632,0,1,60
32,3895,59,1340623823,1340623883,0,1,60
32,3896,59,1340788438,1340788498,0,1,60
32,3897,59,1341220784,1341220844,0,1,60
32,3898,59,1341307131,1341307191,0,1,60
32,3899,59,1341397001,1341397061,0,1,60
32,3900,59,1341492099,1341492159,0,1,60
32,3901,59,1341586039,1341586099,0,1,60
32,3902,2806,1341651199,1341651259,0,1,60
32,3903,2804,1341784711,1341784771,0,1,60
32,3904,59,1341833097,1341833157,0,1,60
32,3905,2804,1341958402,1341977151,0,2,18749
32,3905,59,1341977151,1341977211,0,2,60
32,3906,59,1342175283,1342175343,0,1,60
32,3907,2807,1342252676,1342252736,0,1,60
32,3908,2795,1342344005,1342344065,0,1,60
32,3909,59,1342527588,1342527648,0,1,60
32,3910,59,1342796716,1342796776,0,1,60
32,3911,2808,1343130833,1343130893,0,1,60
32,3912,59,1344520193,1344520253,0,1,60
32,3913,59,1344611461,1344611521,0,1,60
32,3914,59,1344939790,1344939850,0,1,60
32,3915,59,1345467807,1345467867,0,1,60
32,3916,2804,1347227633,1347227693,0,1,60
32,3917,59,1347543709,1347543769,0,1,60
32,3918,2809,1347702311,1347702371,0,1,60
32,3919,59,1349962888,1349962948,0,1,60
32,3920,2810,1350097960,1350101861,0,4,3901
32,3920,2811,1350101861,1350111455,0,4,9594
32,3920,2812,1350111455,1350117786,0,4,6331
32,3920,2797,1350117786,1350117846,0,4,60
32,3921,1093,1350470617,1350470682,0,2,65
32,3921,59,1350470682,1350470742,0,2,60
32,3922,2804,1350599898,1350599958,0,1,60
32,3923,59,1351083169,1351083229,0,1,60
32,3924,1218,1351157684,1351157744,0,1,60
32,3925,59,1351506976,1351507036,0,1,60
32,3926,59,1351664680,1351664740,0,1,60
32,3927,59,1351774166,1351774226,0,1,60
32,3928,59,1352117887,1352117947,0,1,60
32,3929,59,1352192908,1352192968,0,1,60
32,3930,2813,1353458446,1353458506,0,1,60
32,3931,59,1353493557,1353493617,0,1,60
32,3932,2668,1353583370,1353594026,0,2,10656
32,3932,59,1353594026,1353594086,0,2,60
32,3933,2806,1353644084,1353650563,0,3,6479
32,3933,2796,1353650563,1353664560,0,3,13997
32,3933,2814,1353664560,1353664620,0,3,60
32,3934,2815,1353750876,1353750936,0,1,60
32,3935,59,1353932707,1353932767,0,1,60
32,3936,59,1354057767,1354057827,0,1,60
32,3937,59,1354609047,1354609107,0,1,60
32,3938,59,1354712558,1354712618,0,1,60
32,3939,2804,1354747192,1354747949,0,2,757
32,3939,2816,1354747949,1354748009,0,2,60
32,3940,2817,1354796839,1354796899,0,1,60
32,3941,96,1354831635,1354831695,0,1,60
32,3942,2429,1354884621,1354884681,0,1,60
32,3943,2818,1354957615,1354957675,0,1,60
32,3944,2819,1355269250,1355269310,0,1,60
32,3945,2820,1355354645,1355365812,0,3,11167
32,3945,1005,1355365812,1355370273,0,3,4461
32,3945,2194,1355370273,1355370333,0,3,60
32,3946,2194,1355543704,1355544455,0,2,751
32,3946,289,1355544455,1355544515,0,2,60
32,3947,59,1355830638,1355830698,0,1,60
32,3948,59,1355910124,1355910184,0,1,60
32,3949,59,1356085320,1356085380,0,1,60
32,3950,2821,1356166019,1356168277,0,3,2258
32,3950,8,1356168277,1356171001,0,3,2724
32,3950,2822,1356171001,1356171061,0,3,60
32,3951,2795,1356240711,1356240771,0,1,60
32,3952,2823,1356689027,1356689810,0,2,783
32,3952,2818,1356689810,1356689870,0,2,60
32,3953,59,1357562322,1357562382,0,1,60
32,3954,2807,1357696820,1357696880,0,1,60
32,3955,59,1357832114,1357832174,0,1,60
32,3956,2824,1358068379,1358068439,0,1,60
32,3957,2820,1358379425,1358379485,0,1,60
32,3958,59,1358510798,1358510858,0,1,60
32,3959,59,1358774061,1358774121,0,1,60
32,3960,2818,1359113895,1359113955,0,1,60
32,3961,59,1359467460,1359467520,0,1,60
32,3962,59,1359536640,1359540703,0,2,4063
32,3962,2801,1359540703,1359540763,0,2,60
32,3963,2818,1359723088,1359728393,0,2,5305
32,3963,59,1359728393,1359728453,0,2,60
32,3964,59,1360056304,1360056364,0,1,60
32,3965,59,1360154943,1360155003,0,1,60
33,3966,59,1360763871,1360763931,0,1,60
33,3967,2825,1333874494,1333882609,0,2,8115
33,3967,2826,1333882609,1333882669,0,2,60
33,3968,1143,1334288958,1334289018,0,1,60
33,3969,449,1339630287,1339632717,0,2,2430
33,3969,5,1339632717,1339632777,0,2,60
33,3970,449,1339759391,1339759451,0,1,60
33,3971,449,1339975775,1339978046,0,2,2271
33,3971,5,1339978046,1339978106,0,2,60
33,3972,5,1340022531,1340027976,0,2,5445
33,3972,449,1340027976,1340028036,0,2,60
33,3973,5,1340101283,1340101343,0,1,60
33,3974,71,1340236578,1340236638,0,1,60
33,3975,2827,1340281450,1340281510,0,1,60
33,3976,449,1340752464,1340752524,0,1,60
33,3977,449,1341110302,1341111740,0,2,1438
33,3977,2828,1341111740,1341111800,0,2,60
33,3978,5,1341311280,1341313611,0,2,2331
33,3978,449,1341313611,1341313671,0,2,60
33,3979,2829,1341488024,1341488084,0,1,60
33,3980,449,1341644299,1341646065,0,4,1766
33,3980,5,1341646065,1341648912,0,4,2847
33,3980,449,1341648912,1341649902,0,4,990
33,3980,2830,1341649902,1341649962,0,4,60
33,3981,5,1341792506,1341810752,0,2,18246
33,3981,2831,1341810752,1341810812,0,2,60
33,3982,449,1341875739,1341875799,0,1,60
33,3983,2832,1342096837,1342096897,0,1,60
33,3984,449,1342135425,1342135485,0,1,60
33,3985,5,1342614689,1342614749,0,1,60
33,3986,449,1342654054,1342654114,0,1,60
33,3987,449,1342827492,1342829926,0,2,2434
33,3987,5,1342829926,1342829986,0,2,60
33,3988,449,1343345089,1343345149,0,1,60
33,3989,5,1343455967,1343458451,0,3,2484
33,3989,2833,1343458451,1343463395,0,3,4944
33,3989,2834,1343463395,1343463455,0,3,60
33,3990,5,1343607048,1343607108,0,1,60
33,3991,449,1344691768,1344691828,0,1,60
33,3992,583,1344742663,1344746177,0,2,3514
33,3992,2831,1344746177,1344746237,0,2,60
33,3993,449,1344900407,1344900467,0,1,60
33,3994,5,1345261499,1345261559,0,1,60
33,3995,260,1345295819,1345295879,0,1,60
33,3996,2835,1345341883,1345341943,0,1,60
33,3997,2836,1345378364,1345378424,0,1,60
33,3998,449,1345419074,1345419134,0,1,60
33,3999,2831,1347626528,1347626588,0,1,60
33,4000,449,1347675889,1347678470,0,4,2581
33,4000,2837,1347678470,1347683749,0,4,5279
33,4000,465,1347683749,1347687991,0,4,4242
33,4000,2838,1347687991,1347688051,0,4,60
33,4001,449,1349998838,1350001050,0,2,2212
33,4001,5,1350001050,1350001110,0,2,60
33,4002,449,1350046568,1350046628,0,1,60
33,4003,2835,1350090363,1350090423,0,1,60
33,4004,8,1350382822,1350382882,0,1,60
33,4005,2839,1350473970,1350474030,0,1,60
33,4006,1563,1350646026,1350646086,0,1,60
33,4007,5,1350989353,1350989413,0,1,60
33,4008,449,1351086120,1351086180,0,1,60
33,4009,5,1351163873,1351163933,0,1,60
33,4010,5,1351303892,1351305382,0,2,1490
33,4010,2840,1351305382,1351305442,0,2,60
33,4011,2841,1351338574,1351338634,0,1,60
33,4012,449,1351638599,1351642289,0,4,3690
33,4012,2842,1351642289,1351649582,0,4,7293
33,4012,875,1351649582,1351651596,0,4,2014
33,4012,5,1351651596,1351651656,0,4,60
33,4013,449,1351727256,1351729769,0,2,2513
33,4013,5,1351729769,1351729829,0,2,60
33,4014,449,1351813615,1351813675,0,1,60
33,4015,2830,1351854684,1351854744,0,1,60
33,4016,449,1352159802,1352161745,0,2,1943
33,4016,5,1352161745,1352161805,0,2,60
33,4017,2831,1352376183,1352376243,0,1,60
33,4018,2843,1352608719,1352622100,0,3,13381
33,4018,2844,1352622100,1352627409,0,3,5309
33,4018,449,1352627409,1352627469,0,3,60
33,4019,449,1352729072,1352729132,0,1,60
33,4020,5,1352802971,1352805347,0,2,2376
33,4020,2845,1352805347,1352805407,0,2,60
33,4021,449,1353022833,1353022893,0,1,60
33,4022,5,1353370826,1353371271,0,2,445
33,4022,2833,1353371271,1353371331,0,2,60
33,4023,766,1353820252,1353822729,0,4,2477
33,4023,2846,1353822729,1353831555,0,4,8826
33,4023,5,1353831555,1353833459,0,4,1904
33,4023,449,1353833459,1353833519,0,4,60
33,4024,5,1353889254,1353889314,0,1,60
33,4025,2847,1354016958,1354017018,0,1,60
33,4026,2848,1354342750,1354348599,0,2,5849
33,4026,2849,1354348599,1354348659,0,2,60
33,4027,5,1354494821,1354494881,0,1,60
33,4028,449,1354535802,1354535862,0,1,60
33,4029,2831,1354627038,1354627098,0,1,60
33,4030,449,1354665386,1354665446,0,1,60
33,4031,5,1354753187,1354753657,0,2,470
33,4031,2833,1354753657,1354753717,0,2,60
33,4032,449,1356602701,1356602761,0,1,60
33,4033,2830,1357270090,1357270150,0,1,60
33,4034,2850,1357812648,1357812708,0,1,60
33,4035,449,1357956608,1357958334,0,2,1726
33,4035,601,1357958334,1357958394,0,2,60
33,4036,260,1358153690,1358153750,0,1,60
33,4037,2845,1358770709,1358770769,0,1,60
33,4038,5,1358860035,1358860272,0,2,237
33,4038,2851,1358860272,1358860332,0,2,60
33,4039,2833,1359074178,1359074238,0,1,60
33,4040,2852,1359193623,1359193683,0,1,60
33,4041,5,1359332398,1359332913,0,2,515
33,4041,2853,1359332913,1359332973,0,2,60
33,4042,2847,1359372526,1359372586,0,1,60
33,4043,2847,1359457560,1359457620,0,1,60
33,4044,2833,1359504676,1359504736,0,1,60
33,4045,2833,1360022876,1360022936,0,1,60
33,4046,449,1360068249,1360068309,0,1,60
33,4047,5,1360669363,1360671136,0,3,1773
33,4047,449,1360671136,1360671633,0,3,497
33,4047,2847,1360671633,1360671693,0,3,60
33,4048,2854,1360764661,1360764721,0,1,60
33,4049,2833,1360801927,1360801987,0,1,60
34,4050,684,1360834049,1360837179,0,2,3130
34,4050,2830,1360837179,1360837239,0,2,60
34,4051,834,1338976237,1338976297,0,1,60
34,4052,253,1339227710,1339229457,0,2,1747
34,4052,2855,1339229457,1339229517,0,2,60
34,4053,2856,1339322857,1339322917,0,1,60
34,4054,2857,1339575396,1339584233,0,2,8837
34,4054,2858,1339584233,1339584293,0,2,60
34,4055,2858,1339669809,1339669869,0,1,60
34,4056,2544,1339910066,1339919725,0,7,9659
34,4056,2859,1339919725,1339919763,0,7,38
34,4056,35,1339919763,1339925345,0,7,5582
34,4056,2860,1339925345,1339925869,0,7,524
34,4056,2861,1339925869,1339927223,0,7,1354
34,4056,2860,1339927223,1339927550,0,7,327
34,4056,2862,1339927550,1339927610,0,7,60
34,4057,2863,1340004635,1340015254,0,2,10619
34,4057,2858,1340015254,1340015314,0,2,60
34,4058,2863,1340263055,1340263115,0,1,60
34,4059,2863,1340784778,1340784872,0,2,94
34,4059,2857,1340784872,1340784932,0,2,60
34,4060,2864,1341113937,1341113997,0,1,60
34,4061,2863,1341385961,1341388048,0,7,2087
34,4061,2865,1341388048,1341392417,0,7,4369
34,4061,2455,1341392417,1341392958,0,7,541
34,4061,590,1341392958,1341393324,0,7,366
34,4061,834,1341393324,1341401800,0,7,8476
34,4061,590,1341401800,1341402757,0,7,957
34,4061,2455,1341402757,1341402817,0,7,60
34,4062,2866,1341465292,1341472464,0,2,7172
34,4062,2863,1341472464,1341472524,0,2,60
34,4063,2865,1341560327,1341563505,0,3,3178
34,4063,2862,1341563505,1341571167,0,3,7662
34,4063,2858,1341571167,1341571227,0,3,60
34,4064,2867,1341643373,1341644305,0,6,932
34,4064,2868,1341644305,1341644363,0,6,58
34,4064,2867,1341644363,1341653342,0,6,8979
34,4064,2460,1341653342,1341654682,0,6,1340
34,4064,2869,1341654682,1341654897,0,6,215
34,4064,2870,1341654897,1341654957,0,6,60
34,4065,2871,1341723236,1341723946,0,6,710
34,4065,2872,1341723946,1341733233,0,6,9287
34,4065,2873,1341733233,1341736136,0,6,2903
34,4065,2874,1341736136,1341736597,0,6,461
34,4065,2875,1341736597,1341743746,0,6,7149
34,4065,2863,1341743746,1341743806,0,6,60
34,4066,2863,1341818082,1341829285,0,2,11203
34,4066,2858,1341829285,1341829345,0,2,60
34,4067,2863,1341990407,1341993134,0,3,2727
34,4067,2865,1341993134,1341998804,0,3,5670
34,4067,2876,1341998804,1341998864,0,3,60
34,4068,2863,1342076897,1342076957,0,1,60
34,4069,2877,1342164327,1342166463,0,3,2136
34,4069,2862,1342166463,1342173385,0,3,6922
34,4069,2858,1342173385,1342173445,0,3,60
34,4070,2876,1342262181,1342262244,0,4,63
34,4070,2878,1342262244,1342271397,0,4,9153
34,4070,2879,1342271397,1342271512,0,4,115
34,4070,2880,1342271512,1342271572,0,4,60
34,4071,2863,1342509028,1342509088,0,1,60
34,4072,2455,1342570128,1342571226,0,3,1098
34,4072,2881,1342571226,1342573451,0,3,2225
34,4072,2882,1342573451,1342573511,0,3,60
34,4073,2865,1343117306,1343118945,0,3,1639
34,4073,2883,1343118945,1343125639,0,3,6694
34,4073,2858,1343125639,1343125699,0,3,60
34,4074,2865,1343465449,1343468303,0,4,2854
34,4074,2880,1343468303,1343468630,0,4,327
34,4074,2884,1343468630,1343469175,0,4,545
34,4074,2885,1343469175,1343469235,0,4,60
34,4075,2865,1343625660,1343625683,0,5,23
34,4075,2885,1343625683,1343632269,0,5,6586
34,4075,2863,1343632269,1343644983,0,5,12714
34,4075,2885,1343644983,1343645129,0,5,146
34,4075,2886,1343645129,1343645189,0,5,60
34,4076,2544,1344150990,1344152910,0,4,1920
34,4076,109,1344152910,1344165190,0,4,12280
34,4076,2887,1344165190,1344169822,0,4,4632
34,4076,590,1344169822,1344169882,0,4,60
34,4077,2863,1344237222,1344240026,0,3,2804
34,4077,2865,1344240026,1344240555,0,3,529
34,4077,2885,1344240555,1344240615,0,3,60
34,4078,2888,1344579408,1344593816,0,5,14408
34,4078,2455,1344593816,1344597060,0,5,3244
34,4078,109,1344597060,1344597112,0,5,52
34,4078,2889,1344597112,1344599752,0,5,2640
34,4078,2890,1344599752,1344599812,0,5,60
34,4079,2891,1344646752,1344662707,0,3,15955
34,4079,2865,1344662707,1344664781,0,3,2074
34,4079,2868,1344664781,1344664841,0,3,60
34,4080,109,1344670289,1344676938,0,4,6649
34,4080,2892,1344676938,1344681024,0,4,4086
34,4080,2544,1344681024,1344686190,0,4,5166
34,4080,2893,1344686190,1344686250,0,4,60
34,4081,2455,1344758337,1344761076,0,7,2739
34,4081,109,1344761076,1344770737,0,7,9661
34,4081,2894,1344770737,1344776531,0,7,5794
34,4081,2730,1344776531,1344777220,0,7,689
34,4081,590,1344777220,1344777682,0,7,462
34,4081,2895,1344777682,1344777832,0,7,150
34,4081,2879,1344777832,1344777892,0,7,60
34,4082,2896,1344783830,1344783976,0,2,146
34,4082,2897,1344783976,1344784036,0,2,60
34,4083,2898,1344822681,1344822741,0,1,60
34,4084,2899,1344931340,1344939474,0,6,8134
34,4084,2455,1344939474,1344940044,0,6,570
34,4084,590,1344940044,1344941768,0,6,1724
34,4084,109,1344941768,1344943329,0,6,1561
34,4084,791,1344943329,1344946984,0,6,3655
34,4084,2455,1344946984,1344947044,0,6,60
34,4085,2858,1345262655,1345278937,0,4,16282
34,4085,2455,1345278937,1345281317,0,4,2380
34,4085,2544,1345281317,1345282605,0,4,1288
34,4085,789,1345282605,1345282665,0,4,60
34,4086,109,1345285196,1345285256,0,1,60
34,4087,2875,1345382204,1345382264,0,1,60
34,4088,2865,1345450119,1345450614,0,2,495
34,4088,2886,1345450614,1345450674,0,2,60
34,4089,2900,1346908514,1346908574,0,1,60
34,4090,2862,1347525953,1347544969,0,2,19016
34,4090,2875,1347544969,1347545029,0,2,60
34,4091,2875,1347626073,1347626133,0,1,60
34,4092,2455,1347669773,1347669833,0,1,60
34,4093,2875,1347768165,1347768225,0,1,60
34,4094,2868,1349685675,1349685735,0,1,60
34,4095,2863,1350025756,1350026518,0,5,762
34,4095,2865,1350026518,1350033314,0,5,6796
34,4095,2455,1350033314,1350034579,0,5,1265
34,4095,2518,1350034579,1350044086,0,5,9507
34,4095,2901,1350044086,1350044146,0,5,60
34,4096,2455,1350102552,1350109877,0,6,7325
34,4096,2902,1350109877,1350111485,0,6,1608
34,4096,400,1350111485,1350114638,0,6,3153
34,4096,2903,1350114638,1350115123,0,6,485
34,4096,2904,1350115123,1350116763,0,6,1640
34,4096,2862,1350116763,1350116823,0,6,60
34,4097,2905,1350959259,1350963889,0,3,4630
34,4097,2906,1350963889,1350977887,0,3,13998
34,4097,2885,1350977887,1350977947,0,3,60
34,4098,2863,1351062441,1351062501,0,1,60
34,4099,2907,1351149011,1351149552,0,3,541
34,4099,2863,1351149552,1351167030,0,3,17478
34,4099,2908,1351167030,1351167090,0,3,60
34,4100,2909,1351173329,1351173389,0,1,60
34,4101,2863,1351235182,1351237128,0,3,1946
34,4101,2865,1351237128,1351243780,0,3,6652
34,4101,2518,1351243780,1351243840,0,3,60
34,4102,648,1351260862,1351260922,0,1,60
34,4103,2862,1351317030,1351317090,0,1,60
34,4104,2910,1351352653,1351352713,0,1,60
34,4105,2911,1351487718,1351488591,0,5,873
34,4105,2879,1351488591,1351494769,0,5,6178
34,4105,2912,1351494769,1351497751,0,5,2982
34,4105,2913,1351497751,1351497763,0,5,12
34,4105,2891,1351497763,1351497823,0,5,60
34,4106,2863,1351754004,1351772686,0,2,18682
34,4106,2914,1351772686,1351772746,0,2,60
34,4107,253,1351777878,1351778788,0,2,910
34,4107,2443,1351778788,1351778848,0,2,60
34,4108,2863,1351840237,1351842238,0,2,2001
34,4108,2865,1351842238,1351842298,0,2,60
34,4109,109,1352176461,1352185942,0,2,9481
34,4109,2857,1352185942,1352186002,0,2,60
34,4110,2863,1352273582,1352273642,0,1,60
34,4111,2863,1352790395,1352794829,0,2,4434
34,4111,2876,1352794829,1352794889,0,2,60
34,4112,2915,1353058354,1353058414,0,1,60
34,4113,2544,1353231760,1353231820,0,1,60
34,4114,2863,1354692327,1354692387,0,1,60
34,4115,2460,1355039502,1355039519,0,2,17
34,4115,2916,1355039519,1355039579,0,2,60
34,4116,2857,1355219497,1355219557,0,1,60
34,4117,385,1355563553,1355563613,0,1,60
34,4118,2444,1355640708,1355640768,0,1,60
34,4119,35,1357811244,1357811547,0,3,303
34,4119,2730,1357811547,1357815870,0,3,4323
34,4119,834,1357815870,1357815930,0,3,60
35,4120,2917,1359723330,1359723390,0,1,60
35,4121,2918,1338761179,1338761493,0,6,314
35,4121,425,1338761493,1338764393,0,6,2900
35,4121,1392,1338764393,1338767853,0,6,3460
35,4121,2919,1338767853,1338768733,0,6,880
35,4121,651,1338768733,1338781560,0,6,12827
35,4121,2920,1338781560,1338781620,0,6,60
35,4122,1392,1338803861,1338805634,0,5,1773
35,4122,1778,1338805634,1338806781,0,5,1147
35,4122,536,1338806781,1338809113,0,5,2332
35,4122,2921,1338809113,1338817812,0,5,8699
35,4122,2922,1338817812,1338817872,0,5,60
35,4123,1392,1338854889,1338865875,0,2,10986
35,4123,2923,1338865875,1338865935,0,2,60
35,4124,2924,1338884521,1338885843,0,4,1322
35,4124,1392,1338885843,1338887328,0,4,1485
35,4124,1778,1338887328,1338887358,0,4,30
35,4124,2925,1338887358,1338887418,0,4,60
35,4125,425,1338977646,1338978641,0,2,995
35,4125,536,1338978641,1338978701,0,2,60
35,4126,536,1339026598,1339038916,0,3,12318
35,4126,2926,1339038916,1339040975,0,3,2059
35,4126,2610,1339040975,1339041035,0,3,60
35,4127,598,1339049354,1339049697,0,4,343
35,4127,2927,1339049697,1339060251,0,4,10554
35,4127,1323,1339060251,1339061935,0,4,1684
35,4127,1392,1339061935,1339061995,0,4,60
35,4128,2928,1339071020,1339071874,0,5,854
35,4128,1392,1339071874,1339073407,0,5,1533
35,4128,1778,1339073407,1339073858,0,5,451
35,4128,425,1339073858,1339074453,0,5,595
35,4128,536,1339074453,1339074513,0,5,60
35,4129,536,1339106554,1339108395,0,5,1841
35,4129,2817,1339108395,1339113785,0,5,5390
35,4129,2929,1339113785,1339114736,0,5,951
35,4129,2577,1339114736,1339118229,0,5,3493
35,4129,2180,1339118229,1339118289,0,5,60
35,4130,2930,1339156316,1339156740,0,4,424
35,4130,2931,1339156740,1339159708,0,4,2968
35,4130,747,1339159708,1339160278,0,4,570
35,4130,2932,1339160278,1339160338,0,4,60
35,4131,536,1339195924,1339195984,0,1,60
35,4132,2684,1339234202,1339234419,0,5,217
35,4132,651,1339234419,1339234902,0,5,483
35,4132,2933,1339234902,1339236364,0,5,1462
35,4132,2934,1339236364,1339240161,0,5,3797
35,4132,2935,1339240161,1339240221,0,5,60
35,4133,2936,1339312755,1339313884,0,6,1129
35,4133,2937,1339313884,1339315500,0,6,1616
35,4133,536,1339315500,1339315904,0,6,404
35,4133,2938,1339315904,1339317081,0,6,1177
35,4133,2939,1339317081,1339334237,0,6,17156
35,4133,2940,1339334237,1339334297,0,6,60
35,4134,2921,1339334931,1339335138,0,3,207
35,4134,2941,1339335138,1339335998,0,3,860
35,4134,536,1339335998,1339336058,0,3,60
35,4135,2936,1339408948,1339409486,0,5,538
35,4135,2942,1339409486,1339409744,0,5,258
35,4135,2943,1339409744,1339413996,0,5,4252
35,4135,536,1339413996,1339414896,0,5,900
35,4135,2936,1339414896,1339414956,0,5,60
35,4136,536,1339455216,1339458614,0,9,3398
35,4136,2536,1339458614,1339458737,0,9,123
35,4136,2944,1339458737,1339458900,0,9,163
35,4136,541,1339458900,1339459439,0,9,539
35,4136,2945,1339459439,1339459460,0,9,21
35,4136,2946,1339459460,1339459938,0,9,478
35,4136,2947,1339459938,1339473119,0,9,13181
35,4136,2948,1339473119,1339473741,0,9,622
35,4136,2949,1339473741,1339473801,0,9,60
35,4137,2950,1339478978,1339481285,0,11,2307
35,4137,791,1339481285,1339482621,0,11,1336
35,4137,35,1339482621,1339482642,0,11,21
35,4137,480,1339482642,1339482692,0,11,50
35,4137,762,1339482692,1339486855,0,11,4163
35,4137,2951,1339486855,1339490146,0,11,3291
35,4137,35,1339490146,1339491201,0,11,1055
35,4137,732,1339491201,1339492338,0,11,1137
35,4137,1392,1339492338,1339499183,0,11,6845
35,4137,536,1339499183,1339499825,0,11,642
35,4137,2942,1339499825,1339499885,0,11,60
35,4138,2291,1339553686,1339553702,0,9,16
35,4138,2952,1339553702,1339560526,0,9,6824
35,4138,253,1339560526,1339561183,0,9,657
35,4138,2953,1339561183,1339564347,0,9,3164
35,4138,253,1339564347,1339565664,0,9,1317
35,4138,314,1339565664,1339567156,0,9,1492
35,4138,2954,1339567156,1339567690,0,9,534
35,4138,2955,1339567690,1339568082,0,9,392
35,4138,2956,1339568082,1339568142,0,9,60
35,4139,314,1339576480,1339577646,0,4,1166
35,4139,425,1339577646,1339579240,0,4,1594
35,4139,536,1339579240,1339580187,0,4,947
35,4139,2936,1339580187,1339580247,0,4,60
35,4140,2942,1339624730,1339626769,0,11,2039
35,4140,1778,1339626769,1339628916,0,11,2147
35,4140,1392,1339628916,1339631601,0,11,2685
35,4140,2919,1339631601,1339632919,0,11,1318
35,4140,651,1339632919,1339632949,0,11,30
35,4140,2933,1339632949,1339634045,0,11,1096
35,4140,920,1339634045,1339642002,0,11,7957
35,4140,2957,1339642002,1339644317,0,11,2315
35,4140,2958,1339644317,1339645238,0,11,921
35,4140,920,1339645238,1339645831,0,11,593
35,4140,651,1339645831,1339645891,0,11,60
35,4141,5,1339647847,1339648369,0,11,522
35,4141,30,1339648369,1339649707,0,11,1338
35,4141,1566,1339649707,1339650170,0,11,463
35,4141,25,1339650170,1339650902,0,11,732
35,4141,20,1339650902,1339653833,0,11,2931
35,4141,2959,1339653833,1339664913,0,11,11080
35,4141,2960,1339664913,1339664964,0,11,51
35,4141,2961,1339664964,1339664977,0,11,13
35,4141,2962,1339664977,1339666212,0,11,1235
35,4141,2933,1339666212,1339668219,0,11,2007
35,4141,747,1339668219,1339668279,0,11,60
35,4142,2963,1339760899,1339761908,0,6,1009
35,4142,35,1339761908,1339762808,0,6,900
35,4142,253,1339762808,1339762829,0,6,21
35,4142,59,1339762829,1339764805,0,6,1976
35,4142,536,1339764805,1339764955,0,6,150
35,4142,2942,1339764955,1339765015,0,6,60
35,4143,2921,1339937937,1339937956,0,3,19
35,4143,536,1339937956,1339938109,0,3,153
35,4143,2932,1339938109,1339938169,0,3,60
35,4144,1392,1339974440,1339993121,0,2,18681
35,4144,2964,1339993121,1339993181,0,2,60
35,4145,1392,1340010313,1340012313,0,4,2000
35,4145,1778,1340012313,1340013682,0,4,1369
35,4145,536,1340013682,1340013713,0,4,31
35,4145,2965,1340013713,1340013773,0,4,60
35,4146,2966,1340100734,1340100794,0,1,60
35,4147,2942,1340234220,1340234259,0,6,39
35,4147,2967,1340234259,1340234275,0,6,16
35,4147,536,1340234275,1340242085,0,6,7810
35,4147,2968,1340242085,1340243402,0,6,1317
35,4147,2969,1340243402,1340243410,0,6,8
35,4147,261,1340243410,1340243470,0,6,60
35,4148,5,1340256628,1340256923,0,4,295
35,4148,736,1340256923,1340258365,0,4,1442
35,4148,541,1340258365,1340274900,0,4,16535
35,4148,77,1340274900,1340274960,0,4,60
35,4149,1024,1340616991,1340619975,0,3,2984
35,4149,77,1340619975,1340621019,0,3,1044
35,4149,536,1340621019,1340621079,0,3,60
35,4150,651,1340756409,1340765461,0,3,9052
35,4150,2970,1340765461,1340767769,0,3,2308
35,4150,5,1340767769,1340767829,0,3,60
35,4151,2971,1340778065,1340779572,0,2,1507
35,4151,2972,1340779572,1340779632,0,2,60
35,4152,747,1341222157,1341231058,0,2,8901
35,4152,2973,1341231058,1341231118,0,2,60
35,4153,1392,1341270617,1341270677,0,1,60
35,4154,2974,1341295646,1341296031,0,5,385
35,4154,1796,1341296031,1341296076,0,5,45
35,4154,2975,1341296076,1341309866,0,5,13790
35,4154,2933,1341309866,1341315179,0,5,5313
35,4154,536,1341315179,1341315239,0,5,60
35,4155,2976,1341364486,1341376310,0,4,11824
35,4155,2977,1341376310,1341376325,0,4,15
35,4155,2978,1341376325,1341381901,0,4,5576
35,4155,2919,1341381901,1341381961,0,4,60
35,4156,2979,1341446463,1341446789,0,6,326
35,4156,2980,1341446789,1341447305,0,6,516
35,4156,2981,1341447305,1341455204,0,6,7899
35,4156,2982,1341455204,1341466077,0,6,10873
35,4156,314,1341466077,1341466097,0,6,20
35,4156,313,1341466097,1341466157,0,6,60
35,4157,2955,1341469079,1341469139,0,1,60
35,4158,2983,1341554008,1341557242,0,2,3234
35,4158,2984,1341557242,1341557302,0,2,60
35,4159,536,1341578817,1341578877,0,1,60
35,4160,536,1341612904,1341628018,0,2,15114
35,4160,2338,1341628018,1341628078,0,2,60
35,4161,2936,1341727709,1341728641,0,4,932
35,4161,536,1341728641,1341738382,0,4,9741
35,4161,2985,1341738382,1341740237,0,4,1855
35,4161,2942,1341740237,1341740297,0,4,60
35,4162,536,1341790029,1341792666,0,4,2637
35,4162,359,1341792666,1341792697,0,4,31
35,4162,2986,1341792697,1341803476,0,4,10779
35,4162,1392,1341803476,1341803536,0,4,60
35,4163,2987,1341815110,1341815485,0,4,375
35,4163,2988,1341815485,1341828488,0,4,13003
35,4163,1392,1341828488,1341831709,0,4,3221
35,4163,536,1341831709,1341831769,0,4,60
35,4164,2936,1341841235,1341841295,0,1,60
35,4165,284,1341977287,1341979308,0,5,2021
35,4165,2989,1341979308,1341989149,0,5,9841
35,4165,1595,1341989149,1341989192,0,5,43
35,4165,2990,1341989192,1341993308,0,5,4116
35,4165,1392,1341993308,1341993368,0,5,60
35,4166,2940,1342012208,1342012260,0,2,52
35,4166,536,1342012260,1342012320,0,2,60
35,4167,2942,1342049629,1342051909,0,10,2280
35,4167,443,1342051909,1342059318,0,10,7409
35,4167,1256,1342059318,1342059341,0,10,23
35,4167,2991,1342059341,1342059360,0,10,19
35,4167,2992,1342059360,1342059835,0,10,475
35,4167,464,1342059835,1342060841,0,10,1006
35,4167,2993,1342060841,1342061410,0,10,569
35,4167,2577,1342061410,1342065273,0,10,3863
35,4167,2994,1342065273,1342068528,0,10,3255
35,4167,2995,1342068528,1342068588,0,10,60
35,4168,1778,1342084479,1342086247,0,2,1768
35,4168,536,1342086247,1342086307,0,2,60
35,4169,2996,1342150951,1342151949,0,5,998
35,4169,2997,1342151949,1342151965,0,5,16
35,4169,2998,1342151965,1342154525,0,5,2560
35,4169,2999,1342154525,1342169267,0,5,14742
35,4169,2968,1342169267,1342169327,0,5,60
35,4170,263,1342178970,1342186580,0,2,7610
35,4170,536,1342186580,1342186640,0,2,60
35,4171,3000,1342241651,1342241677,0,2,26
35,4171,3001,1342241677,1342241737,0,2,60
35,4172,3002,1342496033,1342503773,0,2,7740
35,4172,1392,1342503773,1342503833,0,2,60
35,4173,536,1342520870,1342520930,0,1,60
35,4174,536,1342568414,1342568474,0,1,60
35,4175,536,1342648316,1342652727,0,3,4411
35,4175,1392,1342652727,1342657512,0,3,4785
35,4175,23,1342657512,1342657572,0,3,60
35,4176,5,1343119274,1343128373,0,2,9099
35,4176,536,1343128373,1343128433,0,2,60
35,4177,2936,1345337869,1345350732,0,3,12863
35,4177,2943,1345350732,1345350751,0,3,19
35,4177,536,1345350751,1345350811,0,3,60
35,4178,253,1346840200,1346841895,0,4,1695
35,4178,536,1346841895,1346841914,0,4,19
35,4178,2939,1346841914,1346847891,0,4,5977
35,4178,2940,1346847891,1346847951,0,4,60
35,4179,536,1346881198,1346885277,0,5,4079
35,4179,3003,1346885277,1346890350,0,5,5073
35,4179,1392,1346890350,1346902408,0,5,12058
35,4179,1392,1346902408,1346902424,0,5,16
35,4179,3004,1346902424,1346902484,0,5,60
35,4180,73,1347238898,1347238914,0,2,16
35,4180,3005,1347238914,1347238974,0,2,60
35,4181,2936,1347656824,1347661945,0,2,5121
35,4181,3006,1347661945,1347662005,0,2,60
35,4182,2972,1347682667,1347682727,0,1,60
35,4183,536,1347704974,1347705034,0,1,60
35,4184,2919,1350007924,1350008481,0,11,557
35,4184,2751,1350008481,1350014602,0,11,6121
35,4184,3007,1350014602,1350015109,0,11,507
35,4184,233,1350015109,1350015264,0,11,155
35,4184,3008,1350015264,1350015560,0,11,296
35,4184,5,1350015560,1350015682,0,11,122
35,4184,20,1350015682,1350019881,0,11,4199
35,4184,30,1350019881,1350020332,0,11,451
35,4184,598,1350020332,1350021222,0,11,890
35,4184,3009,1350021222,1350021409,0,11,187
35,4184,3010,1350021409,1350021469,0,11,60
35,4185,434,1350031686,1350047370,0,4,15684
35,4185,573,1350047370,1350050727,0,4,3357
35,4185,536,1350050727,1350050762,0,4,35
35,4185,3011,1350050762,1350050822,0,4,60
35,4186,920,1350381213,1350381273,0,1,60
35,4187,1778,1350467321,1350468147,0,3,826
35,4187,2934,1350468147,1350469418,0,3,1271
35,4187,536,1350469418,1350469478,0,3,60
35,4188,3012,1350602857,1350602880,0,7,23
35,4188,3003,1350602880,1350608808,0,7,5928
35,4188,3013,1350608808,1350608891,0,7,83
35,4188,3014,1350608891,1350610239,0,7,1348
35,4188,732,1350610239,1350610873,0,7,634
35,4188,1392,1350610873,1350610903,0,7,30
35,4188,3003,1350610903,1350610963,0,7,60
35,4189,1323,1350892712,1350892772,0,1,60
35,4190,536,1350942768,1350947195,0,6,4427
35,4190,2928,1350947195,1350947221,0,6,26
35,4190,3003,1350947221,1350962038,0,6,14817
35,4190,23,1350962038,1350962062,0,6,24
35,4190,3015,1350962062,1350962100,0,6,38
35,4190,3016,1350962100,1350962160,0,6,60
35,4191,603,1350972388,1350972570,0,8,182
35,4191,1257,1350972570,1350973629,0,8,1059
35,4191,3002,1350973629,1350973652,0,8,23
35,4191,3017,1350973652,1350982703,0,8,9051
35,4191,1257,1350982703,1350983447,0,8,744
35,4191,35,1350983447,1350984186,0,8,739
35,4191,253,1350984186,1350986270,0,8,2084
35,4191,536,1350986270,1350986330,0,8,60
35,4192,1778,1351031516,1351036332,0,12,4816
35,4192,1392,1351036332,1351036350,0,12,18
35,4192,2928,1351036350,1351036367,0,12,17
35,4192,1392,1351036367,1351036390,0,12,23
35,4192,3018,1351036390,1351038507,0,12,2117
35,4192,23,1351038507,1351045951,0,12,7444
35,4192,3019,1351045951,1351046459,0,12,508
35,4192,434,1351046459,1351049413,0,12,2954
35,4192,2993,1351049413,1351049499,0,12,86
35,4192,732,1351049499,1351050167,0,12,668
35,4192,3012,1351050167,1351050186,0,12,19
35,4192,3003,1351050186,1351050246,0,12,60
35,4193,2919,1351062002,1351062545,0,5,543
35,4193,737,1351062545,1351062785,0,5,240
35,4193,3020,1351062785,1351068315,0,5,5530
35,4193,3021,1351068315,1351072830,0,5,4515
35,4193,536,1351072830,1351072890,0,5,60
35,4194,536,1351117081,1351121437,0,3,4356
35,4194,50,1351121437,1351121646,0,3,209
35,4194,3022,1351121646,1351121706,0,3,60
35,4195,30,1351142714,1351148375,0,2,5661
35,4195,598,1351148375,1351148435,0,2,60
35,4196,2338,1351209488,1351215088,0,6,5600
35,4196,640,1351215088,1351216240,0,6,1152
35,4196,3023,1351216240,1351221743,0,6,5503
35,4196,3024,1351221743,1351224363,0,6,2620
35,4196,798,1351224363,1351226058,0,6,1695
35,4196,284,1351226058,1351226118,0,6,60
35,4197,3025,1351232816,1351232861,0,7,45
35,4197,3026,1351232861,1351240900,0,7,8039
35,4197,3025,1351240900,1351241272,0,7,372
35,4197,612,1351241272,1351242914,0,7,1642
35,4197,253,1351242914,1351243376,0,7,462
35,4197,170,1351243376,1351251315,0,7,7939
35,4197,2953,1351251315,1351251375,0,7,60
35,4198,3027,1351256324,1351256352,0,2,28
35,4198,536,1351256352,1351256412,0,2,60
35,4199,536,1351404086,1351404146,0,1,60
35,4200,536,1351462698,1351467450,0,11,4752
35,4200,1392,1351467450,1351468148,0,11,698
35,4200,5,1351468148,1351469207,0,11,1059
35,4200,1588,1351469207,1351471617,0,11,2410
35,4200,1588,1351471617,1351471805,0,11,188
35,4200,695,1351471805,1351472382,0,11,577
35,4200,3028,1351472382,1351480895,0,11,8513
35,4200,3029,1351480895,1351482491,0,11,1596
35,4200,5,1351482491,1351483671,0,11,1180
35,4200,1392,1351483671,1351483703,0,11,32
35,4200,2928,1351483703,1351483763,0,11,60
35,4201,386,1351492557,1351492578,0,9,21
35,4201,3030,1351492578,1351492607,0,9,29
35,4201,297,1351492607,1351492643,0,9,36
35,4201,365,1351492643,1351492667,0,9,24
35,4201,2959,1351492667,1351498445,0,9,5778
35,4201,3030,1351498445,1351499309,0,9,864
35,4201,920,1351499309,1351507660,0,9,8351
35,4201,536,1351507660,1351507684,0,9,24
35,4201,3031,1351507684,1351507744,0,9,60
35,4202,536,1351600998,1351601024,0,3,26
35,4202,3032,1351601024,1351601048,0,3,24
35,4202,2942,1351601048,1351601108,0,3,60
35,4203,536,1351634264,1351638680,0,4,4416
35,4203,3003,1351638680,1351654973,0,4,16293
35,4203,3033,1351654973,1351654999,0,4,26
35,4203,3018,1351654999,1351655059,0,4,60
35,4204,3034,1351662136,1351675966,0,3,13830
35,4204,425,1351675966,1351676849,0,3,883
35,4204,536,1351676849,1351676909,0,3,60
35,4205,536,1351720927,1351725293,0,3,4366
35,4205,1392,1351725293,1351741419,0,3,16126
35,4205,3035,1351741419,1351741479,0,3,60
35,4206,359,1351750870,1351750893,0,6,23
35,4206,3036,1351750893,1351762274,0,6,11381
35,4206,3037,1351762274,1351765954,0,6,3680
35,4206,3038,1351765954,1351766256,0,6,302
35,4206,425,1351766256,1351768204,0,6,1948
35,4206,536,1351768204,1351768264,0,6,60
35,4207,2936,1351780316,1351780376,0,1,60
35,4208,1778,1351809153,1351813939,0,5,4786
35,4208,1392,1351813939,1351814041,0,5,102
35,4208,3003,1351814041,1351823718,0,5,9677
35,4208,2999,1351823718,1351824017,0,5,299
35,4208,3039,1351824017,1351824077,0,5,60
35,4209,23,1351832745,1351832775,0,9,30
35,4209,3040,1351832775,1351834208,0,9,1433
35,4209,2982,1351834208,1351834243,0,9,35
35,4209,3041,1351834243,1351834480,0,9,237
35,4209,3042,1351834480,1351835892,0,9,1412
35,4209,3043,1351835892,1351835917,0,9,25
35,4209,3044,1351835917,1351853482,0,9,17565
35,4209,1392,1351853482,1351853526,0,9,44
35,4209,3003,1351853526,1351853586,0,9,60
35,4210,3035,1351854354,1351854414,0,1,60
35,4211,762,1352107619,1352108797,0,4,1178
35,4211,253,1352108797,1352113323,0,4,4526
35,4211,536,1352113323,1352113417,0,4,94
35,4211,3045,1352113417,1352113477,0,4,60
35,4212,1392,1352156720,1352156748,0,4,28
35,4212,2928,1352156748,1352161289,0,4,4541
35,4212,3046,1352161289,1352171757,0,4,10468
35,4212,3047,1352171757,1352171817,0,4,60
35,4213,3048,1352182026,1352194827,0,6,12801
35,4213,1,1352194827,1352195478,0,6,651
35,4213,3049,1352195478,1352195520,0,6,42
35,4213,622,1352195520,1352200123,0,6,4603
35,4213,536,1352200123,1352200174,0,6,51
35,4213,3050,1352200174,1352200234,0,6,60
35,4214,2934,1352240173,1352243055,0,2,2882
35,4214,1392,1352243055,1352243115,0,2,60
35,4215,1392,1352272848,1352272874,0,6,26
35,4215,3012,1352272874,1352272967,0,6,93
35,4215,3003,1352272967,1352288773,0,6,15806
35,4215,77,1352288773,1352288795,0,6,22
35,4215,536,1352288795,1352288815,0,6,20
35,4215,2940,1352288815,1352288875,0,6,60
35,4216,5,1352365236,1352366374,0,5,1138
35,4216,30,1352366374,1352374940,0,5,8566
35,4216,425,1352374940,1352375912,0,5,972
35,4216,536,1352375912,1352375933,0,5,21
35,4216,3051,1352375933,1352375993,0,5,60
35,4217,536,1352460535,1352462192,0,3,1657
35,4217,2973,1352462192,1352465071,0,3,2879
35,4217,3052,1352465071,1352465131,0,3,60
35,4218,536,1352498454,1352502778,0,2,4324
35,4218,2338,1352502778,1352502838,0,2,60
35,4219,536,1352669211,1352669271,0,1,60
35,4220,3053,1352705248,1352719086,0,4,13838
35,4220,736,1352719086,1352719132,0,4,46
35,4220,5,1352719132,1352720980,0,4,1848
35,4220,253,1352720980,1352721040,0,4,60
35,4221,3012,1352761644,1352782847,0,2,21203
35,4221,3054,1352782847,1352782907,0,2,60
35,4222,5,1352783472,1352785232,0,7,1760
35,4222,215,1352785232,1352785872,0,7,640
35,4222,1629,1352785872,1352786254,0,7,382
35,4222,3055,1352786254,1352801408,0,7,15154
35,4222,3056,1352801408,1352802981,0,7,1573
35,4222,3057,1352802981,1352804943,0,7,1962
35,4222,536,1352804943,1352805003,0,7,60
35,4223,603,1353058865,1353058905,0,7,40
35,4223,3058,1353058905,1353058946,0,7,41
35,4223,3059,1353058946,1353059029,0,7,83
35,4223,605,1353059029,1353061742,0,7,2713
35,4223,3060,1353061742,1353068414,0,7,6672
35,4223,35,1353068414,1353070263,0,7,1849
35,4223,920,1353070263,1353070323,0,7,60
35,4224,2936,1353229856,1353230640,0,4,784
35,4224,536,1353230640,1353231182,0,4,542
35,4224,2938,1353231182,1353235598,0,4,4416
35,4224,3031,1353235598,1353235658,0,4,60
35,4225,3061,1353403994,1353405412,0,2,1418
35,4225,536,1353405412,1353405472,0,2,60
35,4226,1355,1353491176,1353493563,0,2,2387
35,4226,536,1353493563,1353493623,0,2,60
35,4227,536,1353536002,1353540599,0,3,4597
35,4227,3003,1353540599,1353543337,0,3,2738
35,4227,2930,1353543337,1353543397,0,3,60
35,4228,260,1353571142,1353572608,0,4,1466
35,4228,263,1353572608,1353581436,0,4,8828
35,4228,449,1353581436,1353583227,0,4,1791
35,4228,747,1353583227,1353583287,0,4,60
35,4229,536,1353744330,1353745878,0,5,1548
35,4229,77,1353745878,1353748151,0,5,2273
35,4229,71,1353748151,1353748187,0,5,36
35,4229,3062,1353748187,1353761517,0,5,13330
35,4229,920,1353761517,1353761577,0,5,60
35,4230,3063,1353787118,1353787178,0,1,60
35,4231,3064,1353912783,1353912829,0,3,46
35,4231,3065,1353912829,1353914187,0,3,1358
35,4231,253,1353914187,1353914247,0,3,60
35,4232,536,1353939354,1353939414,0,1,60
35,4233,2928,1354057825,1354057855,0,2,30
35,4233,3003,1354057855,1354057915,0,2,60
35,4234,640,1354166298,1354166358,0,1,60
35,4235,1392,1354490469,1354490482,0,6,13
35,4235,3012,1354490482,1354490502,0,6,20
35,4235,3003,1354490502,1354500896,0,6,10394
35,4235,2929,1354500896,1354501393,0,6,497
35,4235,3066,1354501393,1354507941,0,6,6548
35,4235,273,1354507941,1354508001,0,6,60
35,4236,2919,1354513185,1354514517,0,4,1332
35,4236,3067,1354514517,1354514558,0,4,41
35,4236,3068,1354514558,1354530408,0,4,15850
35,4236,536,1354530408,1354530468,0,4,60
35,4237,2980,1354601452,1354614830,0,4,13378
35,4237,2981,1354614830,1354615253,0,4,423
35,4237,3069,1354615253,1354616687,0,4,1434
35,4237,3070,1354616687,1354616747,0,4,60
35,4238,536,1354658976,1354660398,0,4,1422
35,4238,747,1354660398,1354665972,0,4,5574
35,4238,3071,1354665972,1354665991,0,4,19
35,4238,3072,1354665991,1354666051,0,4,60
35,4239,3073,1354680961,1354699409,0,4,18448
35,4239,3074,1354699409,1354700927,0,4,1518
35,4239,536,1354700927,1354701110,0,4,183
35,4239,2921,1354701110,1354701170,0,4,60
35,4240,100,1354751558,1354752749,0,2,1191
35,4240,3075,1354752749,1354752809,0,2,60
35,4241,2927,1354786861,1354786903,0,3,42
35,4241,598,1354786903,1354789568,0,3,2665
35,4241,77,1354789568,1354789628,0,3,60
35,4242,425,1354836658,1354840154,0,6,3496
35,4242,1392,1354840154,1354840193,0,6,39
35,4242,3003,1354840193,1354846625,0,6,6432
35,4242,351,1354846625,1354855784,0,6,9159
35,4242,284,1354855784,1354857972,0,6,2188
35,4242,2577,1354857972,1354858032,0,6,60
35,4243,573,1354864471,1354864531,0,1,60
35,4244,536,1354918924,1354940282,0,2,21358
35,4244,1323,1354940282,1354940342,0,2,60
35,4245,3076,1354941773,1354944862,0,2,3089
35,4245,3077,1354944862,1354944922,0,2,60
35,4246,1392,1355105587,1355107784,0,3,2197
35,4246,434,1355107784,1355123966,0,3,16182
35,4246,3078,1355123966,1355124026,0,3,60
35,4247,536,1355491708,1355491768,0,1,60
35,4248,2985,1355646240,1355647180,0,2,940
35,4248,3079,1355647180,1355647240,0,2,60
35,4249,3072,1355708936,1355721717,0,3,12781
35,4249,654,1355721717,1355721738,0,3,21
35,4249,3080,1355721738,1355721798,0,3,60
35,4250,3081,1355802756,1355811586,0,2,8830
35,4250,2294,1355811586,1355811646,0,2,60
35,4251,3074,1355826531,1355826538,0,2,7
35,4251,253,1355826538,1355826598,0,2,60
35,4252,1392,1355873029,1355873045,0,4,16
35,4252,3003,1355873045,1355887170,0,4,14125
35,4252,3082,1355887170,1355887211,0,4,41
35,4252,3083,1355887211,1355887271,0,4,60
35,4253,732,1355914701,1355922980,0,2,8279
35,4253,536,1355922980,1355923040,0,2,60
35,4254,2918,1356042139,1356042199,0,1,60
35,4255,1257,1356083348,1356084639,0,2,1291
35,4255,253,1356084639,1356084699,0,2,60
35,4256,3084,1356260037,1356260097,0,1,60
35,4257,434,1356598950,1356610228,0,2,11278
35,4257,253,1356610228,1356610288,0,2,60
35,4258,536,1357033854,1357034626,0,2,772
35,4258,3045,1357034626,1357034686,0,2,60
35,4259,536,1357459114,1357462629,0,2,3515
35,4259,3079,1357462629,1357462689,0,2,60
35,4260,2936,1357781602,1357782672,0,3,1070
35,4260,536,1357782672,1357791941,0,3,9269
35,4260,3085,1357791941,1357792001,0,3,60
35,4261,1392,1358380704,1358381408,0,3,704
35,4261,723,1358381408,1358382245,0,3,837
35,4261,3086,1358382245,1358382305,0,3,60
35,4262,3087,1358402456,1358404556,0,8,2100
35,4262,3088,1358404556,1358416753,0,8,12197
35,4262,200,1358416753,1358417054,0,8,301
35,4262,3089,1358417054,1358417289,0,8,235
35,4262,3090,1358417289,1358418601,0,8,1312
35,4262,762,1358418601,1358419732,0,8,1131
35,4262,253,1358419732,1358421446,0,8,1714
35,4262,536,1358421446,1358421506,0,8,60
35,4263,536,1358506300,1358506788,0,2,488
35,4263,3031,1358506788,1358506848,0,2,60
35,4264,2711,1358832766,1358833806,0,2,1040
35,4264,3091,1358833806,1358833866,0,2,60
35,4265,3040,1359071763,1359071793,0,2,30
35,4265,3041,1359071793,1359071853,0,2,60
35,4266,536,1359117529,1359117589,0,1,60
35,4267,59,1359330847,1359330864,0,5,17
35,4267,253,1359330864,1359337352,0,5,6488
35,4267,2394,1359337352,1359347233,0,5,9881
35,4267,3092,1359347233,1359347271,0,5,38
35,4267,3093,1359347271,1359347331,0,5,60
35,4268,253,1359361227,1359361287,0,1,60
35,4269,2994,1359518726,1359518786,0,1,60
35,4270,2577,1359603892,1359617045,0,2,13153
35,4270,3043,1359617045,1359617105,0,2,60
35,4271,2931,1359678460,1359678520,0,1,60
35,4272,3074,1359710830,1359721245,0,2,10415
35,4272,3094,1359721245,1359721305,0,2,60
35,4273,3095,1359936367,1359936427,0,1,60
35,4274,261,1360037113,1360037173,0,1,60
35,4275,231,1360204427,1360204467,0,3,40
35,4275,3096,1360204467,1360216085,0,3,11618
35,4275,1392,1360216085,1360216145,0,3,60
35,4276,3097,1360228501,1360228561,0,1,60
35,4277,920,1360311655,1360311715,0,1,60
35,4278,253,1360566198,1360567221,0,3,1023
35,4278,2560,1360567221,1360572517,0,3,5296
35,4278,2934,1360572517,1360572577,0,3,60
35,4279,920,1360636613,1360636651,0,2,38
35,4279,3098,1360636651,1360636711,0,2,60
35,4280,425,1360667881,1360667941,0,1,60
35,4281,536,1360711161,1360713918,0,2,2757
35,4281,3099,1360713918,1360713978,0,2,60
36,4282,536,1360767588,1360767648,0,1,60
36,4283,765,1333503463,1333503523,0,1,60
36,4284,3100,1333542978,1333543442,0,3,464
36,4284,588,1333543442,1333545002,0,3,1560
36,4284,3101,1333545002,1333545062,0,3,60
36,4285,11,1333618698,1333621191,0,3,2493
36,4285,3102,1333621191,1333621273,0,3,82
36,4285,3103,1333621273,1333621333,0,3,60
36,4286,2569,1333847530,1333847590,0,1,60
36,4287,2569,1333880215,1333881930,0,4,1715
36,4287,253,1333881930,1333882541,0,4,611
36,4287,3104,1333882541,1333883539,0,4,998
36,4287,3105,1333883539,1333883599,0,4,60
36,4288,284,1334026529,1334026589,0,1,60
36,4289,35,1334114387,1334129426,0,2,15039
36,4289,3106,1334129426,1334129486,0,2,60
36,4290,3107,1334230335,1334230383,0,3,48
36,4290,572,1334230383,1334232101,0,3,1718
36,4290,284,1334232101,1334232161,0,3,60
36,4291,284,1334290970,1334291000,0,8,30
36,4291,588,1334291000,1334291875,0,8,875
36,4291,3100,1334291875,1334298344,0,8,6469
36,4291,3108,1334298344,1334300026,0,8,1682
36,4291,877,1334300026,1334300044,0,8,18
36,4291,609,1334300044,1334305002,0,8,4958
36,4291,1726,1334305002,1334305567,0,8,565
36,4291,35,1334305567,1334305627,0,8,60
36,4292,1419,1334359428,1334359702,0,2,274
36,4292,561,1334359702,1334359762,0,2,60
36,4293,561,1334402164,1334402224,0,1,60
36,4294,561,1334447007,1334447067,0,1,60
36,4295,3109,1334489452,1334489512,0,1,60
36,4296,351,1334566766,1334567170,0,3,404
36,4296,3110,1334567170,1334567986,0,3,816
36,4296,351,1334567986,1334568046,0,3,60
36,4297,3111,1334871852,1334871912,0,1,60
36,4298,3112,1334899638,1334916755,0,6,17117
36,4298,3107,1334916755,1334916973,0,6,218
36,4298,572,1334916973,1334918010,0,6,1037
36,4298,591,1334918010,1334919429,0,6,1419
36,4298,3113,1334919429,1334919741,0,6,312
36,4298,284,1334919741,1334919801,0,6,60
36,4299,253,1334968841,1334969692,0,4,851
36,4299,3114,1334969692,1334970439,0,4,747
36,4299,2326,1334970439,1334971203,0,4,764
36,4299,2569,1334971203,1334971263,0,4,60
36,4300,2697,1335007283,1335007320,0,4,37
36,4300,2569,1335007320,1335008976,0,4,1656
36,4300,253,1335008976,1335009131,0,4,155
36,4300,3115,1335009131,1335009191,0,4,60
36,4301,253,1335054982,1335055429,0,5,447
36,4301,3116,1335055429,1335055816,0,5,387
36,4301,3114,1335055816,1335056668,0,5,852
36,4301,2567,1335056668,1335056853,0,5,185
36,4301,2569,1335056853,1335056913,0,5,60
36,4302,3117,1335093575,1335093590,0,5,15
36,4302,2697,1335093590,1335093603,0,5,13
36,4302,2569,1335093603,1335094780,0,5,1177
36,4302,3114,1335094780,1335095993,0,5,1213
36,4302,253,1335095993,1335096053,0,5,60
36,4303,284,1335142425,1335142449,0,2,24
36,4303,588,1335142449,1335142509,0,2,60
36,4304,3118,1335183046,1335184808,0,3,1762
36,4304,3119,1335184808,1335184827,0,3,19
36,4304,640,1335184827,1335184887,0,3,60
36,4305,35,1335247257,1335248339,0,2,1082
36,4305,866,1335248339,1335248399,0,2,60
36,4306,3120,1335522987,1335532071,0,3,9084
36,4306,609,1335532071,1335532094,0,3,23
36,4306,35,1335532094,1335532154,0,3,60
36,4307,351,1335571122,1335572161,0,4,1039
36,4307,35,1335572161,1335572432,0,4,271
36,4307,115,1335572432,1335573272,0,4,840
36,4307,609,1335573272,1335573332,0,4,60
36,4308,35,1335612506,1335612566,0,1,60
36,4309,35,1335659638,1335659698,0,1,60
36,4310,3121,1335696017,1335704851,0,3,8834
36,4310,284,1335704851,1335705945,0,3,1094
36,4310,351,1335705945,1335706005,0,3,60
36,4311,284,1335919216,1335919241,0,8,25
36,4311,588,1335919241,1335920761,0,8,1520
36,4311,3100,1335920761,1335920784,0,8,23
36,4311,3122,1335920784,1335936177,0,8,15393
36,4311,3123,1335936177,1335936972,0,8,795
36,4311,3100,1335936972,1335940285,0,8,3313
36,4311,3106,1335940285,1335940299,0,8,14
36,4311,464,1335940299,1335940359,0,8,60
36,4312,651,1335941050,1335943170,0,10,2120
36,4312,3124,1335943170,1335943194,0,10,24
36,4312,651,1335943194,1335943871,0,10,677
36,4312,336,1335943871,1335943886,0,10,15
36,4312,3125,1335943886,1335945310,0,10,1424
36,4312,3126,1335945310,1335946005,0,10,695
36,4312,3127,1335946005,1335949162,0,10,3157
36,4312,3126,1335949162,1335950289,0,10,1127
36,4312,3114,1335950289,1335950738,0,10,449
36,4312,253,1335950738,1335950798,0,10,60
36,4313,284,1336129321,1336129336,0,5,15
36,4313,588,1336129336,1336130203,0,5,867
36,4313,3100,1336130203,1336140452,0,5,10249
36,4313,434,1336140452,1336142845,0,5,2393
36,4313,351,1336142845,1336142905,0,5,60
36,4314,434,1336176770,1336176830,0,1,60
36,4315,434,1336215250,1336215495,0,4,245
36,4315,21,1336215495,1336216876,0,4,1381
36,4315,3128,1336216876,1336218464,0,4,1588
36,4315,11,1336218464,1336218524,0,4,60
36,4316,11,1336264748,1336264808,0,1,60
36,4317,351,1336351640,1336351657,0,4,17
36,4317,284,1336351657,1336351690,0,4,33
36,4317,588,1336351690,1336352483,0,4,793
36,4317,3100,1336352483,1336352543,0,4,60
36,4318,3123,1336387740,1336388231,0,2,491
36,4318,3100,1336388231,1336388291,0,2,60
36,4319,351,1336609980,1336610040,0,1,60
36,4320,351,1336696560,1336697290,0,4,730
36,4320,588,1336697290,1336697307,0,4,17
36,4320,284,1336697307,1336698162,0,4,855
36,4320,3100,1336698162,1336698222,0,4,60
36,4321,3123,1336733795,1336736124,0,3,2329
36,4321,3129,1336736124,1336736144,0,3,20
36,4321,284,1336736144,1336736204,0,3,60
36,4322,253,1336785073,1336786964,0,2,1891
36,4322,3126,1336786964,1336787024,0,2,60
36,4323,3130,1336822499,1336822751,0,5,252
36,4323,3127,1336822751,1336822765,0,5,14
36,4323,3126,1336822765,1336827270,0,5,4505
36,4323,3114,1336827270,1336827293,0,5,23
36,4323,253,1336827293,1336827353,0,5,60
36,4324,253,1336873006,1336873072,0,4,66
36,4324,3114,1336873072,1336874406,0,4,1334
36,4324,3126,1336874406,1336874420,0,4,14
36,4324,3127,1336874420,1336874480,0,4,60
36,4325,3130,1336907855,1336908675,0,8,820
36,4325,3126,1336908675,1336909641,0,8,966
36,4325,3131,1336909641,1336910613,0,8,972
36,4325,3100,1336910613,1336915635,0,8,5022
36,4325,3123,1336915635,1336915651,0,8,16
36,4325,3100,1336915651,1336917137,0,8,1486
36,4325,588,1336917137,1336917151,0,8,14
36,4325,284,1336917151,1336917211,0,8,60
36,4326,284,1336984682,1336985728,0,2,1046
36,4326,3132,1336985728,1336985788,0,2,60
36,4327,3133,1337013438,1337032364,0,4,18926
36,4327,3133,1337032364,1337034330,0,4,1966
36,4327,35,1337034330,1337034345,0,4,15
36,4327,877,1337034345,1337034405,0,4,60
36,4328,609,1337047570,1337050584,0,2,3014
36,4328,35,1337050584,1337050644,0,2,60
36,4329,284,1337162705,1337162729,0,4,24
36,4329,588,1337162729,1337163528,0,4,799
36,4329,3100,1337163528,1337176198,0,4,12670
36,4329,434,1337176198,1337176258,0,4,60
36,4330,11,1337215442,1337216443,0,2,1001
36,4330,434,1337216443,1337216503,0,2,60
36,4331,482,1337254864,1337254964,0,4,100
36,4331,3134,1337254964,1337255003,0,4,39
36,4331,434,1337255003,1337256504,0,4,1501
36,4331,11,1337256504,1337256564,0,4,60
36,4332,3100,1337344800,1337346087,0,3,1287
36,4332,3135,1337346087,1337346746,0,3,659
36,4332,3136,1337346746,1337346806,0,3,60
36,4333,3123,1337603011,1337603416,0,2,405
36,4333,3100,1337603416,1337603476,0,2,60
36,4334,3114,1337823481,1337824493,0,4,1012
36,4334,3126,1337824493,1337843415,0,4,18922
36,4334,3127,1337843415,1337843438,0,4,23
36,4334,3137,1337843438,1337843498,0,4,60
36,4335,3126,1337945352,1337945372,0,7,20
36,4335,3114,1337945372,1337945392,0,7,20
36,4335,253,1337945392,1337945991,0,7,599
36,4335,35,1337945991,1337946052,0,7,61
36,4335,609,1337946052,1337950696,0,7,4644
36,4335,3138,1337950696,1337951771,0,7,1075
36,4335,35,1337951771,1337951831,0,7,60
36,4336,35,1337990020,1337991956,0,2,1936
36,4336,609,1337991956,1337992016,0,2,60
36,4337,35,1338076429,1338076886,0,4,457
36,4337,3139,1338076886,1338078032,0,4,1146
36,4337,115,1338078032,1338078074,0,4,42
36,4337,609,1338078074,1338078134,0,4,60
36,4338,1863,1338115877,1338122877,0,3,7000
36,4338,3136,1338122877,1338123144,0,3,267
36,4338,284,1338123144,1338123204,0,3,60
36,4339,284,1338166304,1338166327,0,10,23
36,4339,588,1338166327,1338167746,0,10,1419
36,4339,3123,1338167746,1338167774,0,10,28
36,4339,3122,1338167774,1338173354,0,10,5580
36,4339,3122,1338173354,1338180438,0,10,7084
36,4339,3100,1338180438,1338181673,0,10,1235
36,4339,3131,1338181673,1338181845,0,10,172
36,4339,3114,1338181845,1338181882,0,10,37
36,4339,253,1338181882,1338183067,0,10,1185
36,4339,1085,1338183067,1338183127,0,10,60
36,4340,3114,1338191267,1338191299,0,14,32
36,4340,2569,1338191299,1338191317,0,14,18
36,4340,3117,1338191317,1338191368,0,14,51
36,4340,3126,1338191368,1338195147,0,14,3779
36,4340,3127,1338195147,1338195193,0,14,46
36,4340,3126,1338195193,1338195784,0,14,591
36,4340,425,1338195784,1338196146,0,14,362
36,4340,424,1338196146,1338197035,0,14,889
36,4340,263,1338197035,1338199107,0,14,2072
36,4340,3140,1338199107,1338199228,0,14,121
36,4340,3141,1338199228,1338200494,0,14,1266
36,4340,263,1338200494,1338200509,0,14,15
36,4340,86,1338200509,1338203558,0,14,3049
36,4340,351,1338203558,1338203618,0,14,60
36,4341,253,1338253765,1338255045,0,3,1280
36,4341,3117,1338255045,1338273182,0,3,18137
36,4341,3142,1338273182,1338273242,0,3,60
36,4342,2697,1338290331,1338290608,0,11,277
36,4342,2569,1338290608,1338292016,0,11,1408
36,4342,3131,1338292016,1338292964,0,11,948
36,4342,3100,1338292964,1338293400,0,11,436
36,4342,3122,1338293400,1338297509,0,11,4109
36,4342,3100,1338297509,1338298438,0,11,929
36,4342,588,1338298438,1338298461,0,11,23
36,4342,3136,1338298461,1338299563,0,11,1102
36,4342,3135,1338299563,1338300509,0,11,946
36,4342,284,1338300509,1338301401,0,11,892
36,4342,351,1338301401,1338301461,0,11,60
36,4343,284,1338364715,1338366659,0,3,1944
36,4343,3135,1338366659,1338366670,0,3,11
36,4343,3143,1338366670,1338366730,0,3,60
36,4344,1085,1338558131,1338558167,0,2,36
36,4344,253,1338558167,1338558227,0,2,60
36,4345,253,1338687417,1338687477,0,1,60
36,4346,3136,1338726934,1338726977,0,3,43
36,4346,3135,1338726977,1338727119,0,3,142
36,4346,284,1338727119,1338727179,0,3,60
36,4347,351,1338855607,1338856780,0,4,1173
36,4347,284,1338856780,1338856804,0,4,24
36,4347,588,1338856804,1338868661,0,4,11857
36,4347,3131,1338868661,1338868721,0,4,60
36,4348,2151,1338884367,1338884427,0,1,60
36,4349,35,1338906607,1338906667,0,1,60
36,4350,588,1339116696,1339117634,0,3,938
36,4350,3100,1339117634,1339118319,0,3,685
36,4350,3122,1339118319,1339118379,0,3,60
36,4351,3123,1339154045,1339154105,0,1,60
36,4352,561,1339935075,1339935135,0,1,60
36,4353,284,1339980610,1339980620,0,3,10
36,4353,588,1339980620,1339981255,0,3,635
36,4353,3122,1339981255,1339981315,0,3,60
36,4354,3123,1340016624,1340016684,0,1,60
36,4355,3135,1340625507,1340625567,0,1,60
36,4356,3144,1340798159,1340798219,0,1,60
36,4357,253,1341108122,1341122676,0,2,14554
36,4357,3145,1341122676,1341122736,0,2,60
36,4358,284,1341214270,1341214297,0,3,27
36,4358,588,1341214297,1341214599,0,3,302
36,4358,3100,1341214599,1341214659,0,3,60
36,4359,588,1341236893,1341237829,0,2,936
36,4359,351,1341237829,1341237889,0,2,60
36,4360,284,1341448680,1341448740,0,1,60
36,4361,3100,1341485307,1341485617,0,3,310
36,4361,588,1341485617,1341485627,0,3,10
36,4361,284,1341485627,1341485687,0,3,60
36,4362,284,1341535720,1341536492,0,2,772
36,4362,3100,1341536492,1341536552,0,2,60
36,4363,3146,1341581026,1341581459,0,2,433
36,4363,3135,1341581459,1341581519,0,2,60
36,4364,284,1341751287,1341751347,0,1,60
36,4365,561,1341798553,1341798613,0,1,60
36,4366,3123,1341833995,1341834002,0,2,7
36,4366,3100,1341834002,1341834062,0,2,60
36,4367,588,1341969958,1341969991,0,3,33
36,4367,3100,1341969991,1341970011,0,3,20
36,4367,3122,1341970011,1341970071,0,3,60
36,4368,3123,1342007587,1342007600,0,5,13
36,4368,3147,1342007600,1342008286,0,5,686
36,4368,3100,1342008286,1342008822,0,5,536
36,4368,588,1342008822,1342008842,0,5,20
36,4368,284,1342008842,1342008902,0,5,60
36,4369,3114,1342058506,1342058970,0,2,464
36,4369,3126,1342058970,1342059030,0,2,60
36,4370,3130,1342091448,1342092594,0,3,1146
36,4370,3126,1342092594,1342093995,0,3,1401
36,4370,3114,1342093995,1342094055,0,3,60
36,4371,351,1342138892,1342139865,0,7,973
36,4371,284,1342139865,1342139879,0,7,14
36,4371,588,1342139879,1342140564,0,7,685
36,4371,3100,1342140564,1342158784,0,7,18220
36,4371,375,1342158784,1342159344,0,7,560
36,4371,612,1342159344,1342160357,0,7,1013
36,4371,3100,1342160357,1342160417,0,7,60
36,4372,3100,1342174330,1342174889,0,5,559
36,4372,588,1342174889,1342174907,0,5,18
36,4372,284,1342174907,1342185741,0,5,10834
36,4372,284,1342185741,1342185777,0,5,36
36,4372,351,1342185777,1342185837,0,5,60
36,4373,380,1342223810,1342223870,0,1,60
36,4374,284,1342265470,1342266824,0,2,1354
36,4374,3113,1342266824,1342266884,0,2,60
36,4375,380,1342358110,1342358201,0,3,91
36,4375,284,1342358201,1342358523,0,3,322
36,4375,284,1342358523,1342358583,0,3,60
36,4376,284,1342396362,1342396583,0,2,221
36,4376,380,1342396583,1342396643,0,2,60
36,4377,3114,1342487176,1342488275,0,3,1099
36,4377,2569,1342488275,1342488948,0,3,673
36,4377,3117,1342488948,1342489008,0,3,60
36,4378,2569,1342526965,1342527730,0,4,765
36,4378,3131,1342527730,1342536966,0,4,9236
36,4378,284,1342536966,1342538481,0,4,1515
36,4378,560,1342538481,1342538541,0,4,60
36,4379,3136,1342789102,1342789162,0,1,60
36,4380,561,1343438310,1343438370,0,1,60
36,4381,561,1343479097,1343480594,0,2,1497
36,4381,3148,1343480594,1343480654,0,2,60
36,4382,3136,1343563622,1343563640,0,2,18
36,4382,284,1343563640,1343563700,0,2,60
36,4383,284,1343609573,1343609584,0,2,11
36,4383,588,1343609584,1343609644,0,2,60
36,4384,3100,1343643655,1343643755,0,6,100
36,4384,588,1343643755,1343643769,0,6,14
36,4384,284,1343643769,1343647166,0,6,3397
36,4384,3132,1343647166,1343647574,0,6,408
36,4384,3132,1343647574,1343649058,0,6,1484
36,4384,3135,1343649058,1343649118,0,6,60
36,4385,351,1344212636,1344215005,0,2,2369
36,4385,3149,1344215005,1344215065,0,2,60
36,4386,3123,1344252120,1344252130,0,4,10
36,4386,3122,1344252130,1344253489,0,4,1359
36,4386,588,1344253489,1344253520,0,4,31
36,4386,284,1344253520,1344253580,0,4,60
36,4387,2569,1344515296,1344515344,0,2,48
36,4387,253,1344515344,1344515404,0,2,60
36,4388,3150,1344940009,1344940314,0,2,305
36,4388,3151,1344940314,1344940374,0,2,60
36,4389,253,1345167329,1345168385,0,2,1056
36,4389,3126,1345168385,1345168445,0,2,60
36,4390,11,1345241002,1345241736,0,2,734
36,4390,21,1345241736,1345241796,0,2,60
36,4391,3152,1345378099,1345378130,0,6,31
36,4391,1606,1345378130,1345379909,0,6,1779
36,4391,21,1345379909,1345380334,0,6,425
36,4391,598,1345380334,1345380404,0,6,70
36,4391,5,1345380404,1345381113,0,6,709
36,4391,11,1345381113,1345381173,0,6,60
36,4392,284,1345451417,1345451993,0,4,576
36,4392,3113,1345451993,1345453128,0,4,1135
36,4392,3132,1345453128,1345464465,0,4,11337
36,4392,284,1345464465,1345464525,0,4,60
36,4393,3103,1346845647,1346855072,0,2,9425
36,4393,11,1346855072,1346855132,0,2,60
36,4394,3100,1346894245,1346903975,0,8,9730
36,4394,3122,1346903975,1346905103,0,8,1128
36,4394,3100,1346905103,1346905248,0,8,145
36,4394,588,1346905248,1346907333,0,8,2085
36,4394,3153,1346907333,1346907516,0,8,183
36,4394,2244,1346907516,1346909839,0,8,2323
36,4394,284,1346909839,1346910881,0,8,1042
36,4394,351,1346910881,1346910941,0,8,60
36,4395,253,1347671624,1347671636,0,5,12
36,4395,3114,1347671636,1347672473,0,5,837
36,4395,2569,1347672473,1347672573,0,5,100
36,4395,3154,1347672573,1347691104,0,5,18531
36,4395,3155,1347691104,1347691164,0,5,60
36,4396,2569,1347706082,1347707404,0,3,1322
36,4396,3114,1347707404,1347707599,0,3,195
36,4396,253,1347707599,1347707659,0,3,60
36,4397,253,1347757490,1347757827,0,4,337
36,4397,3114,1347757827,1347759005,0,4,1178
36,4397,2569,1347759005,1347759064,0,4,59
36,4397,3155,1347759064,1347759124,0,4,60
36,4398,2569,1349695246,1349701489,0,2,6243
36,4398,253,1349701489,1349701549,0,2,60
36,4399,11,1350088293,1350088313,0,2,20
36,4399,5,1350088313,1350088373,0,2,60
36,4400,5,1350126353,1350127033,0,2,680
36,4400,11,1350127033,1350127093,0,2,60
36,4401,327,1350900480,1350900540,0,1,60
36,4402,11,1351297410,1351298170,0,2,760
36,4402,651,1351298170,1351298230,0,2,60
37,4403,651,1351335468,1351335528,0,1,60
37,4404,77,1333506070,1333507547,0,5,1477
37,4404,747,1333507547,1333524732,0,5,17185
37,4404,3156,1333524732,1333524754,0,5,22
37,4404,747,1333524754,1333524834,0,5,80
37,4404,77,1333524834,1333524894,0,5,60
37,4405,747,1334043054,1334043264,0,5,210
37,4405,77,1334043264,1334045834,0,5,2570
37,4405,3157,1334045834,1334051035,0,5,5201
37,4405,747,1334051035,1334053526,0,5,2491
37,4405,3158,1334053526,1334053586,0,5,60
37,4406,3159,1334107513,1334107573,0,1,60
37,4407,77,1334194081,1334198733,0,3,4652
37,4407,3156,1334198733,1334199364,0,3,631
37,4407,3160,1334199364,1334199424,0,3,60
37,4408,77,1334279966,1334287498,0,3,7532
37,4408,3156,1334287498,1334287901,0,3,403
37,4408,3160,1334287901,1334287961,0,3,60
37,4409,77,1334379366,1334379426,0,1,60
37,4410,77,1334573669,1334573729,0,1,60
37,4411,77,1334798627,1334798687,0,1,60
37,4412,77,1334893336,1334902085,0,2,8749
37,4412,3161,1334902085,1334902145,0,2,60
37,4413,77,1334972087,1334972365,0,5,278
37,4413,747,1334972365,1334980769,0,5,8404
37,4413,77,1334980769,1334981077,0,5,308
37,4413,3157,1334981077,1334981797,0,5,720
37,4413,3162,1334981797,1334981857,0,5,60
37,4414,693,1335063561,1335063621,0,1,60
37,4415,747,1335236324,1335236384,0,1,60
37,4416,77,1335930457,1335930517,0,1,60
37,4417,747,1336348624,1336348684,0,1,60
37,4418,77,1336555124,1336555184,0,1,60
37,4419,77,1336797658,1336797718,0,1,60
37,4420,35,1336884724,1336890691,0,3,5967
37,4420,3163,1336890691,1336902684,0,3,11993
37,4420,284,1336902684,1336902744,0,3,60
37,4421,77,1336980995,1336986810,0,2,5815
37,4421,693,1336986810,1336986870,0,2,60
37,4422,747,1337161742,1337161802,0,1,60
37,4423,3159,1337218857,1337219638,0,2,781
37,4423,77,1337219638,1337219698,0,2,60
37,4424,3164,1337650712,1337650787,0,2,75
37,4424,77,1337650787,1337650847,0,2,60
37,4425,601,1337991836,1337991947,0,13,111
37,4425,2355,1337991947,1337992630,0,13,683
37,4425,2914,1337992630,1337993034,0,13,404
37,4425,3165,1337993034,1338003244,0,13,10210
37,4425,311,1338003244,1338004813,0,13,1569
37,4425,3166,1338004813,1338006388,0,13,1575
37,4425,3167,1338006388,1338006406,0,13,18
37,4425,3168,1338006406,1338009028,0,13,2622
37,4425,2914,1338009028,1338009158,0,13,130
37,4425,2355,1338009158,1338010122,0,13,964
37,4425,1235,1338010122,1338010269,0,13,147
37,4425,35,1338010269,1338010780,0,13,511
37,4425,3169,1338010780,1338010840,0,13,60
37,4426,1694,1338014658,1338017150,0,4,2492
37,4426,2512,1338017150,1338017858,0,4,708
37,4426,35,1338017858,1338019430,0,4,1572
37,4426,693,1338019430,1338019490,0,4,60
37,4427,2966,1338262825,1338262885,0,1,60
37,4428,77,1338775664,1338775680,0,5,16
37,4428,593,1338775680,1338776673,0,5,993
37,4428,253,1338776673,1338777404,0,5,731
37,4428,3131,1338777404,1338781125,0,5,3721
37,4428,3170,1338781125,1338781185,0,5,60
37,4429,3171,1338800163,1338800223,0,1,60
37,4430,747,1338982166,1338982226,0,1,60
37,4431,2864,1339207733,1339207793,0,1,60
37,4432,77,1339298310,1339298370,0,1,60
37,4433,463,1339470792,1339471296,0,2,504
37,4433,77,1339471296,1339471356,0,2,60
37,4434,77,1339580490,1339580512,0,3,22
37,4434,2966,1339580512,1339581373,0,3,861
37,4434,3172,1339581373,1339581433,0,3,60
37,4435,747,1340795663,1340795723,0,1,60
37,4436,77,1341640060,1341640120,0,1,60
37,4437,747,1341984943,1341985003,0,1,60
37,4438,35,1342171647,1342171707,0,1,60
37,4439,35,1342790661,1342790721,0,1,60
37,4440,77,1343632738,1343639502,0,2,6764
37,4440,747,1343639502,1343639562,0,2,60
37,4441,3173,1344237446,1344237680,0,4,234
37,4441,258,1344237680,1344238200,0,4,520
37,4441,253,1344238200,1344238918,0,4,718
37,4441,2438,1344238918,1344238978,0,4,60
37,4442,35,1345258875,1345258935,0,1,60
37,4443,35,1345280918,1345283478,0,2,2560
37,4443,77,1345283478,1345283538,0,2,60
37,4444,11,1345470941,1345471630,0,3,689
37,4444,21,1345471630,1345472502,0,3,872
37,4444,3152,1345472502,1345472562,0,3,60
37,4445,35,1347713496,1347713556,0,1,60
37,4446,35,1347756474,1347756534,0,1,60
37,4447,35,1350478024,1350478084,0,1,60
37,4448,2512,1351083341,1351083401,0,1,60
37,4449,3174,1351230942,1351231002,0,1,60
37,4450,35,1351309794,1351309854,0,1,60
37,4451,35,1351342600,1351342660,0,1,60
37,4452,35,1351429697,1351429757,0,1,60
37,4453,253,1351497585,1351497920,0,2,335
37,4453,258,1351497920,1351497980,0,2,60
37,4454,35,1352120290,1352120350,0,1,60
37,4455,35,1352724560,1352724620,0,1,60
37,4456,35,1353145182,1353146429,0,2,1247
37,4456,121,1353146429,1353146489,0,2,60
37,4457,3090,1353204789,1353204829,0,3,40
37,4457,139,1353204829,1353210148,0,3,5319
37,4457,3090,1353210148,1353210208,0,3,60
37,4458,35,1353245258,1353245318,0,1,60
37,4459,651,1353570653,1353583538,0,2,12885
37,4459,21,1353583538,1353583598,0,2,60
37,4460,651,1353639341,1353639401,0,1,60
37,4461,3171,1354856979,1354865343,0,2,8364
37,4461,3175,1354865343,1354865403,0,2,60
37,4462,21,1354927842,1354928648,0,10,806
37,4462,3176,1354928648,1354940964,0,10,12316
37,4462,3177,1354940964,1354941270,0,10,306
37,4462,3178,1354941270,1354941301,0,10,31
37,4462,3179,1354941301,1354942222,0,10,921
37,4462,3180,1354942222,1354943850,0,10,1628
37,4462,3181,1354943850,1354944201,0,10,351
37,4462,3182,1354944201,1354945503,0,10,1302
37,4462,3183,1354945503,1354945556,0,10,53
37,4462,3184,1354945556,1354945616,0,10,60
37,4463,428,1354955456,1354955577,0,4,121
37,4463,3185,1354955577,1354955585,0,4,8
37,4463,3186,1354955585,1354955607,0,4,22
37,4463,3187,1354955607,1354955667,0,4,60
37,4464,3174,1355125216,1355125276,0,1,60
37,4465,3188,1355575697,1355575757,0,1,60
37,4466,3174,1355815191,1355815251,0,1,60
37,4467,601,1356139125,1356139185,0,1,60
37,4468,1694,1356761336,1356761396,0,1,60
37,4469,1070,1357617031,1357617736,0,2,705
37,4469,3189,1357617736,1357617796,0,2,60
37,4470,3169,1357803567,1357812820,0,2,9253
37,4470,121,1357812820,1357812880,0,2,60
38,4471,3190,1357970042,1357970102,0,1,60
38,4472,1609,1333616685,1333617405,0,2,720
38,4472,3191,1333617405,1333617465,0,2,60
38,4473,5,1333719918,1333719958,0,6,40
38,4473,3192,1333719958,1333719958,0,6,0
38,4473,3192,1333719958,1333720466,0,6,508
38,4473,480,1333720466,1333723229,0,6,2763
38,4473,3193,1333723229,1333723623,0,6,394
38,4473,3194,1333723623,1333723683,0,6,60
38,4474,3195,1334791482,1334791542,0,1,60
38,4475,2549,1335175326,1335175386,0,1,60
38,4476,1391,1335254989,1335257356,0,3,2367
38,4476,3196,1335257356,1335257796,0,3,440
38,4476,298,1335257796,1335257856,0,3,60
38,4477,1071,1335443003,1335443063,0,1,60
38,4478,5,1335535610,1335537381,0,2,1771
38,4478,3197,1335537381,1335537441,0,2,60
38,4479,5,1335692469,1335692529,0,1,60
38,4480,2763,1336195019,1336195213,0,7,194
38,4480,3198,1336195213,1336204127,0,7,8914
38,4480,3199,1336204127,1336205003,0,7,876
38,4480,24,1336205003,1336206965,0,7,1962
38,4480,3200,1336206965,1336207003,0,7,38
38,4480,3201,1336207003,1336211115,0,7,4112
38,4480,3202,1336211115,1336211175,0,7,60
38,4481,3203,1336385060,1336385120,0,1,60
38,4482,3204,1336528341,1336528401,0,1,60
38,4483,35,1336606658,1336606718,0,1,60
38,4484,2730,1336733204,1336733264,0,1,60
38,4485,3205,1336902815,1336911394,0,4,8579
38,4485,3206,1336911394,1336911515,0,4,121
38,4485,3207,1336911515,1336911546,0,4,31
38,4485,3208,1336911546,1336911606,0,4,60
38,4486,1465,1336997313,1336997373,0,1,60
38,4487,5,1337955693,1337956863,0,2,1170
38,4487,35,1337956863,1337956923,0,2,60
38,4488,578,1338103439,1338103524,0,2,85
38,4488,3209,1338103524,1338103584,0,2,60
38,4489,3210,1338241930,1338248112,0,4,6182
38,4489,1143,1338248112,1338249007,0,4,895
38,4489,1391,1338249007,1338252002,0,4,2995
38,4489,3211,1338252002,1338252062,0,4,60
38,4490,5,1338810602,1338810662,0,1,60
38,4491,5,1338895805,1338895865,0,1,60
38,4492,5,1339062229,1339062289,0,1,60
38,4493,3212,1341647146,1341647555,0,2,409
38,4493,3213,1341647555,1341647615,0,2,60
38,4494,2762,1341719851,1341722846,0,5,2995
38,4494,2761,1341722846,1341730701,0,5,7855
38,4494,3214,1341730701,1341731344,0,5,643
38,4494,3209,1341731344,1341740617,0,5,9273
38,4494,3215,1341740617,1341740677,0,5,60
38,4495,465,1341806177,1341806237,0,1,60
38,4496,449,1341868755,1341869282,0,4,527
38,4496,3216,1341869282,1341869904,0,4,622
38,4496,3217,1341869904,1341870765,0,4,861
38,4496,298,1341870765,1341870825,0,4,60
38,4497,3218,1342082593,1342094365,0,3,11772
38,4497,5,1342094365,1342095393,0,3,1028
38,4497,35,1342095393,1342095453,0,3,60
38,4498,3219,1342175988,1342176048,0,1,60
38,4499,3209,1342424388,1342424448,0,1,60
38,4500,791,1342566766,1342566826,0,1,60
38,4501,1155,1343130704,1343130764,0,1,60
38,4502,3209,1343547813,1343547873,0,1,60
38,4503,5,1343605639,1343605699,0,1,60
38,4504,5,1343643603,1343644518,0,2,915
38,4504,35,1343644518,1343644578,0,2,60
38,4505,5,1344235421,1344236683,0,4,1262
38,4505,297,1344236683,1344239712,0,4,3029
38,4505,3220,1344239712,1344239911,0,4,199
38,4505,3221,1344239911,1344239971,0,4,60
38,4506,12,1344745055,1344750424,0,2,5369
38,4506,3222,1344750424,1344750484,0,2,60
38,4507,5,1344817275,1344817335,0,1,60
38,4508,3223,1344935624,1344935684,0,1,60
38,4509,587,1345376175,1345376796,0,3,621
38,4509,121,1345376796,1345378323,0,3,1527
38,4509,104,1345378323,1345378383,0,3,60
38,4510,3224,1347229161,1347229221,0,1,60
38,4511,260,1347714326,1347715028,0,2,702
38,4511,3225,1347715028,1347715088,0,2,60
38,4512,21,1349689867,1349689927,0,1,60
38,4513,260,1350021930,1350022502,0,4,572
38,4513,21,1350022502,1350023003,0,4,501
38,4513,3225,1350023003,1350024830,0,4,1827
38,4513,5,1350024830,1350024890,0,4,60
38,4514,10,1350078205,1350078265,0,1,60
38,4515,35,1350390659,1350390719,0,1,60
38,4516,555,1350901735,1350901795,0,1,60
38,4517,5,1351079856,1351079916,0,1,60
38,4518,3225,1351234785,1351234845,0,1,60
38,4519,260,1351502093,1351502992,0,3,899
38,4519,21,1351502992,1351508928,0,3,5936
38,4519,5,1351508928,1351508988,0,3,60
38,4520,5,1351759718,1351759778,0,1,60
38,4521,3226,1351857489,1351857549,0,1,60
38,4522,3227,1352119775,1352119812,0,3,37
38,4522,1089,1352119812,1352120113,0,3,301
38,4522,3228,1352120113,1352120173,0,3,60
38,4523,3229,1352191979,1352192039,0,1,60
38,4524,5,1352281274,1352288967,0,2,7693
38,4524,35,1352288967,1352289027,0,2,60
38,4525,1071,1352380088,1352380148,0,1,60
38,4526,212,1352462808,1352462868,0,1,60
38,4527,35,1352603323,1352603383,0,1,60
38,4528,35,1352816346,1352816406,0,1,60
38,4529,562,1353022957,1353033831,0,2,10874
38,4529,3230,1353033831,1353033891,0,2,60
38,4530,2457,1353209855,1353222705,0,2,12850
38,4530,3231,1353222705,1353222765,0,2,60
38,4531,3223,1353368970,1353369030,0,1,60
38,4532,35,1353418869,1353418929,0,1,60
38,4533,5,1353588412,1353588472,0,1,60
38,4534,3232,1353932933,1353933523,0,2,590
38,4534,2762,1353933523,1353933583,0,2,60
38,4535,5,1354011354,1354015835,0,3,4481
38,4535,3233,1354015835,1354017554,0,3,1719
38,4535,8,1354017554,1354017614,0,3,60
38,4536,1703,1354061898,1354062928,0,2,1030
38,4536,3234,1354062928,1354062988,0,2,60
38,4537,3209,1354431785,1354443073,0,2,11288
38,4537,3235,1354443073,1354443133,0,2,60
38,4538,8,1354527311,1354527371,0,1,60
38,4539,3236,1354575921,1354580085,0,3,4164
38,4539,3220,1354580085,1354580499,0,3,414
38,4539,3237,1354580499,1354580559,0,3,60
38,4540,2194,1354624266,1354624326,0,1,60
38,4541,3222,1355547650,1355558658,0,2,11008
38,4541,597,1355558658,1355558718,0,2,60
38,4542,866,1355570229,1355570289,0,1,60
38,4543,3238,1355722280,1355722340,0,1,60
38,4544,3239,1355787658,1355787718,0,1,60
38,4545,3240,1355826495,1355826555,0,1,60
38,4546,3239,1356046855,1356046915,0,1,60
38,4547,3241,1356250999,1356272158,0,2,21159
38,4547,3242,1356272158,1356272218,0,2,60
38,4548,21,1356605021,1356607551,0,2,2530
38,4548,3215,1356607551,1356607611,0,2,60
38,4549,3243,1356941811,1356941871,0,1,60
38,4550,5,1357256725,1357256785,0,1,60
38,4551,3244,1357281848,1357281908,0,1,60
38,4552,637,1357641626,1357645413,0,2,3787
38,4552,3245,1357645413,1357645473,0,2,60
38,4553,2544,1357724194,1357724254,0,1,60
38,4554,3246,1358040508,1358040568,0,1,60
38,4555,3239,1358465484,1358465544,0,1,60
38,4556,3247,1358511534,1358511594,0,1,60
38,4557,121,1358763383,1358763443,0,1,60
38,4558,3248,1358852965,1358854247,0,2,1282
38,4558,583,1358854247,1358854307,0,2,60
38,4559,3249,1359167016,1359168043,0,2,1027
38,4559,541,1359168043,1359168103,0,2,60
38,4560,1291,1359329596,1359329656,0,1,60
38,4561,5,1359535271,1359535331,0,1,60
38,4562,3250,1359588780,1359588840,0,1,60
38,4563,3251,1359625268,1359625328,0,1,60
38,4564,3252,1359700722,1359721920,0,3,21198
38,4564,3253,1359721920,1359721978,0,3,58
38,4564,1621,1359721978,1359722038,0,3,60
38,4565,5,1360058053,1360058113,0,1,60
38,4566,35,1360108831,1360108891,0,1,60
38,4567,3254,1360289025,1360289085,0,1,60
38,4568,3255,1360566119,1360566178,0,2,59
38,4568,3255,1360566178,1360566238,0,2,60
38,4569,5,1360749500,1360749560,0,1,60
39,4570,5,1360838882,1360838942,0,1,60
39,4571,3256,1333841328,1333842974,0,3,1646
39,4571,3257,1333842974,1333844309,0,3,1335
39,4571,3258,1333844309,1333844369,0,3,60
39,4572,3259,1333866239,1333873170,0,2,6931
39,4572,3260,1333873170,1333873230,0,2,60
39,4573,3261,1334375451,1334377827,0,3,2376
39,4573,3257,1334377827,1334378862,0,3,1035
39,4573,3262,1334378862,1334378922,0,3,60
39,4574,3263,1334658835,1334659163,0,3,328
39,4574,3264,1334659163,1334659217,0,3,54
39,4574,3265,1334659217,1334659277,0,3,60
39,4575,3256,1334984037,1334986357,0,3,2320
39,4575,3257,1334986357,1334987524,0,3,1167
39,4575,3262,1334987524,1334987584,0,3,60
39,4576,3256,1335050540,1335050776,0,5,236
39,4576,3261,1335050776,1335052053,0,5,1277
39,4576,3257,1335052053,1335053012,0,5,959
39,4576,3262,1335053012,1335064272,0,5,11260
39,4576,3266,1335064272,1335064332,0,5,60
39,4577,3260,1335572341,1335573514,0,2,1173
39,4577,3257,1335573514,1335573574,0,2,60
39,4578,3256,1335655702,1335656269,0,4,567
39,4578,3267,1335656269,1335657668,0,4,1399
39,4578,3257,1335657668,1335660100,0,4,2432
39,4578,3262,1335660100,1335660160,0,4,60
39,4579,3260,1335679084,1335679144,0,1,60
39,4580,3256,1336796651,1336797926,0,5,1275
39,4580,3268,1336797926,1336799049,0,5,1123
39,4580,3257,1336799049,1336799655,0,5,606
39,4580,3262,1336799655,1336816151,0,5,16496
39,4580,3257,1336816151,1336816211,0,5,60
39,4581,3269,1336867115,1336868127,0,2,1012
39,4581,3262,1336868127,1336868187,0,2,60
39,4582,3267,1336894933,1336894993,0,1,60
39,4583,983,1337054084,1337054140,0,4,56
39,4583,3262,1337054140,1337061849,0,4,7709
39,4583,3270,1337061849,1337075365,0,4,13516
39,4583,2784,1337075365,1337075425,0,4,60
39,4584,2817,1337076029,1337076664,0,3,635
39,4584,3264,1337076664,1337077012,0,3,348
39,4584,3265,1337077012,1337077072,0,3,60
39,4585,3262,1337408845,1337420391,0,2,11546
39,4585,3271,1337420391,1337420451,0,2,60
39,4586,3256,1338075178,1338076826,0,4,1648
39,4586,3257,1338076826,1338077875,0,4,1049
39,4586,3262,1338077875,1338093090,0,4,15215
39,4586,3272,1338093090,1338093150,0,4,60
39,4587,3273,1338097566,1338097626,0,1,60
39,4588,3257,1338681651,1338694870,0,2,13219
39,4588,3274,1338694870,1338694930,0,2,60
39,4589,3267,1338707052,1338707682,0,2,630
39,4589,3256,1338707682,1338707742,0,2,60
39,4590,3275,1339310092,1339312356,0,2,2264
39,4590,3276,1339312356,1339312416,0,2,60
39,4591,2784,1339495890,1339497068,0,3,1178
39,4591,3264,1339497068,1339497494,0,3,426
39,4591,3265,1339497494,1339497554,0,3,60
39,4592,3256,1341635671,1341637003,0,4,1332
39,4592,3260,1341637003,1341637996,0,4,993
39,4592,3257,1341637996,1341638787,0,4,791
39,4592,3262,1341638787,1341638847,0,4,60
39,4593,3257,1341705378,1341705438,0,1,60
39,4594,3260,1341734498,1341734558,0,1,60
39,4595,3269,1342243899,1342245073,0,2,1174
39,4595,3262,1342245073,1342245133,0,2,60
39,4596,3270,1342514097,1342519355,0,3,5258
39,4596,3262,1342519355,1342529752,0,3,10397
39,4596,3265,1342529752,1342529812,0,3,60
39,4597,3271,1343343116,1343344014,0,2,898
39,4597,983,1343344014,1343344074,0,2,60
39,4598,3277,1343458963,1343459023,0,1,60
39,4599,3262,1343521885,1343521924,0,4,39
39,4599,3262,1343521924,1343532774,0,4,10850
39,4599,3278,1343532774,1343537686,0,4,4912
39,4599,733,1343537686,1343537746,0,4,60
39,4600,3279,1343546430,1343546490,0,1,60
39,4601,3261,1345333104,1345334550,0,3,1446
39,4601,3269,1345334550,1345335049,0,3,499
39,4601,3262,1345335049,1345335109,0,3,60
39,4602,983,1347681879,1347681946,0,2,67
39,4602,3262,1347681946,1347682006,0,2,60
39,4603,3270,1347704215,1347705223,0,3,1008
39,4603,171,1347705223,1347715708,0,3,10485
39,4603,400,1347715708,1347715768,0,3,60
39,4604,3261,1347753401,1347754752,0,4,1351
39,4604,3257,1347754752,1347755844,0,4,1092
39,4604,3262,1347755844,1347756388,0,4,544
39,4604,3280,1347756388,1347756448,0,4,60
39,4605,983,1350104573,1350104633,0,1,60
39,4606,3281,1350467493,1350467553,0,1,60
39,4607,3257,1351295271,1351296010,0,2,739
39,4607,3262,1351296010,1351296070,0,2,60
39,4608,3262,1351387153,1351398835,0,2,11682
39,4608,3268,1351398835,1351398895,0,2,60
39,4609,3257,1352593284,1352593344,0,1,60
39,4610,733,1352615311,1352615371,0,1,60
39,4611,3282,1352778833,1352778906,0,2,73
39,4611,2654,1352778906,1352778966,0,2,60
39,4612,3282,1353025008,1353025068,0,1,60
39,4613,3262,1353132376,1353146573,0,3,14197
39,4613,3260,1353146573,1353147784,0,3,1211
39,4613,3283,1353147784,1353147844,0,3,60
39,4614,3257,1353196157,1353198161,0,2,2004
39,4614,3262,1353198161,1353198221,0,2,60
39,4615,3284,1353217862,1353221863,0,2,4001
39,4615,3256,1353221863,1353221923,0,2,60
39,4616,3282,1353370440,1353370500,0,1,60
39,4617,3264,1353405666,1353405677,0,3,11
39,4617,3285,1353405677,1353405775,0,3,98
39,4617,3265,1353405775,1353405835,0,3,60
39,4618,3286,1353636241,1353636301,0,1,60
39,4619,3270,1353734073,1353734234,0,2,161
39,4619,3287,1353734234,1353734294,0,2,60
39,4620,3288,1353814759,1353814819,0,1,60
39,4621,3262,1354339839,1354339899,0,1,60
39,4622,3256,1354407666,1354407726,0,1,60
39,4623,3289,1354435734,1354436470,0,2,736
39,4623,3287,1354436470,1354436530,0,2,60
39,4624,3270,1354524363,1354524872,0,2,509
39,4624,3262,1354524872,1354524932,0,2,60
39,4625,458,1354637432,1354637492,0,1,60
39,4626,3290,1355023707,1355023767,0,1,60
39,4627,3257,1355535995,1355536055,0,1,60
39,4628,3268,1355617764,1355619876,0,3,2112
39,4628,3262,1355619876,1355628416,0,3,8540
39,4628,3290,1355628416,1355628476,0,3,60
39,4629,3257,1356222230,1356243344,0,2,21114
39,4629,3261,1356243344,1356243404,0,2,60
39,4630,368,1356831190,1356831260,0,4,70
39,4630,3262,1356831260,1356837093,0,4,5833
39,4630,3290,1356837093,1356840463,0,4,3370
39,4630,3291,1356840463,1356840523,0,4,60
39,4631,3292,1357452357,1357452795,0,2,438
39,4631,1434,1357452795,1357452855,0,2,60
39,4632,3293,1357702775,1357720766,0,3,17991
39,4632,3294,1357720766,1357721725,0,3,959
39,4632,3295,1357721725,1357721785,0,3,60
39,4633,3296,1357772579,1357772639,0,1,60
39,4634,922,1357807029,1357808441,0,3,1412
39,4634,3296,1357808441,1357808636,0,3,195
39,4634,3295,1357808636,1357808696,0,3,60
39,4635,922,1357860130,1357860190,0,1,60
39,4636,3295,1357896195,1357896255,0,1,60
39,4637,3268,1357966587,1357967954,0,3,1367
39,4637,3257,1357967954,1357986779,0,3,18825
39,4637,3267,1357986779,1357986839,0,3,60
39,4638,922,1358205527,1358211168,0,2,5641
39,4638,1078,1358211168,1358211228,0,2,60
39,4639,3297,1358295244,1358295304,0,1,60
39,4640,746,1358382549,1358382609,0,1,60
39,4641,920,1358427316,1358427721,0,2,405
39,4641,3294,1358427721,1358427781,0,2,60
39,4642,3298,1358463236,1358468722,0,2,5486
39,4642,287,1358468722,1358468782,0,2,60
39,4643,922,1358498013,1358500853,0,2,2840
39,4643,3299,1358500853,1358500913,0,2,60
39,4644,640,1358758859,1358758872,0,3,13
39,4644,3297,1358758872,1358765909,0,3,7037
39,4644,3295,1358765909,1358765969,0,3,60
39,4645,922,1358813347,1358815259,0,4,1912
39,4645,3297,1358815259,1358829754,0,4,14495
39,4645,3300,1358829754,1358830084,0,4,330
39,4645,564,1358830084,1358830144,0,4,60
39,4646,3294,1359027787,1359027847,0,1,60
39,4647,3297,1359103913,1359105288,0,3,1375
39,4647,1176,1359105288,1359111727,0,3,6439
39,4647,3294,1359111727,1359111787,0,3,60
39,4648,922,1359364052,1359364112,0,1,60
39,4649,3295,1359550350,1359550410,0,1,60
39,4650,922,1359587746,1359592291,0,2,4545
39,4650,1176,1359592291,1359592351,0,2,60
39,4651,3301,1359617707,1359617767,0,1,60
39,4652,3294,1359673834,1359674395,0,3,561
39,4652,922,1359674395,1359677919,0,3,3524
39,4652,1176,1359677919,1359677979,0,3,60
39,4653,380,1359699440,1359699500,0,1,60
39,4654,3268,1359778733,1359796068,0,2,17335
39,4654,3262,1359796068,1359796128,0,2,60
39,4655,3257,1359849190,1359849250,0,1,60
39,4656,3302,1359878297,1359878357,0,1,60
39,4657,3303,1360024369,1360024429,0,1,60
39,4658,922,1360106718,1360111306,0,2,4588
39,4658,23,1360111306,1360111366,0,2,60
39,4659,922,1360193654,1360196095,0,2,2441
39,4659,1176,1360196095,1360196155,0,2,60
39,4660,922,1360278904,1360292045,0,2,13141
39,4660,1176,1360292045,1360292105,0,2,60
39,4661,380,1360311415,1360316922,0,2,5507
39,4661,3304,1360316922,1360316982,0,2,60
39,4662,1176,1360637320,1360637380,0,1,60
39,4663,2962,1360662227,1360662730,0,4,503
39,4663,3305,1360662730,1360664313,0,4,1583
39,4663,3265,1360664313,1360674092,0,4,9779
39,4663,3126,1360674092,1360674152,0,4,60
39,4664,922,1360714147,1360715276,0,3,1129
39,4664,3303,1360715276,1360731166,0,3,15890
39,4664,3306,1360731166,1360731226,0,3,60
39,4665,3297,1360740275,1360745876,0,2,5601
39,4665,3295,1360745876,1360745936,0,2,60
40,4666,922,1360797583,1360813124,0,2,15541
40,4666,3307,1360813124,1360813184,0,2,60
40,4667,5,1333515446,1333516233,0,5,787
40,4667,972,1333516233,1333518456,0,5,2223
40,4667,770,1333518456,1333521960,0,5,3504
40,4667,3308,1333521960,1333531953,0,5,9993
40,4667,553,1333531953,1333532013,0,5,60
40,4668,14,1333845699,1333845943,0,2,244
40,4668,15,1333845943,1333846003,0,2,60
40,4669,3309,1333882846,1333882906,0,1,60
40,4670,35,1334823655,1334823663,0,9,8
40,4670,3310,1334823663,1334824857,0,9,1194
40,4670,359,1334824857,1334825200,0,9,343
40,4670,3311,1334825200,1334825515,0,9,315
40,4670,3312,1334825515,1334826884,0,9,1369
40,4670,3313,1334826884,1334829050,0,9,2166
40,4670,3314,1334829050,1334836687,0,9,7637
40,4670,385,1334836687,1334840401,0,9,3714
40,4670,3313,1334840401,1334840461,0,9,60
40,4671,3315,1334929479,1334938082,0,2,8603
40,4671,3316,1334938082,1334938142,0,2,60
40,4672,3310,1335428221,1335428246,0,7,25
40,4672,35,1335428246,1335429440,0,7,1194
40,4672,359,1335429440,1335430156,0,7,716
40,4672,3312,1335430156,1335430932,0,7,776
40,4672,3313,1335430932,1335433774,0,7,2842
40,4672,3314,1335433774,1335441835,0,7,8061
40,4672,3317,1335441835,1335441895,0,7,60
40,4673,3318,1335520863,1335520923,0,1,60
40,4674,3319,1335602930,1335618228,0,2,15298
40,4674,3320,1335618228,1335618288,0,2,60
40,4675,14,1335679161,1335679651,0,3,490
40,4675,15,1335679651,1335688119,0,3,8468
40,4675,3321,1335688119,1335688179,0,3,60
40,4676,3314,1336037343,1336047370,0,3,10027
40,4676,3322,1336047370,1336047410,0,3,40
40,4676,3323,1336047410,1336047470,0,3,60
40,4677,3324,1336070499,1336071734,0,2,1235
40,4677,3325,1336071734,1336071794,0,2,60
40,4678,3310,1336637524,1336637531,0,2,7
40,4678,35,1336637531,1336637591,0,2,60
40,4679,359,1337241307,1337242658,0,4,1351
40,4679,3312,1337242658,1337247610,0,4,4952
40,4679,3314,1337247610,1337256820,0,4,9210
40,4679,3323,1337256820,1337256880,0,4,60
40,4680,3313,1337265608,1337265668,0,1,60
40,4681,3326,1337346388,1337354823,0,2,8435
40,4681,3327,1337354823,1337354883,0,2,60
40,4682,3328,1337594634,1337596570,0,3,1936
40,4682,3329,1337596570,1337597879,0,3,1309
40,4682,3330,1337597879,1337597939,0,3,60
40,4683,5,1337682965,1337684813,0,2,1848
40,4683,709,1337684813,1337684873,0,2,60
40,4684,359,1337845701,1337848560,0,3,2859
40,4684,3331,1337848560,1337851764,0,3,3204
40,4684,3314,1337851764,1337851824,0,3,60
40,4685,746,1338739060,1338739120,0,1,60
40,4686,35,1338971700,1338972024,0,5,324
40,4686,3332,1338972024,1338972375,0,5,351
40,4686,284,1338972375,1338975448,0,5,3073
40,4686,2533,1338975448,1338988029,0,5,12581
40,4686,3333,1338988029,1338988089,0,5,60
40,4687,3310,1339056814,1339056817,0,6,3
40,4687,35,1339056817,1339057812,0,6,995
40,4687,359,1339057812,1339058565,0,6,753
40,4687,3312,1339058565,1339061346,0,6,2781
40,4687,3314,1339061346,1339070721,0,6,9375
40,4687,3317,1339070721,1339070781,0,6,60
40,4688,3310,1339662138,1339662148,0,4,10
40,4688,35,1339662148,1339663412,0,4,1264
40,4688,359,1339663412,1339664095,0,4,683
40,4688,3334,1339664095,1339664155,0,4,60
40,4689,5,1340267538,1340268057,0,5,519
40,4689,479,1340268057,1340269204,0,5,1147
40,4689,770,1340269204,1340271384,0,5,2180
40,4689,553,1340271384,1340283384,0,5,12000
40,4689,359,1340283384,1340283444,0,5,60
40,4690,12,1341113430,1341114463,0,2,1033
40,4690,3335,1341114463,1341114523,0,2,60
40,4691,35,1341476983,1341477623,0,5,640
40,4691,3332,1341477623,1341480196,0,5,2573
40,4691,2577,1341480196,1341480354,0,5,158
40,4691,3336,1341480354,1341481017,0,5,663
40,4691,3337,1341481017,1341481077,0,5,60
40,4692,449,1341565822,1341565882,0,7,60
40,4692,451,1341565882,1341572993,0,7,7111
40,4692,3338,1341572993,1341573912,0,7,919
40,4692,35,1341573912,1341573954,0,7,42
40,4692,3332,1341573954,1341575033,0,7,1079
40,4692,3339,1341575033,1341578116,0,7,3083
40,4692,3340,1341578116,1341578176,0,7,60
40,4693,14,1341708760,1341708768,0,3,8
40,4693,15,1341708768,1341717343,0,3,8575
40,4693,3341,1341717343,1341717403,0,3,60
40,4694,3342,1341735684,1341747455,0,2,11771
40,4694,3343,1341747455,1341747515,0,2,60
40,4695,3344,1341850654,1341850714,0,1,60
40,4696,253,1342339036,1342342023,0,4,2987
40,4696,3078,1342342023,1342345554,0,4,3531
40,4696,3199,1342345554,1342351433,0,4,5879
40,4696,2281,1342351433,1342351493,0,4,60
40,4697,3345,1342362904,1342362964,0,1,60
40,4698,73,1342435349,1342435932,0,2,583
40,4698,3346,1342435932,1342435992,0,2,60
40,4699,3347,1344549816,1344549876,0,1,60
40,4700,3347,1344757912,1344779236,0,2,21324
40,4700,3348,1344779236,1344779296,0,2,60
40,4701,170,1344954014,1344954074,0,1,60
40,4702,3349,1345135125,1345135185,0,1,60
40,4703,253,1345277605,1345279381,0,4,1776
40,4703,3350,1345279381,1345282568,0,4,3187
40,4703,3319,1345282568,1345296797,0,4,14229
40,4703,3350,1345296797,1345296857,0,4,60
40,4704,3349,1345649900,1345649960,0,1,60
40,4705,3319,1347533134,1347553492,0,2,20358
40,4705,3351,1347553492,1347553552,0,2,60
40,4706,253,1347689360,1347690624,0,4,1264
40,4706,170,1347690624,1347692682,0,4,2058
40,4706,3352,1347692682,1347700410,0,4,7728
40,4706,3350,1347700410,1347700470,0,4,60
40,4707,877,1347721053,1347721113,0,1,60
40,4708,35,1351241437,1351255949,0,3,14512
40,4708,603,1351255949,1351258033,0,3,2084
40,4708,3353,1351258033,1351258093,0,3,60
40,4709,253,1351760002,1351761136,0,4,1134
40,4709,3354,1351761136,1351762981,0,4,1845
40,4709,3319,1351762981,1351773535,0,4,10554
40,4709,3355,1351773535,1351773595,0,4,60
40,4710,3319,1352368405,1352377027,0,2,8622
40,4710,3350,1352377027,1352377087,0,2,60
40,4711,3349,1353430403,1353430463,0,1,60
40,4712,3356,1353561937,1353564193,0,5,2256
40,4712,3357,1353564193,1353565711,0,5,1518
40,4712,253,1353565711,1353569716,0,5,4005
40,4712,3358,1353569716,1353576842,0,5,7126
40,4712,3319,1353576842,1353576902,0,5,60
40,4713,3350,1353588651,1353588711,0,1,60
40,4714,3359,1354366764,1354366824,0,1,60
40,4715,35,1354702547,1354702607,0,1,60
40,4716,3319,1354875031,1354887282,0,2,12251
40,4716,3360,1354887282,1354887342,0,2,60
40,4717,253,1356082097,1356082460,0,2,363
40,4717,3319,1356082460,1356082520,0,2,60
40,4718,284,1356602238,1356603489,0,2,1251
40,4718,3333,1356603489,1356603549,0,2,60
40,4719,3361,1357819414,1357819474,0,1,60
40,4720,71,1357905845,1357905905,0,1,60
40,4721,479,1358241543,1358241603,0,1,60
40,4722,3319,1358421618,1358425672,0,2,4054
40,4722,3350,1358425672,1358425732,0,2,60
40,4723,5,1359186874,1359186934,0,1,60
40,4724,3349,1359388831,1359395339,0,2,6508
40,4724,3362,1359395339,1359395399,0,2,60
40,4725,3350,1359629082,1359636043,0,3,6961
40,4725,3320,1359636043,1359649636,0,3,13593
40,4725,3363,1359649636,1359649696,0,3,60
40,4726,253,1360229618,1360229913,0,3,295
40,4726,3319,1360229913,1360239512,0,3,9599
40,4726,3350,1360239512,1360239572,0,3,60
40,4727,746,1360254053,1360254113,0,1,60
40,4728,5,1360745386,1360746089,0,4,703
40,4728,1320,1360746089,1360748037,0,4,1948
40,4728,553,1360748037,1360761410,0,4,13373
40,4728,3364,1360761410,1360761470,0,4,60
41,4729,3319,1360834430,1360834443,0,2,13
41,4729,253,1360834443,1360834503,0,2,60
41,4730,3365,1333492417,1333492634,0,6,217
41,4730,3366,1333492634,1333492785,0,6,151
41,4730,3159,1333492785,1333493197,0,6,412
41,4730,3367,1333493197,1333493436,0,6,239
41,4730,3368,1333493436,1333493620,0,6,184
41,4730,3369,1333493620,1333493680,0,6,60
41,4731,3369,1333527111,1333527140,0,2,29
41,4731,3368,1333527140,1333527200,0,2,60
41,4732,3368,1333579571,1333579631,0,1,60
41,4733,3369,1333614893,1333614911,0,6,18
41,4733,3368,1333614911,1333615906,0,6,995
41,4733,3159,1333615906,1333616153,0,6,247
41,4733,593,1333616153,1333616168,0,6,15
41,4733,3370,1333616168,1333616183,0,6,15
41,4733,77,1333616183,1333616243,0,6,60
41,4734,3371,1333723436,1333723496,0,1,60
41,4735,3372,1333871825,1333871870,0,4,45
41,4735,3373,1333871870,1333877484,0,4,5614
41,4735,3374,1333877484,1333877502,0,4,18
41,4735,3375,1333877502,1333877562,0,4,60
41,4736,3365,1333924166,1333924187,0,8,21
41,4736,593,1333924187,1333924203,0,8,16
41,4736,3370,1333924203,1333924225,0,8,22
41,4736,77,1333924225,1333924608,0,8,383
41,4736,3159,1333924608,1333925010,0,8,402
41,4736,3367,1333925010,1333925147,0,8,137
41,4736,3368,1333925147,1333925509,0,8,362
41,4736,3369,1333925509,1333925569,0,8,60
41,4737,3365,1334010030,1334010046,0,5,16
41,4737,593,1334010046,1334010060,0,5,14
41,4737,3370,1334010060,1334010883,0,5,823
41,4737,3367,1334010883,1334010903,0,5,20
41,4737,3368,1334010903,1334010963,0,5,60
41,4738,3368,1334045626,1334045686,0,1,60
41,4739,3365,1334097218,1334097257,0,6,39
41,4739,3370,1334097257,1334097273,0,6,16
41,4739,77,1334097273,1334098184,0,6,911
41,4739,3367,1334098184,1334098244,0,6,60
41,4739,3368,1334098244,1334098573,0,6,329
41,4739,3369,1334098573,1334098633,0,6,60
41,4740,3369,1334132374,1334132400,0,6,26
41,4740,3368,1334132400,1334134491,0,6,2091
41,4740,3376,1334134491,1334134630,0,6,139
41,4740,3377,1334134630,1334134656,0,6,26
41,4740,77,1334134656,1334138364,0,6,3708
41,4740,3374,1334138364,1334138424,0,6,60
41,4741,3365,1334183493,1334183514,0,7,21
41,4741,593,1334183514,1334183526,0,7,12
41,4741,3370,1334183526,1334183538,0,7,12
41,4741,77,1334183538,1334183797,0,7,259
41,4741,3159,1334183797,1334184651,0,7,854
41,4741,3368,1334184651,1334184689,0,7,38
41,4741,3369,1334184689,1334184749,0,7,60
41,4742,3378,1334218489,1334218537,0,3,48
41,4742,3379,1334218537,1334219064,0,3,527
41,4742,3380,1334219064,1334219124,0,3,60
41,4743,3365,1334270074,1334270088,0,7,14
41,4743,593,1334270088,1334270101,0,7,13
41,4743,3370,1334270101,1334270113,0,7,12
41,4743,77,1334270113,1334270301,0,7,188
41,4743,3366,1334270301,1334270392,0,7,91
41,4743,3159,1334270392,1334270940,0,7,548
41,4743,3368,1334270940,1334271000,0,7,60
41,4744,3381,1334364844,1334364875,0,4,31
41,4744,3382,1334364875,1334370792,0,4,5917
41,4744,3383,1334370792,1334370806,0,4,14
41,4744,3384,1334370806,1334370866,0,4,60
41,4745,3374,1334407925,1334407985,0,1,60
41,4746,3370,1334447958,1334447977,0,6,19
41,4746,593,1334447977,1334448006,0,6,29
41,4746,77,1334448006,1334450131,0,6,2125
41,4746,3057,1334450131,1334460628,0,6,10497
41,4746,3385,1334460628,1334460658,0,6,30
41,4746,3057,1334460658,1334460718,0,6,60
41,4747,3370,1334527538,1334528496,0,2,958
41,4747,3368,1334528496,1334528556,0,2,60
41,4748,3386,1334571345,1334571405,0,1,60
41,4749,3387,1334653792,1334653896,0,2,104
41,4749,3388,1334653896,1334653956,0,2,60
41,4750,593,1334701311,1334701325,0,6,14
41,4750,3365,1334701325,1334701337,0,6,12
41,4750,3370,1334701337,1334701694,0,6,357
41,4750,3159,1334701694,1334702149,0,6,455
41,4750,3368,1334702149,1334702162,0,6,13
41,4750,3369,1334702162,1334702222,0,6,60
41,4751,593,1334788198,1334788212,0,6,14
41,4751,3370,1334788212,1334788223,0,6,11
41,4751,3365,1334788223,1334788237,0,6,14
41,4751,77,1334788237,1334788691,0,6,454
41,4751,3159,1334788691,1334789193,0,6,502
41,4751,3369,1334789193,1334789253,0,6,60
41,4752,593,1334874376,1334874390,0,4,14
41,4752,3370,1334874390,1334874949,0,4,559
41,4752,3159,1334874949,1334875508,0,4,559
41,4752,3368,1334875508,1334875568,0,4,60
41,4753,3389,1334910996,1334922900,0,2,11904
41,4753,1266,1334922900,1334922960,0,2,60
41,4754,298,1335088087,1335088147,0,1,60
41,4755,2966,1335133814,1335133839,0,7,25
41,4755,3390,1335133839,1335133889,0,7,50
41,4755,77,1335133889,1335134317,0,7,428
41,4755,3391,1335134317,1335134343,0,7,26
41,4755,78,1335134343,1335134360,0,7,17
41,4755,3392,1335134360,1335134432,0,7,72
41,4755,81,1335134432,1335134492,0,7,60
41,4756,3369,1335168687,1335168718,0,9,31
41,4756,3368,1335168718,1335168751,0,9,33
41,4756,3367,1335168751,1335168784,0,9,33
41,4756,3393,1335168784,1335168889,0,9,105
41,4756,3394,1335168889,1335169048,0,9,159
41,4756,3395,1335169048,1335169094,0,9,46
41,4756,3396,1335169094,1335169230,0,9,136
41,4756,77,1335169230,1335169251,0,9,21
41,4756,3397,1335169251,1335169311,0,9,60
41,4757,593,1335220521,1335220533,0,6,12
41,4757,3370,1335220533,1335220556,0,6,23
41,4757,77,1335220556,1335220662,0,6,106
41,4757,3366,1335220662,1335221209,0,6,547
41,4757,3368,1335221209,1335221222,0,6,13
41,4757,3369,1335221222,1335221282,0,6,60
41,4758,3398,1335255545,1335255559,0,9,14
41,4758,3399,1335255559,1335255657,0,9,98
41,4758,1266,1335255657,1335256052,0,9,395
41,4758,263,1335256052,1335256073,0,9,21
41,4758,86,1335256073,1335256651,0,9,578
41,4758,1263,1335256651,1335256682,0,9,31
41,4758,3400,1335256682,1335256715,0,9,33
41,4758,3216,1335256715,1335261436,0,9,4721
41,4758,3401,1335261436,1335261496,0,9,60
41,4759,3370,1335305891,1335305897,0,3,6
41,4759,3365,1335305897,1335305931,0,3,34
41,4759,3366,1335305931,1335305991,0,3,60
41,4760,3365,1335393103,1335393120,0,7,17
41,4760,3370,1335393120,1335393135,0,7,15
41,4760,593,1335393135,1335393148,0,7,13
41,4760,77,1335393148,1335393464,0,7,316
41,4760,3159,1335393464,1335395014,0,7,1550
41,4760,3368,1335395014,1335395031,0,7,17
41,4760,3369,1335395031,1335395091,0,7,60
41,4761,463,1335430591,1335430627,0,6,36
41,4761,3402,1335430627,1335430879,0,6,252
41,4761,3057,1335430879,1335432086,0,6,1207
41,4761,3403,1335432086,1335433386,0,6,1300
41,4761,3404,1335433386,1335446335,0,6,12949
41,4761,3370,1335446335,1335446395,0,6,60
41,4762,3159,1335531103,1335538667,0,2,7564
41,4762,3405,1335538667,1335538727,0,2,60
41,4763,3372,1335590992,1335610150,0,3,19158
41,4763,3381,1335610150,1335610170,0,3,20
41,4763,3406,1335610170,1335610230,0,3,60
41,4764,515,1335652380,1335652405,0,3,25
41,4764,3407,1335652405,1335654612,0,3,2207
41,4764,3408,1335654612,1335654672,0,3,60
41,4765,3409,1335692396,1335692456,0,1,60
41,4766,77,1335935123,1335935137,0,4,14
41,4766,2966,1335935137,1335935156,0,4,19
41,4766,3383,1335935156,1335935169,0,4,13
41,4766,3384,1335935169,1335935229,0,4,60
41,4767,542,1336097394,1336097831,0,4,437
41,4767,429,1336097831,1336097848,0,4,17
41,4767,542,1336097848,1336097863,0,4,15
41,4767,3410,1336097863,1336097923,0,4,60
41,4768,3365,1336178816,1336178836,0,14,20
41,4768,593,1336178836,1336178858,0,14,22
41,4768,3370,1336178858,1336179125,0,14,267
41,4768,463,1336179125,1336179144,0,14,19
41,4768,3411,1336179144,1336179189,0,14,45
41,4768,3412,1336179189,1336179253,0,14,64
41,4768,3402,1336179253,1336190991,0,14,11738
41,4768,2151,1336190991,1336191030,0,14,39
41,4768,3413,1336191030,1336191046,0,14,16
41,4768,3414,1336191046,1336191075,0,14,29
41,4768,3415,1336191075,1336191817,0,14,742
41,4768,3416,1336191817,1336191886,0,14,69
41,4768,3417,1336191886,1336191920,0,14,34
41,4768,3418,1336191920,1336191980,0,14,60
41,4769,693,1336203837,1336203860,0,20,23
41,4769,2864,1336203860,1336203878,0,20,18
41,4769,693,1336203878,1336203890,0,20,12
41,4769,2150,1336203890,1336204016,0,20,126
41,4769,3419,1336204016,1336204046,0,20,30
41,4769,3420,1336204046,1336204098,0,20,52
41,4769,3421,1336204098,1336204121,0,20,23
41,4769,3422,1336204121,1336204225,0,20,104
41,4769,3423,1336204225,1336204257,0,20,32
41,4769,3424,1336204257,1336204947,0,20,690
41,4769,593,1336204947,1336204963,0,20,16
41,4769,3376,1336204963,1336205048,0,20,85
41,4769,3377,1336205048,1336205081,0,20,33
41,4769,3381,1336205081,1336205310,0,20,229
41,4769,3388,1336205310,1336216076,0,20,10766
41,4769,3375,1336216076,1336216097,0,20,21
41,4769,3425,1336216097,1336216124,0,20,27
41,4769,3426,1336216124,1336216143,0,20,19
41,4769,3427,1336216143,1336216822,0,20,679
41,4769,3374,1336216822,1336216882,0,20,60
41,4770,3381,1336256810,1336257757,0,3,947
41,4770,429,1336257757,1336258316,0,3,559
41,4770,3428,1336258316,1336258376,0,3,60
41,4771,3387,1336342956,1336343658,0,6,702
41,4771,3365,1336343658,1336343693,0,6,35
41,4771,3370,1336343693,1336343716,0,6,23
41,4771,77,1336343716,1336343982,0,6,266
41,4771,3159,1336343982,1336344246,0,6,264
41,4771,3394,1336344246,1336344306,0,6,60
41,4772,3429,1336379044,1336379069,0,16,25
41,4772,3387,1336379069,1336379117,0,16,48
41,4772,3172,1336379117,1336379141,0,16,24
41,4772,3430,1336379141,1336379363,0,16,222
41,4772,3431,1336379363,1336379395,0,16,32
41,4772,3432,1336379395,1336381151,0,16,1756
41,4772,3381,1336381151,1336381171,0,16,20
41,4772,3382,1336381171,1336382384,0,16,1213
41,4772,3433,1336382384,1336382425,0,16,41
41,4772,3406,1336382425,1336382479,0,16,54
41,4772,3434,1336382479,1336382809,0,16,330
41,4772,3435,1336382809,1336392955,0,16,10146
41,4772,3436,1336392955,1336392986,0,16,31
41,4772,3376,1336392986,1336393055,0,16,69
41,4772,3437,1336393055,1336393126,0,16,71
41,4772,3438,1336393126,1336393186,0,16,60
41,4773,3376,1336429578,1336429608,0,5,30
41,4773,593,1336429608,1336429636,0,5,28
41,4773,77,1336429636,1336429934,0,5,298
41,4773,77,1336429934,1336429984,0,5,50
41,4773,3394,1336429984,1336430044,0,5,60
41,4774,3376,1336516088,1336516113,0,8,25
41,4774,3365,1336516113,1336516134,0,8,21
41,4774,593,1336516134,1336516166,0,8,32
41,4774,3370,1336516166,1336516192,0,8,26
41,4774,77,1336516192,1336516698,0,8,506
41,4774,3439,1336516698,1336516938,0,8,240
41,4774,3367,1336516938,1336517157,0,8,219
41,4774,3368,1336517157,1336517217,0,8,60
41,4775,3369,1336551104,1336551173,0,13,69
41,4775,3368,1336551173,1336551443,0,13,270
41,4775,3367,1336551443,1336551463,0,13,20
41,4775,3393,1336551463,1336551496,0,13,33
41,4775,3394,1336551496,1336551613,0,13,117
41,4775,3396,1336551613,1336552238,0,13,625
41,4775,3431,1336552238,1336552297,0,13,59
41,4775,3432,1336552297,1336552568,0,13,271
41,4775,3440,1336552568,1336552595,0,13,27
41,4775,3441,1336552595,1336554433,0,13,1838
41,4775,3442,1336554433,1336554459,0,13,26
41,4775,3377,1336554459,1336554750,0,13,291
41,4775,3443,1336554750,1336554810,0,13,60
41,4776,3172,1336601916,1336601966,0,10,50
41,4776,3388,1336601966,1336602344,0,10,378
41,4776,3365,1336602344,1336602361,0,10,17
41,4776,3370,1336602361,1336602378,0,10,17
41,4776,593,1336602378,1336602399,0,10,21
41,4776,77,1336602399,1336603019,0,10,620
41,4776,3394,1336603019,1336603067,0,10,48
41,4776,3367,1336603067,1336603249,0,10,182
41,4776,3368,1336603249,1336604327,0,10,1078
41,4776,3444,1336604327,1336604387,0,10,60
41,4777,3369,1336637548,1336637571,0,6,23
41,4777,3368,1336637571,1336637734,0,6,163
41,4777,3367,1336637734,1336637772,0,6,38
41,4777,3393,1336637772,1336637816,0,6,44
41,4777,3445,1336637816,1336637851,0,6,35
41,4777,3396,1336637851,1336637911,0,6,60
41,4778,3446,1336688902,1336688975,0,12,73
41,4778,593,1336688975,1336688990,0,12,15
41,4778,3365,1336688990,1336689009,0,12,19
41,4778,3370,1336689009,1336689027,0,12,18
41,4778,77,1336689027,1336689489,0,12,462
41,4778,3159,1336689489,1336689688,0,12,199
41,4778,3367,1336689688,1336689715,0,12,27
41,4778,3394,1336689715,1336690682,0,12,967
41,4778,3369,1336690682,1336707252,0,12,16570
41,4778,3369,1336707252,1336707271,0,12,19
41,4778,3368,1336707271,1336707287,0,12,16
41,4778,3447,1336707287,1336707347,0,12,60
41,4779,3448,1336725195,1336725260,0,32,65
41,4779,3367,1336725260,1336725609,0,32,349
41,4779,3393,1336725609,1336725660,0,32,51
41,4779,3449,1336725660,1336725756,0,32,96
41,4779,3394,1336725756,1336725843,0,32,87
41,4779,3450,1336725843,1336725908,0,32,65
41,4779,3451,1336725908,1336726064,0,32,156
41,4779,3452,1336726064,1336726140,0,32,76
41,4779,3453,1336726140,1336726253,0,32,113
41,4779,3454,1336726253,1336726301,0,32,48
41,4779,3455,1336726301,1336726511,0,32,210
41,4779,3159,1336726511,1336726585,0,32,74
41,4779,3456,1336726585,1336727343,0,32,758
41,4779,3405,1336727343,1336727359,0,32,16
41,4779,2835,1336727359,1336727576,0,32,217
41,4779,3457,1336727576,1336727652,0,32,76
41,4779,3458,1336727652,1336727752,0,32,100
41,4779,2596,1336727752,1336728967,0,32,1215
41,4779,3459,1336728967,1336729022,0,32,55
41,4779,3460,1336729022,1336729080,0,32,58
41,4779,3461,1336729080,1336729321,0,32,241
41,4779,3462,1336729321,1336729820,0,32,499
41,4779,3400,1336729820,1336729886,0,32,66
41,4779,3463,1336729886,1336729986,0,32,100
41,4779,3464,1336729986,1336730070,0,32,84
41,4779,3465,1336730070,1336730244,0,32,174
41,4779,2847,1336730244,1336730385,0,32,141
41,4779,3401,1336730385,1336730509,0,32,124
41,4779,3466,1336730509,1336736226,0,32,5717
41,4779,3465,1336736226,1336739081,0,32,2855
41,4779,3467,1336739081,1336744002,0,32,4921
41,4779,3468,1336744002,1336744062,0,32,60
41,4780,2854,1336760304,1336768437,0,3,8133
41,4780,3405,1336768437,1336769419,0,3,982
41,4780,593,1336769419,1336769479,0,3,60
41,4781,3441,1336799211,1336799290,0,7,79
41,4781,3469,1336799290,1336799919,0,7,629
41,4781,3470,1336799919,1336799994,0,7,75
41,4781,3471,1336799994,1336805819,0,7,5825
41,4781,3372,1336805819,1336810963,0,7,5144
41,4781,3387,1336810963,1336813163,0,7,2200
41,4781,3374,1336813163,1336813223,0,7,60
41,4782,453,1336853115,1336853175,0,23,60
41,4782,3472,1336853175,1336862830,0,23,9655
41,4782,3400,1336862830,1336862858,0,23,28
41,4782,3473,1336862858,1336862986,0,23,128
41,4782,3474,1336862986,1336863036,0,23,50
41,4782,3475,1336863036,1336863363,0,23,327
41,4782,3476,1336863363,1336863429,0,23,66
41,4782,3477,1336863429,1336863516,0,23,87
41,4782,3478,1336863516,1336863759,0,23,243
41,4782,3479,1336863759,1336864035,0,23,276
41,4782,3480,1336864035,1336864522,0,23,487
41,4782,3481,1336864522,1336864749,0,23,227
41,4782,3482,1336864749,1336864783,0,23,34
41,4782,3483,1336864783,1336864871,0,23,88
41,4782,3484,1336864871,1336864908,0,23,37
41,4782,3485,1336864908,1336865143,0,23,235
41,4782,3486,1336865143,1336865336,0,23,193
41,4782,3487,1336865336,1336865485,0,23,149
41,4782,3488,1336865485,1336865662,0,23,177
41,4782,3489,1336865662,1336865757,0,23,95
41,4782,3490,1336865757,1336865843,0,23,86
41,4782,3491,1336865843,1336866112,0,23,269
41,4782,3492,1336866112,1336866172,0,23,60
41,4783,3388,1336892218,1336892634,0,6,416
41,4783,3384,1336892634,1336895097,0,6,2463
41,4783,3493,1336895097,1336895326,0,6,229
41,4783,3494,1336895326,1336895945,0,6,619
41,4783,3495,1336895945,1336905640,0,6,9695
41,4783,3496,1336905640,1336905700,0,6,60
41,4784,3446,1336948447,1336948465,0,9,18
41,4784,3365,1336948465,1336948485,0,9,20
41,4784,3370,1336948485,1336948506,0,9,21
41,4784,593,1336948506,1336948545,0,9,39
41,4784,77,1336948545,1336948855,0,9,310
41,4784,3159,1336948855,1336948889,0,9,34
41,4784,3439,1336948889,1336949109,0,9,220
41,4784,3367,1336949109,1336949303,0,9,194
41,4784,3368,1336949303,1336949363,0,9,60
41,4785,3369,1336983168,1336983904,0,10,736
41,4785,3159,1336983904,1336984350,0,10,446
41,4785,3497,1336984350,1336984471,0,10,121
41,4785,545,1336984471,1336985053,0,10,582
41,4785,694,1336985053,1336986541,0,10,1488
41,4785,3498,1336986541,1336991608,0,10,5067
41,4785,3479,1336991608,1336991905,0,10,297
41,4785,3477,1336991905,1337003506,0,10,11601
41,4785,2854,1337003506,1337003859,0,10,353
41,4785,3216,1337003859,1337003919,0,10,60
41,4786,3376,1337005186,1337005277,0,6,91
41,4786,3499,1337005277,1337005378,0,6,101
41,4786,3436,1337005378,1337005404,0,6,26
41,4786,3438,1337005404,1337005703,0,6,299
41,4786,3500,1337005703,1337005758,0,6,55
41,4786,3387,1337005758,1337005818,0,6,60
41,4787,593,1337034750,1337034764,0,8,14
41,4787,3365,1337034764,1337034788,0,8,24
41,4787,3370,1337034788,1337034905,0,8,117
41,4787,594,1337034905,1337034930,0,8,25
41,4787,3366,1337034930,1337035085,0,8,155
41,4787,3439,1337035085,1337035226,0,8,141
41,4787,3394,1337035226,1337035511,0,8,285
41,4787,3368,1337035511,1337035571,0,8,60
41,4788,3447,1337069459,1337069488,0,9,29
41,4788,3369,1337069488,1337069515,0,9,27
41,4788,3368,1337069515,1337069565,0,9,50
41,4788,3501,1337069565,1337069663,0,9,98
41,4788,3367,1337069663,1337069755,0,9,92
41,4788,3394,1337069755,1337069849,0,9,94
41,4788,3395,1337069849,1337069960,0,9,111
41,4788,3396,1337069960,1337070192,0,9,232
41,4788,3429,1337070192,1337070252,0,9,60
41,4789,3502,1337092256,1337092316,0,1,60
41,4790,593,1337121284,1337121308,0,6,24
41,4790,3370,1337121308,1337121335,0,6,27
41,4790,77,1337121335,1337121558,0,6,223
41,4790,3159,1337121558,1337121689,0,6,131
41,4790,3452,1337121689,1337121876,0,6,187
41,4790,3367,1337121876,1337121936,0,6,60
41,4791,3369,1337155922,1337155957,0,16,35
41,4791,3368,1337155957,1337156191,0,16,234
41,4791,3367,1337156191,1337156211,0,16,20
41,4791,3393,1337156211,1337156313,0,16,102
41,4791,3503,1337156313,1337156342,0,16,29
41,4791,3396,1337156342,1337156877,0,16,535
41,4791,3431,1337156877,1337156946,0,16,69
41,4791,3432,1337156946,1337157133,0,16,187
41,4791,3440,1337157133,1337157157,0,16,24
41,4791,3441,1337157157,1337158454,0,16,1297
41,4791,3504,1337158454,1337158481,0,16,27
41,4791,3411,1337158481,1337159073,0,16,592
41,4791,3505,1337159073,1337159257,0,16,184
41,4791,3506,1337159257,1337160668,0,16,1411
41,4791,3372,1337160668,1337170996,0,16,10328
41,4791,3374,1337170996,1337171056,0,16,60
41,4792,3388,1337206458,1337206484,0,12,26
41,4792,3500,1337206484,1337206796,0,12,312
41,4792,3446,1337206796,1337206844,0,12,48
41,4792,3365,1337206844,1337206870,0,12,26
41,4792,3370,1337206870,1337206902,0,12,32
41,4792,77,1337206902,1337207416,0,12,514
41,4792,3159,1337207416,1337207446,0,12,30
41,4792,3439,1337207446,1337207543,0,12,97
41,4792,3394,1337207543,1337207705,0,12,162
41,4792,3367,1337207705,1337207935,0,12,230
41,4792,3368,1337207935,1337208186,0,12,251
41,4792,3369,1337208186,1337208246,0,12,60
41,4793,3368,1337242497,1337242869,0,25,372
41,4793,3448,1337242869,1337242898,0,25,29
41,4793,3393,1337242898,1337242930,0,25,32
41,4793,3394,1337242930,1337243097,0,25,167
41,4793,3450,1337243097,1337243113,0,25,16
41,4793,3451,1337243113,1337243153,0,25,40
41,4793,3452,1337243153,1337243203,0,25,50
41,4793,3454,1337243203,1337244101,0,25,898
41,4793,3402,1337244101,1337244424,0,25,323
41,4793,3057,1337244424,1337244501,0,25,77
41,4793,3507,1337244501,1337244558,0,25,57
41,4793,3508,1337244558,1337244703,0,25,145
41,4793,3509,1337244703,1337244825,0,25,122
41,4793,3510,1337244825,1337244906,0,25,81
41,4793,3403,1337244906,1337244931,0,25,25
41,4793,3404,1337244931,1337251805,0,25,6874
41,4793,3511,1337251805,1337251837,0,25,32
41,4793,3057,1337251837,1337251885,0,25,48
41,4793,3512,1337251885,1337251916,0,25,31
41,4793,3513,1337251916,1337251974,0,25,58
41,4793,3514,1337251974,1337252050,0,25,76
41,4793,3515,1337252050,1337252101,0,25,51
41,4793,3516,1337252101,1337259741,0,25,7640
41,4793,3366,1337259741,1337260075,0,25,334
41,4793,3497,1337260075,1337260135,0,25,60
41,4794,3376,1337294219,1337294487,0,7,268
41,4794,3159,1337294487,1337294578,0,7,91
41,4794,3439,1337294578,1337294718,0,7,140
41,4794,3451,1337294718,1337296702,0,7,1984
41,4794,3370,1337296702,1337296706,0,7,4
41,4794,3446,1337296706,1337296758,0,7,52
41,4794,3452,1337296758,1337296818,0,7,60
41,4795,3467,1337342581,1337342833,0,3,252
41,4795,3517,1337342833,1337343032,0,3,199
41,4795,3518,1337343032,1337343092,0,3,60
41,4796,3519,1337372384,1337372454,0,2,70
41,4796,3400,1337372454,1337372514,0,2,60
41,4797,3520,1337399058,1337399097,0,9,39
41,4797,3376,1337399097,1337399132,0,9,35
41,4797,3370,1337399132,1337399178,0,9,46
41,4797,3446,1337399178,1337399223,0,9,45
41,4797,3365,1337399223,1337399275,0,9,52
41,4797,593,1337399275,1337399305,0,9,30
41,4797,77,1337399305,1337399336,0,9,31
41,4797,3521,1337399336,1337399402,0,9,66
41,4797,542,1337399402,1337399462,0,9,60
41,4798,3388,1337638824,1337639176,0,7,352
41,4798,3365,1337639176,1337639198,0,7,22
41,4798,3370,1337639198,1337639216,0,7,18
41,4798,593,1337639216,1337639231,0,7,15
41,4798,3446,1337639231,1337639458,0,7,227
41,4798,3366,1337639458,1337639663,0,7,205
41,4798,3439,1337639663,1337639723,0,7,60
41,4799,3368,1337674446,1337674486,0,26,40
41,4799,3369,1337674486,1337674737,0,26,251
41,4799,3367,1337674737,1337674755,0,26,18
41,4799,3394,1337674755,1337674788,0,26,33
41,4799,3445,1337674788,1337674858,0,26,70
41,4799,3395,1337674858,1337675124,0,26,266
41,4799,3522,1337675124,1337675151,0,26,27
41,4799,3429,1337675151,1337675172,0,26,21
41,4799,3172,1337675172,1337687059,0,26,11887
41,4799,3405,1337687059,1337687075,0,26,16
41,4799,3477,1337687075,1337687101,0,26,26
41,4799,3457,1337687101,1337687259,0,26,158
41,4799,3459,1337687259,1337687285,0,26,26
41,4799,3461,1337687285,1337687410,0,26,125
41,4799,3523,1337687410,1337687443,0,26,33
41,4799,2854,1337687443,1337687612,0,26,169
41,4799,3524,1337687612,1337687771,0,26,159
41,4799,3525,1337687771,1337695213,0,26,7442
41,4799,3457,1337695213,1337695242,0,26,29
41,4799,3463,1337695242,1337695344,0,26,102
41,4799,3474,1337695344,1337695404,0,26,60
41,4799,3526,1337695404,1337695478,0,26,74
41,4799,3527,1337695478,1337695576,0,26,98
41,4799,3528,1337695576,1337695639,0,26,63
41,4799,3529,1337695639,1337695835,0,26,196
41,4799,3486,1337695835,1337695895,0,26,60
41,4800,3500,1337811726,1337811786,0,1,60
41,4801,3396,1337847459,1337847552,0,8,93
41,4801,3530,1337847552,1337847608,0,8,56
41,4801,3531,1337847608,1337847690,0,8,82
41,4801,3532,1337847690,1337847728,0,8,38
41,4801,3370,1337847728,1337847781,0,8,53
41,4801,3387,1337847781,1337848039,0,8,258
41,4801,3431,1337848039,1337848076,0,8,37
41,4801,3432,1337848076,1337848136,0,8,60
41,4802,3497,1337936771,1337936787,0,17,16
41,4802,3533,1337936787,1337936876,0,17,89
41,4802,545,1337936876,1337936907,0,17,31
41,4802,3534,1337936907,1337937068,0,17,161
41,4802,3405,1337937068,1337937175,0,17,107
41,4802,3477,1337937175,1337937197,0,17,22
41,4802,449,1337937197,1337937490,0,17,293
41,4802,3461,1337937490,1337942149,0,17,4659
41,4802,2854,1337942149,1337942169,0,17,20
41,4802,3518,1337942169,1337942190,0,17,21
41,4802,3535,1337942190,1337942230,0,17,40
41,4802,3468,1337942230,1337944274,0,17,2044
41,4802,3517,1337944274,1337944315,0,17,41
41,4802,3536,1337944315,1337953002,0,17,8687
41,4802,3537,1337953002,1337953046,0,17,44
41,4802,3538,1337953046,1337953087,0,17,41
41,4802,3539,1337953087,1337953147,0,17,60
41,4803,3440,1337972732,1337972750,0,2,18
41,4803,3441,1337972750,1337972810,0,2,60
41,4804,3441,1338005608,1338005648,0,12,40
41,4804,3440,1338005648,1338005689,0,12,41
41,4804,3432,1338005689,1338005839,0,12,150
41,4804,3430,1338005839,1338005859,0,12,20
41,4804,3431,1338005859,1338006421,0,12,562
41,4804,3470,1338006421,1338006440,0,12,19
41,4804,3471,1338006440,1338008288,0,12,1848
41,4804,3372,1338008288,1338017672,0,12,9384
41,4804,3540,1338017672,1338017717,0,12,45
41,4804,3469,1338017717,1338017756,0,12,39
41,4804,3172,1338017756,1338017828,0,12,72
41,4804,3541,1338017828,1338017888,0,12,60
41,4805,3388,1338080577,1338080611,0,14,34
41,4805,3500,1338080611,1338080709,0,14,98
41,4805,3376,1338080709,1338080748,0,14,39
41,4805,3370,1338080748,1338080838,0,14,90
41,4805,3384,1338080838,1338080869,0,14,31
41,4805,3383,1338080869,1338084013,0,14,3144
41,4805,3542,1338084013,1338084079,0,14,66
41,4805,3543,1338084079,1338084220,0,14,141
41,4805,3544,1338084220,1338084248,0,14,28
41,4805,3545,1338084248,1338084715,0,14,467
41,4805,3546,1338084715,1338088891,0,14,4176
41,4805,3372,1338088891,1338088924,0,14,33
41,4805,3547,1338088924,1338088958,0,14,34
41,4805,3548,1338088958,1338089018,0,14,60
41,4806,3549,1338106049,1338106179,0,7,130
41,4806,3540,1338106179,1338106203,0,7,24
41,4806,3387,1338106203,1338106412,0,7,209
41,4806,3172,1338106412,1338106441,0,7,29
41,4806,3469,1338106441,1338106507,0,7,66
41,4806,3541,1338106507,1338107455,0,7,948
41,4806,3441,1338107455,1338107515,0,7,60
41,4807,3500,1338157607,1338157639,0,7,32
41,4807,3388,1338157639,1338157934,0,7,295
41,4807,3365,1338157934,1338157954,0,7,20
41,4807,3370,1338157954,1338158259,0,7,305
41,4807,3159,1338158259,1338158293,0,7,34
41,4807,3550,1338158293,1338158319,0,7,26
41,4807,3439,1338158319,1338158379,0,7,60
41,4808,3369,1338192700,1338192725,0,10,25
41,4808,3368,1338192725,1338192908,0,10,183
41,4808,3367,1338192908,1338192992,0,10,84
41,4808,3395,1338192992,1338193054,0,10,62
41,4808,3396,1338193054,1338193324,0,10,270
41,4808,3172,1338193324,1338193635,0,10,311
41,4808,3431,1338193635,1338193713,0,10,78
41,4808,3432,1338193713,1338193738,0,10,25
41,4808,3430,1338193738,1338193905,0,10,167
41,4808,3441,1338193905,1338193965,0,10,60
41,4809,3500,1338243927,1338244094,0,9,167
41,4809,3436,1338244094,1338244270,0,9,176
41,4809,3370,1338244270,1338244749,0,9,479
41,4809,3159,1338244749,1338244765,0,9,16
41,4809,3551,1338244765,1338245252,0,9,487
41,4809,3368,1338245252,1338246156,0,9,904
41,4809,3501,1338246156,1338246268,0,9,112
41,4809,3447,1338246268,1338246354,0,9,86
41,4809,3552,1338246354,1338246414,0,9,60
41,4810,3393,1338279340,1338279385,0,8,45
41,4810,3367,1338279385,1338279660,0,8,275
41,4810,3553,1338279660,1338279700,0,8,40
41,4810,3397,1338279700,1338279727,0,8,27
41,4810,3433,1338279727,1338280037,0,8,310
41,4810,3431,1338280037,1338280079,0,8,42
41,4810,3430,1338280079,1338280113,0,8,34
41,4810,3432,1338280113,1338280173,0,8,60
41,4811,3172,1338329923,1338329969,0,11,46
41,4811,3388,1338329969,1338330029,0,11,60
41,4811,3500,1338330029,1338330366,0,11,337
41,4811,3370,1338330366,1338330393,0,11,27
41,4811,3446,1338330393,1338330773,0,11,380
41,4811,3159,1338330773,1338330805,0,11,32
41,4811,3551,1338330805,1338330827,0,11,22
41,4811,3439,1338330827,1338330961,0,11,134
41,4811,3394,1338330961,1338331076,0,11,115
41,4811,3367,1338331076,1338331275,0,11,199
41,4811,3368,1338331275,1338331335,0,11,60
41,4812,3370,1338503528,1338503591,0,7,63
41,4812,3446,1338503591,1338503663,0,7,72
41,4812,77,1338503663,1338503983,0,7,320
41,4812,3159,1338503983,1338504036,0,7,53
41,4812,3551,1338504036,1338504063,0,7,27
41,4812,3439,1338504063,1338504209,0,7,146
41,4812,3394,1338504209,1338504269,0,7,60
41,4813,3172,1338540202,1338541960,0,14,1758
41,4813,3541,1338541960,1338541974,0,14,14
41,4813,3469,1338541974,1338542077,0,14,103
41,4813,3435,1338542077,1338542195,0,14,118
41,4813,3554,1338542195,1338542318,0,14,123
41,4813,3445,1338542318,1338542380,0,14,62
41,4813,3451,1338542380,1338542394,0,14,14
41,4813,3450,1338542394,1338542685,0,14,291
41,4813,3529,1338542685,1338542703,0,14,18
41,4813,3528,1338542703,1338551558,0,14,8855
41,4813,3555,1338551558,1338551585,0,14,27
41,4813,3524,1338551585,1338551599,0,14,14
41,4813,2854,1338551599,1338551633,0,14,34
41,4813,2848,1338551633,1338551693,0,14,60
41,4814,3556,1338672285,1338687349,0,3,15064
41,4814,3489,1338687349,1338687388,0,3,39
41,4814,3557,1338687388,1338687448,0,3,60
41,4815,3441,1338702230,1338702261,0,18,31
41,4815,3440,1338702261,1338702277,0,18,16
41,4815,3432,1338702277,1338702428,0,18,151
41,4815,3430,1338702428,1338702450,0,18,22
41,4815,3431,1338702450,1338702654,0,18,204
41,4815,3558,1338702654,1338702763,0,18,109
41,4815,3559,1338702763,1338702885,0,18,122
41,4815,3469,1338702885,1338702910,0,18,25
41,4815,3387,1338702910,1338718624,0,18,15714
41,4815,3495,1338718624,1338718702,0,18,78
41,4815,3560,1338718702,1338718728,0,18,26
41,4815,3496,1338718728,1338718751,0,18,23
41,4815,3561,1338718751,1338718777,0,18,26
41,4815,3426,1338718777,1338718810,0,18,33
41,4815,3425,1338718810,1338718839,0,18,29
41,4815,3375,1338718839,1338719033,0,18,194
41,4815,3562,1338719033,1338719109,0,18,76
41,4815,3374,1338719109,1338719169,0,18,60
41,4816,3563,1338726314,1338726374,0,1,60
41,4817,3500,1338762274,1338762293,0,10,19
41,4817,3388,1338762293,1338762318,0,10,25
41,4817,3520,1338762318,1338762395,0,10,77
41,4817,3438,1338762395,1338762597,0,10,202
41,4817,3446,1338762597,1338762650,0,10,53
41,4817,3370,1338762650,1338762674,0,10,24
41,4817,3365,1338762674,1338763391,0,10,717
41,4817,3367,1338763391,1338763435,0,10,44
41,4817,3448,1338763435,1338763553,0,10,118
41,4817,3368,1338763553,1338763613,0,10,60
41,4818,3447,1338797386,1338797512,0,19,126
41,4818,3369,1338797512,1338797633,0,19,121
41,4818,3367,1338797633,1338797670,0,19,37
41,4818,3394,1338797670,1338797796,0,19,126
41,4818,3445,1338797796,1338797828,0,19,32
41,4818,3564,1338797828,1338797856,0,19,28
41,4818,3396,1338797856,1338798167,0,19,311
41,4818,3565,1338798167,1338798233,0,19,66
41,4818,3566,1338798233,1338801283,0,19,3050
41,4818,3377,1338801283,1338801410,0,19,127
41,4818,3567,1338801410,1338803151,0,19,1741
41,4818,3568,1338803151,1338803167,0,19,16
41,4818,3529,1338803167,1338803237,0,19,70
41,4818,3528,1338803237,1338803448,0,19,211
41,4818,3569,1338803448,1338803575,0,19,127
41,4818,3473,1338803575,1338805847,0,19,2272
41,4818,3570,1338805847,1338811184,0,19,5337
41,4818,3409,1338811184,1338811204,0,19,20
41,4818,3571,1338811204,1338811264,0,19,60
41,4819,3500,1338849220,1338849244,0,8,24
41,4819,3388,1338849244,1338849270,0,8,26
41,4819,3500,1338849270,1338849597,0,8,327
41,4819,3370,1338849597,1338849613,0,8,16
41,4819,3446,1338849613,1338849948,0,8,335
41,4819,3551,1338849948,1338850105,0,8,157
41,4819,3394,1338850105,1338850221,0,8,116
41,4819,3367,1338850221,1338850281,0,8,60
41,4820,3447,1338883864,1338883890,0,7,26
41,4820,3552,1338883890,1338883914,0,7,24
41,4820,3369,1338883914,1338884922,0,7,1008
41,4820,3431,1338884922,1338885020,0,7,98
41,4820,3558,1338885020,1338886470,0,7,1450
41,4820,3381,1338886470,1338886504,0,7,34
41,4820,3433,1338886504,1338886564,0,7,60
41,4821,3369,1338970322,1338970344,0,18,22
41,4821,3501,1338970344,1338970473,0,18,129
41,4821,3367,1338970473,1338970504,0,18,31
41,4821,3394,1338970504,1338970554,0,18,50
41,4821,3445,1338970554,1338970605,0,18,51
41,4821,3395,1338970605,1338970624,0,18,19
41,4821,3396,1338970624,1338971044,0,18,420
41,4821,3431,1338971044,1338971288,0,18,244
41,4821,3430,1338971288,1338971315,0,18,27
41,4821,3432,1338971315,1338971447,0,18,132
41,4821,3558,1338971447,1338971468,0,18,21
41,4821,3440,1338971468,1338971486,0,18,18
41,4821,3441,1338971486,1338973226,0,18,1740
41,4821,3572,1338973226,1338973361,0,18,135
41,4821,3573,1338973361,1338973597,0,18,236
41,4821,3574,1338973597,1338974119,0,18,522
41,4821,3575,1338974119,1338974138,0,18,19
41,4821,3377,1338974138,1338974198,0,18,60
41,4822,3172,1339021146,1339021196,0,9,50
41,4822,3388,1339021196,1339021568,0,9,372
41,4822,3365,1339021568,1339021598,0,9,30
41,4822,3370,1339021598,1339021613,0,9,15
41,4822,593,1339021613,1339021931,0,9,318
41,4822,3159,1339021931,1339021964,0,9,33
41,4822,3551,1339021964,1339022385,0,9,421
41,4822,3367,1339022385,1339022405,0,9,20
41,4822,3368,1339022405,1339022465,0,9,60
41,4823,3501,1339056753,1339056769,0,20,16
41,4823,3368,1339056769,1339057096,0,20,327
41,4823,3367,1339057096,1339057779,0,20,683
41,4823,3431,1339057779,1339057889,0,20,110
41,4823,3430,1339057889,1339059757,0,20,1868
41,4823,3541,1339059757,1339059865,0,20,108
41,4823,3469,1339059865,1339059976,0,20,111
41,4823,3397,1339059976,1339060136,0,20,160
41,4823,3396,1339060136,1339060415,0,20,279
41,4823,3486,1339060415,1339060522,0,20,107
41,4823,3529,1339060522,1339060622,0,20,100
41,4823,3528,1339060622,1339060751,0,20,129
41,4823,3576,1339060751,1339060909,0,20,158
41,4823,3463,1339060909,1339060923,0,20,14
41,4823,3400,1339060923,1339062405,0,20,1482
41,4823,2596,1339062405,1339065153,0,20,2748
41,4823,3459,1339065153,1339065176,0,20,23
41,4823,3461,1339065176,1339065218,0,20,42
41,4823,3460,1339065218,1339071105,0,20,5887
41,4823,3535,1339071105,1339071165,0,20,60
41,4824,3365,1339108493,1339108519,0,7,26
41,4824,3370,1339108519,1339108818,0,7,299
41,4824,3159,1339108818,1339108842,0,7,24
41,4824,3550,1339108842,1339109055,0,7,213
41,4824,3394,1339109055,1339109080,0,7,25
41,4824,3393,1339109080,1339109103,0,7,23
41,4824,3367,1339109103,1339109163,0,7,60
41,4825,3372,1339228744,1339228759,0,9,15
41,4825,3373,1339228759,1339233718,0,9,4959
41,4825,3540,1339233718,1339233751,0,9,33
41,4825,3469,1339233751,1339233779,0,9,28
41,4825,3387,1339233779,1339233800,0,9,21
41,4825,3172,1339233800,1339233833,0,9,33
41,4825,3541,1339233833,1339233857,0,9,24
41,4825,3432,1339233857,1339233882,0,9,25
41,4825,3558,1339233882,1339233942,0,9,60
41,4826,3577,1339275502,1339275658,0,20,156
41,4826,3529,1339275658,1339275680,0,20,22
41,4826,3481,1339275680,1339275806,0,20,126
41,4826,3400,1339275806,1339282813,0,20,7007
41,4826,3432,1339282813,1339282825,0,20,12
41,4826,3431,1339282825,1339282841,0,20,16
41,4826,3558,1339282841,1339282854,0,20,13
41,4826,3430,1339282854,1339282868,0,20,14
41,4826,3441,1339282868,1339282886,0,20,18
41,4826,3440,1339282886,1339286060,0,20,3174
41,4826,3411,1339286060,1339286074,0,20,14
41,4826,3578,1339286074,1339286224,0,20,150
41,4826,3578,1339286224,1339286238,0,20,14
41,4826,3579,1339286238,1339286347,0,20,109
41,4826,3580,1339286347,1339286488,0,20,141
41,4826,3581,1339286488,1339286508,0,20,20
41,4826,3582,1339286508,1339286936,0,20,428
41,4826,3583,1339286936,1339286958,0,20,22
41,4826,3584,1339286958,1339287353,0,20,395
41,4826,3585,1339287353,1339287413,0,20,60
41,4827,3586,1339308251,1339308311,0,1,60
41,4828,3500,1339367103,1339367492,0,8,389
41,4828,3446,1339367492,1339367528,0,8,36
41,4828,3370,1339367528,1339367952,0,8,424
41,4828,3159,1339367952,1339367971,0,8,19
41,4828,3550,1339367971,1339368015,0,8,44
41,4828,3439,1339368015,1339368125,0,8,110
41,4828,3394,1339368125,1339368269,0,8,144
41,4828,3367,1339368269,1339368329,0,8,60
42,4829,3587,1339402541,1339402652,0,20,111
42,4829,3399,1339402652,1339402706,0,20,54
42,4829,3588,1339402706,1339402738,0,20,32
42,4829,3398,1339402738,1339403900,0,20,1162
42,4829,449,1339403900,1339403932,0,20,32
42,4829,2835,1339403932,1339404166,0,20,234
42,4829,3461,1339404166,1339404197,0,20,31
42,4829,3459,1339404197,1339404964,0,20,767
42,4829,3459,1339404964,1339404985,0,20,21
42,4829,3457,1339404985,1339413462,0,20,8477
42,4829,2596,1339413462,1339415763,0,20,2301
42,4829,449,1339415763,1339415777,0,20,14
42,4829,3405,1339415777,1339416889,0,20,1112
42,4829,3376,1339416889,1339416917,0,20,28
42,4829,593,1339416917,1339416964,0,20,47
42,4829,3499,1339416964,1339417055,0,20,91
42,4829,3436,1339417055,1339417084,0,20,29
42,4829,3438,1339417084,1339417107,0,20,23
42,4829,3520,1339417107,1339417136,0,20,29
42,4829,3589,1339417136,1339417196,0,20,60
42,4830,3304,1333495804,1333498282,0,2,2478
42,4830,2546,1333498282,1333498342,0,2,60
42,4831,3304,1333539085,1333539617,0,2,532
42,4831,3590,1333539617,1333539677,0,2,60
42,4832,3304,1333581941,1333582001,0,1,60
42,4833,3591,1333725493,1333725553,0,1,60
42,4834,1723,1333802590,1333803127,0,3,537
42,4834,3592,1333803127,1333811811,0,3,8684
42,4834,3304,1333811811,1333811871,0,3,60
42,4835,3304,1333848624,1333850981,0,2,2357
42,4835,2546,1333850981,1333851041,0,2,60
42,4836,3593,1333912442,1333912502,0,1,60
42,4837,3304,1333971090,1333971134,0,3,44
42,4837,3590,1333971134,1333971583,0,3,449
42,4837,3591,1333971583,1333971643,0,3,60
42,4838,3304,1334030954,1334033184,0,7,2230
42,4838,3594,1334033184,1334036208,0,7,3024
42,4838,1647,1334036208,1334041752,0,7,5544
42,4838,3595,1334041752,1334042393,0,7,641
42,4838,2569,1334042393,1334043911,0,7,1518
42,4838,3114,1334043911,1334044106,0,7,195
42,4838,3596,1334044106,1334044166,0,7,60
42,4839,3114,1334055127,1334055957,0,4,830
42,4839,1235,1334055957,1334056280,0,4,323
42,4839,3597,1334056280,1334057338,0,4,1058
42,4839,3598,1334057338,1334057398,0,4,60
42,4840,3304,1334100492,1334100552,0,1,60
42,4841,3591,1334139615,1334139675,0,1,60
42,4842,3304,1334186880,1334189549,0,3,2669
42,4842,2546,1334189549,1334201282,0,3,11733
42,4842,868,1334201282,1334201342,0,3,60
42,4843,3599,1334225565,1334225625,0,1,60
42,4844,3304,1334366684,1334368956,0,2,2272
42,4844,2546,1334368956,1334369016,0,2,60
42,4845,3304,1334407246,1334407962,0,2,716
42,4845,3591,1334407962,1334408022,0,2,60
42,4846,3304,1334453286,1334455785,0,2,2499
42,4846,2546,1334455785,1334455845,0,2,60
42,4847,3304,1334503557,1334504362,0,2,805
42,4847,3591,1334504362,1334504422,0,2,60
42,4848,3304,1334575826,1334576530,0,2,704
42,4848,3591,1334576530,1334576590,0,2,60
42,4849,3304,1334705121,1334705181,0,1,60
42,4850,2546,1334795724,1334795784,0,1,60
42,4851,253,1334829758,1334829980,0,2,222
42,4851,170,1334829980,1334830040,0,2,60
42,4852,3304,1334896293,1334899337,0,6,3044
42,4852,5,1334899337,1334900828,0,6,1491
42,4852,8,1334900828,1334903355,0,6,2527
42,4852,574,1334903355,1334910508,0,6,7153
42,4852,3600,1334910508,1334910750,0,6,242
42,4852,3601,1334910750,1334910810,0,6,60
42,4853,3304,1334930732,1334930792,0,1,60
42,4854,3602,1334972992,1334973676,0,2,684
42,4854,2546,1334973676,1334973736,0,2,60
42,4855,3304,1335010470,1335011107,0,2,637
42,4855,3591,1335011107,1335011167,0,2,60
42,4856,3304,1335057939,1335057999,0,1,60
42,4857,3591,1335099919,1335099979,0,1,60
42,4858,3304,1335137260,1335154987,0,4,17727
42,4858,2546,1335154987,1335157129,0,4,2142
42,4858,3603,1335157129,1335157657,0,4,528
42,4858,2546,1335157657,1335157717,0,4,60
42,4859,3304,1335239064,1335249751,0,4,10687
42,4859,3604,1335249751,1335252014,0,4,2263
42,4859,1070,1335252014,1335253821,0,4,1807
42,4859,458,1335253821,1335253881,0,4,60
42,4860,3304,1335309120,1335309180,0,1,60
42,4861,3304,1335355259,1335355319,0,1,60
42,4862,3304,1335397122,1335397182,0,1,60
42,4863,1235,1335444574,1335447184,0,2,2610
42,4863,3304,1335447184,1335447244,0,2,60
42,4864,104,1335528426,1335537070,0,4,8644
42,4864,2501,1335537070,1335538985,0,4,1915
42,4864,3304,1335538985,1335539018,0,4,33
42,4864,3605,1335539018,1335539078,0,4,60
42,4865,3606,1335575276,1335575336,0,1,60
42,4866,3591,1335614320,1335614380,0,1,60
42,4867,3304,1335652641,1335654815,0,7,2174
42,4867,253,1335654815,1335656162,0,7,1347
42,4867,14,1335656162,1335656610,0,7,448
42,4867,15,1335656610,1335661300,0,7,4690
42,4867,14,1335661300,1335663210,0,7,1910
42,4867,35,1335663210,1335663671,0,7,461
42,4867,2546,1335663671,1335663731,0,7,60
42,4868,2546,1335678123,1335678183,0,1,60
42,4869,1311,1335702598,1335702912,0,4,314
42,4869,3607,1335702912,1335714041,0,4,11129
42,4869,3304,1335714041,1335714501,0,4,460
42,4869,3591,1335714501,1335714561,0,4,60
42,4870,3304,1335923420,1335926673,0,3,3253
42,4870,1550,1335926673,1335931287,0,3,4614
42,4870,1551,1335931287,1335931347,0,3,60
42,4871,3304,1335947345,1335947405,0,1,60
42,4872,3304,1336046867,1336047386,0,2,519
42,4872,3591,1336047386,1336047446,0,2,60
42,4873,3304,1336098090,1336100319,0,3,2229
42,4873,3173,1336100319,1336101261,0,3,942
42,4873,3608,1336101261,1336101321,0,3,60
42,4874,35,1336120976,1336121036,0,1,60
42,4875,1235,1336162039,1336164466,0,6,2427
42,4875,3304,1336164466,1336165495,0,6,1029
42,4875,3591,1336165495,1336174297,0,6,8802
42,4875,3304,1336174297,1336176832,0,6,2535
42,4875,1235,1336176832,1336179789,0,6,2957
42,4875,2546,1336179789,1336179849,0,6,60
42,4876,3609,1336186538,1336189694,0,2,3156
42,4876,2546,1336189694,1336189754,0,2,60
42,4877,3304,1336260106,1336260166,0,1,60
42,4878,3304,1336346587,1336361411,0,2,14824
42,4878,868,1336361411,1336361471,0,2,60
42,4879,3304,1336390244,1336390304,0,1,60
42,4880,3610,1336526931,1336526991,0,1,60
43,4881,3304,1336577719,1336578097,0,3,378
43,4881,3611,1336578097,1336578621,0,3,524
43,4881,3591,1336578621,1336578681,0,3,60
43,4882,5,1334310653,1334310713,0,1,60
43,4883,601,1334458360,1334458420,0,1,60
43,4884,765,1335669995,1335670009,0,4,14
43,4884,260,1335670009,1335670932,0,4,923
43,4884,5,1335670932,1335675154,0,4,4222
43,4884,1565,1335675154,1335675214,0,4,60
43,4885,3612,1335699246,1335699306,0,1,60
43,4886,260,1336884265,1336885303,0,4,1038
43,4886,5,1336885303,1336891148,0,4,5845
43,4886,9,1336891148,1336893386,0,4,2238
43,4886,9,1336893386,1336893446,0,4,60
43,4887,3613,1337347102,1337348667,0,2,1565
43,4887,3614,1337348667,1337348727,0,2,60
43,4888,1005,1338102705,1338103849,0,5,1144
43,4888,5,1338103849,1338104142,0,5,293
43,4888,237,1338104142,1338108564,0,5,4422
43,4888,9,1338108564,1338116608,0,5,8044
43,4888,228,1338116608,1338116668,0,5,60
43,4889,1778,1338700419,1338701248,0,2,829
43,4889,1261,1338701248,1338701308,0,2,60
43,4890,1261,1338727541,1338728685,0,2,1144
43,4890,1778,1338728685,1338728745,0,2,60
43,4891,5,1338893144,1338893519,0,3,375
43,4891,228,1338893519,1338896747,0,3,3228
43,4891,770,1338896747,1338896807,0,3,60
43,4892,5,1339293075,1339308925,0,2,15850
43,4892,237,1339308925,1339308985,0,2,60
43,4893,3615,1339315299,1339321807,0,2,6508
43,4893,1573,1339321807,1339321867,0,2,60
43,4894,5,1339909262,1339909478,0,8,216
43,4894,16,1339909478,1339910312,0,8,834
43,4894,3616,1339910312,1339912615,0,8,2303
43,4894,284,1339912615,1339917577,0,8,4962
43,4894,5,1339917577,1339917593,0,8,16
43,4894,3617,1339917593,1339917913,0,8,320
43,4894,237,1339917913,1339930429,0,8,12516
43,4894,3617,1339930429,1339930489,0,8,60
43,4895,3618,1339931854,1339931914,0,1,60
43,4896,260,1341095355,1341095384,0,2,29
43,4896,1005,1341095384,1341095444,0,2,60
43,4897,5,1342238944,1342239004,0,1,60
43,4898,1085,1342832752,1342832812,0,1,60
43,4899,2194,1344256665,1344256725,0,1,60
43,4900,5,1345259277,1345259337,0,1,60
43,4901,260,1347686179,1347686896,0,2,717
43,4901,5,1347686896,1347686956,0,2,60
43,4902,5,1347713588,1347713648,0,1,60
43,4903,5,1351245946,1351246006,0,1,60
43,4904,3619,1351388404,1351389274,0,4,870
43,4904,3620,1351389274,1351390690,0,4,1416
43,4904,467,1351390690,1351407296,0,4,16606
43,4904,3621,1351407296,1351407356,0,4,60
43,4905,5,1351410182,1351410242,0,1,60
43,4906,5,1352513408,1352515728,0,2,2320
43,4906,766,1352515728,1352515788,0,2,60
43,4907,5,1353578166,1353579211,0,3,1045
43,4907,26,1353579211,1353585040,0,3,5829
43,4907,1292,1353585040,1353585100,0,3,60
43,4908,1005,1353722619,1353722634,0,4,15
43,4908,260,1353722634,1353737529,0,4,14895
43,4908,5,1353737529,1353737955,0,4,426
43,4908,48,1353737955,1353738015,0,4,60
43,4909,3622,1353819687,1353819747,0,1,60
43,4910,260,1354330580,1354331465,0,4,885
43,4910,5,1354331465,1354345744,0,4,14279
43,4910,3623,1354345744,1354345943,0,4,199
43,4910,3624,1354345943,1354346003,0,4,60
43,4911,26,1355626879,1355626921,0,3,42
43,4911,237,1355626921,1355635531,0,3,8610
43,4911,3625,1355635531,1355635591,0,3,60
43,4912,3626,1355653198,1355653258,0,1,60
43,4913,26,1356084222,1356084235,0,2,13
43,4913,5,1356084235,1356084295,0,2,60
43,4914,3627,1356142179,1356142190,0,4,11
43,4914,1136,1356142190,1356152426,0,4,10236
43,4914,3628,1356152426,1356161540,0,4,9114
43,4914,3629,1356161540,1356161600,0,4,60
43,4915,3630,1356186051,1356186111,0,1,60
43,4916,3631,1356699440,1356699500,0,1,60
43,4917,14,1356840937,1356854898,0,4,13961
43,4917,5,1356854898,1356857581,0,4,2683
43,4917,3612,1356857581,1356861680,0,4,4099
43,4917,770,1356861680,1356861740,0,4,60
43,4918,71,1357962249,1357962309,0,1,60
43,4919,170,1359167921,1359167938,0,5,17
43,4919,3632,1359167938,1359168830,0,5,892
43,4919,3633,1359168830,1359172168,0,5,3338
43,4919,24,1359172168,1359175860,0,5,3692
43,4919,24,1359175860,1359175920,0,5,60
43,4920,1005,1359250536,1359251479,0,4,943
43,4920,5,1359251479,1359257825,0,4,6346
43,4920,8,1359257825,1359261930,0,4,4105
43,4920,24,1359261930,1359261990,0,4,60
43,4921,1005,1359773479,1359780342,0,2,6863
43,4921,3634,1359780342,1359780402,0,2,60
43,4922,35,1360526069,1360526129,0,1,60
44,4923,253,1360748700,1360756942,0,4,8242
44,4923,258,1360756942,1360758187,0,4,1245
44,4923,5,1360758187,1360762645,0,4,4458
44,4923,5,1360762645,1360762705,0,4,60
44,4924,3635,1333510950,1333523464,0,3,12514
44,4924,1112,1333523464,1333523771,0,3,307
44,4924,3636,1333523771,1333523831,0,3,60
44,4925,253,1333613996,1333614056,0,1,60
44,4926,71,1333867416,1333867476,0,1,60
44,4927,1112,1334022418,1334022881,0,3,463
44,4927,3636,1334022881,1334037772,0,3,14891
44,4927,3637,1334037772,1334037832,0,3,60
44,4928,3638,1334053415,1334053475,0,1,60
44,4929,458,1334129332,1334131520,0,3,2188
44,4929,3639,1334131520,1334137796,0,3,6276
44,4929,253,1334137796,1334137856,0,3,60
44,4930,3114,1334199245,1334199793,0,4,548
44,4930,3640,1334199793,1334200091,0,4,298
44,4930,3641,1334200091,1334208682,0,4,8591
44,4930,3642,1334208682,1334208742,0,4,60
44,4931,3643,1334233707,1334233767,0,1,60
44,4932,3637,1334286032,1334305061,0,2,19029
44,4932,221,1334305061,1334305121,0,2,60
44,4933,3642,1334380152,1334380277,0,3,125
44,4933,3644,1334380277,1334385679,0,3,5402
44,4933,3645,1334385679,1334385739,0,3,60
44,4934,1112,1334812315,1334812706,0,4,391
44,4934,3636,1334812706,1334826925,0,4,14219
44,4934,3646,1334826925,1334830303,0,4,3378
44,4934,3114,1334830303,1334830363,0,4,60
44,4935,1112,1334896015,1334896932,0,3,917
44,4935,3647,1334896932,1334912700,0,3,15768
44,4935,3648,1334912700,1334912760,0,3,60
44,4936,3125,1334999504,1335000366,0,2,862
44,4936,3649,1335000366,1335000426,0,2,60
44,4937,446,1335072914,1335074547,0,4,1633
44,4937,449,1335074547,1335076437,0,4,1890
44,4937,2033,1335076437,1335087224,0,4,10787
44,4937,3650,1335087224,1335087284,0,4,60
44,4938,1112,1335144699,1335145527,0,3,828
44,4938,3642,1335145527,1335160306,0,3,14779
44,4938,3651,1335160306,1335160366,0,3,60
44,4939,1112,1335231994,1335238133,0,2,6139
44,4939,3636,1335238133,1335238193,0,2,60
44,4940,253,1335257976,1335259891,0,3,1915
44,4940,3652,1335259891,1335260120,0,3,229
44,4940,3638,1335260120,1335260180,0,3,60
44,4941,1084,1335401270,1335413723,0,3,12453
44,4941,1112,1335413723,1335415017,0,3,1294
44,4941,3637,1335415017,1335415077,0,3,60
44,4942,3653,1335524976,1335525036,0,1,60
44,4943,458,1335570107,1335572725,0,4,2618
44,4943,359,1335572725,1335582359,0,4,9634
44,4943,100,1335582359,1335583462,0,4,1103
44,4943,3645,1335583462,1335583522,0,4,60
44,4944,253,1335594011,1335594071,0,1,60
44,4945,1112,1335930516,1335932497,0,2,1981
44,4945,3636,1335932497,1335932557,0,2,60
44,4946,253,1335954691,1335956682,0,2,1991
44,4946,3638,1335956682,1335956742,0,2,60
44,4947,253,1336105793,1336106470,0,5,677
44,4947,3640,1336106470,1336108854,0,5,2384
44,4947,3654,1336108854,1336109380,0,5,526
44,4947,3655,1336109380,1336111452,0,5,2072
44,4947,3656,1336111452,1336111512,0,5,60
44,4948,3642,1336188875,1336191037,0,3,2162
44,4948,3657,1336191037,1336193723,0,3,2686
44,4948,3658,1336193723,1336193783,0,3,60
44,4949,3652,1336212380,1336212838,0,2,458
44,4949,3638,1336212838,1336212898,0,2,60
44,4950,3642,1336353486,1336354012,0,3,526
44,4950,3636,1336354012,1336361172,0,3,7160
44,4950,3659,1336361172,1336361232,0,3,60
44,4951,3652,1336384190,1336384409,0,2,219
44,4951,3638,1336384409,1336384469,0,2,60
44,4952,3642,1336528594,1336528654,0,1,60
44,4953,3652,1336737644,1336737848,0,2,204
44,4953,3638,1336737848,1336737908,0,2,60
44,4954,253,1336812567,1336812857,0,3,290
44,4954,1259,1336812857,1336814035,0,3,1178
44,4954,3660,1336814035,1336814095,0,3,60
44,4955,1112,1336959195,1336959556,0,2,361
44,4955,3642,1336959556,1336959616,0,2,60
44,4956,3652,1336988337,1336989687,0,2,1350
44,4956,3638,1336989687,1336989747,0,2,60
44,4957,1112,1337046518,1337047526,0,3,1008
44,4957,3642,1337047526,1337049655,0,3,2129
44,4957,3636,1337049655,1337049715,0,3,60
44,4958,3652,1337072906,1337073069,0,2,163
44,4958,3638,1337073069,1337073129,0,2,60
44,4959,253,1337128727,1337140114,0,5,11387
44,4959,3642,1337140114,1337146601,0,5,6487
44,4959,3652,1337146601,1337147155,0,5,554
44,4959,3653,1337147155,1337148691,0,5,1536
44,4959,3638,1337148691,1337148751,0,5,60
44,4960,1112,1337217694,1337218564,0,2,870
44,4960,3636,1337218564,1337218624,0,2,60
44,4961,2443,1337255651,1337255711,0,1,60
44,4962,3125,1337418585,1337419647,0,4,1062
44,4962,3649,1337419647,1337428863,0,4,9216
44,4962,3652,1337428863,1337429094,0,4,231
44,4962,3638,1337429094,1337429154,0,4,60
44,4963,3636,1337657264,1337657324,0,1,60
44,4964,1112,1337827871,1337828115,0,2,244
44,4964,3642,1337828115,1337828175,0,2,60
44,4965,3642,1338169191,1338169251,0,1,60
44,4966,3642,1339046295,1339046355,0,1,60
44,4967,3661,1339473244,1339473304,0,1,60
44,4968,3662,1339645860,1339645920,0,1,60
44,4969,651,1341110073,1341110133,0,1,60
44,4970,3636,1341282488,1341300819,0,2,18331
44,4970,490,1341300819,1341300879,0,2,60
44,4971,3638,1341312602,1341312662,0,1,60
44,4972,3653,1341397538,1341397908,0,2,370
44,4972,3638,1341397908,1341397968,0,2,60
44,4973,1112,1341456492,1341457224,0,2,732
44,4973,3636,1341457224,1341457284,0,2,60
44,4974,747,1341481298,1341497860,0,2,16562
44,4974,3663,1341497860,1341497920,0,2,60
44,4975,3664,1341557766,1341567031,0,3,9265
44,4975,3636,1341567031,1341569428,0,3,2397
44,4975,425,1341569428,1341569488,0,3,60
44,4976,3652,1341646810,1341646957,0,5,147
44,4976,3638,1341646957,1341649882,0,5,2925
44,4976,1096,1341649882,1341650711,0,5,829
44,4976,3665,1341650711,1341667180,0,5,16469
44,4976,3666,1341667180,1341667240,0,5,60
44,4977,3667,1341804125,1341805452,0,4,1327
44,4977,3642,1341805452,1341824849,0,4,19397
44,4977,3652,1341824849,1341825056,0,4,207
44,4977,3638,1341825056,1341825116,0,4,60
44,4978,253,1341991198,1341991258,0,1,60
44,4979,2438,1342087496,1342090864,0,3,3368
44,4979,3652,1342090864,1342091201,0,3,337
44,4979,3668,1342091201,1342091261,0,3,60
44,4980,3642,1342145504,1342156846,0,2,11342
44,4980,3644,1342156846,1342156906,0,2,60
44,4981,253,1342167915,1342167975,0,1,60
44,4982,253,1342243613,1342246489,0,2,2876
44,4982,3662,1342246489,1342246549,0,2,60
44,4983,3652,1342424088,1342424282,0,2,194
44,4983,3638,1342424282,1342424342,0,2,60
44,4984,315,1342490535,1342498439,0,4,7904
44,4984,3669,1342498439,1342502538,0,4,4099
44,4984,3640,1342502538,1342510522,0,4,7984
44,4984,253,1342510522,1342510582,0,4,60
44,4985,3652,1342512502,1342512708,0,2,206
44,4985,3638,1342512708,1342512768,0,2,60
44,4986,3670,1342957190,1342957250,0,1,60
44,4987,253,1343116871,1343116931,0,1,60
44,4988,253,1343551645,1343554176,0,2,2531
44,4988,3671,1343554176,1343554236,0,2,60
44,4989,2294,1343618694,1343618843,0,5,149
44,4989,3639,1343618843,1343623939,0,5,5096
44,4989,3672,1343623939,1343624645,0,5,706
44,4989,1112,1343624645,1343625765,0,5,1120
44,4989,3642,1343625765,1343625825,0,5,60
44,4990,3358,1343640842,1343651860,0,2,11018
44,4990,3673,1343651860,1343651920,0,2,60
44,4991,3674,1344152364,1344152424,0,1,60
44,4992,3639,1344504001,1344504061,0,1,60
44,4993,3653,1344595117,1344595177,0,1,60
44,4994,336,1345278950,1345279010,0,1,60
44,4995,3675,1350128761,1350128821,0,1,60
44,4996,3642,1351812349,1351812409,0,1,60
44,4997,3676,1351854645,1351857376,0,2,2731
44,4997,3677,1351857376,1351857436,0,2,60
44,4998,403,1352694751,1352696860,0,2,2109
44,4998,3678,1352696860,1352696920,0,2,60
44,4999,3645,1353128283,1353136283,0,3,8000
44,4999,3679,1353136283,1353141785,0,3,5502
44,4999,3680,1353141785,1353141845,0,3,60
