userID,trajID,poiID,startTime,endTime,#photo,trajLen,poiDuration
10007579@N00,1,30,1346844688,1346844688,1,1,0
10012675@N05,2,6,1142731848,1142732445,4,1,597
10012675@N05,3,6,1142916492,1142916492,1,1,0
10012675@N05,4,13,1319327174,1319332848,9,1,5674
10014440@N06,5,24,1196128621,1196128878,3,1,257
10014440@N06,6,23,1198051767,1198052832,12,1,1065
10014440@N06,7,23,1198627025,1198627598,5,1,573
10014440@N06,8,23,1206164087,1206165702,10,2,1615
10014440@N06,8,24,1206168673,1206170032,16,2,1359
10014440@N06,9,24,1214890166,1214890462,6,1,296
10014440@N06,10,25,1215592158,1215600149,82,1,7991
10014440@N06,11,17,1220231631,1220263113,283,1,31482
10014440@N06,12,24,1221900500,1221900536,3,1,36
10014440@N06,13,23,1222562726,1222563147,2,1,421
10014440@N06,14,24,1223185528,1223185867,6,1,339
10014440@N06,15,4,1296787058,1296787058,1,1,0
10014440@N06,16,24,1298829412,1298829412,1,1,0
10031363@N00,17,7,1117944001,1117944085,4,1,84
10031363@N00,18,22,1136768686,1136768686,1,1,0
10031363@N00,19,21,1146572943,1146572943,1,1,0
10031363@N00,20,25,1151017445,1151017445,1,1,0
10031363@N00,21,3,1168261752,1168261752,1,1,0
10031363@N00,22,21,1176558895,1176558895,1,1,0
10031363@N00,23,25,1193743477,1193743477,1,1,0
10116041@N02,24,22,1316434915,1316434915,1,1,0
10116041@N02,25,22,1316517548,1316517548,1,1,0
10116041@N02,26,22,1317177127,1317177127,1,1,0
10125851@N06,27,11,1288144203,1288144203,1,1,0
10125851@N06,28,21,1361575441,1361575441,1,1,0
101330524@N02,29,25,1221651765,1221651765,1,1,0
101607720@N06,30,30,1364183074,1364183114,3,1,40
10218635@N06,31,26,1300499814,1300499814,1,1,0
10218635@N06,32,23,1327067338,1327067338,1,1,0
10218635@N06,33,21,1361155807,1361155807,2,2,0
10218635@N06,33,25,1361158664,1361162713,2,2,4049
10282509@N00,34,30,1235274222,1235274222,1,1,0
10282509@N00,35,11,1395549706,1395551517,11,1,1811
10285309@N08,36,1,1281783875,1281795556,8,1,11681
10297518@N00,37,11,1372302213,1372311245,2,1,9032
10316646@N07,38,6,1379577453,1379577453,1,1,0
10316646@N07,39,22,1382225714,1382225714,1,1,0
10316646@N07,40,6,1383644442,1383644442,1,1,0
10316646@N07,41,6,1383899070,1383899205,2,1,135
10316646@N07,42,6,1384205119,1384205119,1,1,0
10316646@N07,43,23,1384501186,1384501186,1,1,0
10316646@N07,44,6,1384601670,1384601670,1,1,0
10316646@N07,45,6,1384684946,1384684946,1,1,0
10316646@N07,46,3,1394077414,1394077414,1,1,0
10397950@N05,47,16,1197782986,1197782986,1,1,0
10438912@N07,48,13,1318218173,1318218173,1,1,0
10438912@N07,49,22,1326853744,1326853744,1,1,0
10438912@N07,50,11,1329529298,1329529298,1,1,0
10442345@N07,51,6,1263978711,1263978711,1,1,0
10483331@N00,52,7,1277172576,1277172576,1,1,0
10488448@N00,53,25,1225188527,1225188527,1,1,0
10488448@N00,54,25,1239890400,1239890400,2,1,0
10488448@N00,55,25,1248600075,1248600075,1,1,0
10488855@N00,56,28,1380847008,1380847372,2,1,364
10502709@N05,57,7,1180696282,1180702766,7,1,6484
10502709@N05,58,7,1180745959,1180751261,3,3,5302
10502709@N05,58,11,1180762851,1180762851,1,3,0
10502709@N05,58,27,1180764267,1180764509,2,3,242
10502709@N05,59,11,1180812368,1180812474,3,2,106
10502709@N05,59,27,1180812942,1180814296,8,2,1354
10502709@N05,60,7,1180869592,1180873331,11,1,3739
10502709@N05,61,7,1180970899,1180970899,1,1,0
10502709@N05,62,11,1195019281,1195022329,7,1,3048
10502709@N05,63,21,1196072277,1196072277,1,1,0
10502709@N05,64,25,1199617917,1199617917,1,1,0
10502709@N05,65,25,1200558479,1200558479,1,1,0
10502709@N05,66,21,1202295248,1202296359,3,1,1111
10502709@N05,67,22,1211647414,1211649578,3,3,2164
10502709@N05,67,23,1211641612,1211646745,5,3,5133
10502709@N05,67,28,1211634164,1211651552,4,3,17388
10502709@N05,68,21,1245923243,1245923243,1,1,0
10502709@N05,69,7,1251252536,1251257966,32,1,5430
10502709@N05,70,21,1254556987,1254566583,2,1,9596
10502709@N05,71,21,1255754920,1255754920,1,4,0
10502709@N05,71,22,1255753089,1255753089,1,4,0
10502709@N05,71,23,1255754148,1255754148,1,4,0
10502709@N05,71,28,1255753362,1255753697,3,4,335
10502709@N05,72,27,1275722248,1275722248,1,1,0
10502709@N05,73,25,1278132432,1278148208,4,1,15776
10502709@N05,74,27,1278735804,1278740426,6,1,4622
10502709@N05,75,6,1280045552,1280045552,1,2,0
10502709@N05,75,25,1280034591,1280038977,19,2,4386
10504927@N08,76,23,1372884918,1372884918,1,1,0
10517457@N04,77,12,1215220255,1215221421,13,1,1166
10563628@N04,78,16,1119257993,1119260570,7,1,2577
10575698@N02,79,25,1317507816,1317511370,24,1,3554
10575698@N02,80,13,1352288471,1352288471,1,1,0
10575698@N02,81,13,1352442667,1352442667,1,1,0
10575698@N02,82,21,1356932945,1356932945,1,1,0
10575698@N02,83,13,1362197896,1362204065,13,1,6169
10575698@N02,84,30,1362783809,1362783809,1,1,0
10575698@N02,85,28,1367032017,1367032017,1,1,0
10575698@N02,86,27,1369454954,1369454954,1,1,0
10575698@N02,87,28,1370679140,1370679140,1,1,0
10575698@N02,88,24,1370767529,1370767529,1,1,0
10602166@N06,89,11,1350950124,1350967515,4,1,17391
10602166@N06,90,30,1351033156,1351033156,1,1,0
10627620@N06,91,27,1180149996,1180150007,2,1,11
10627620@N06,92,21,1220689693,1220689744,8,1,51
10627620@N06,93,28,1256386348,1256386348,1,1,0
10627620@N06,94,11,1274660608,1274661138,3,1,530
10627620@N06,95,21,1277191377,1277191377,1,1,0
10627620@N06,96,21,1288928262,1288928262,1,1,0
10627620@N06,97,8,1320763952,1320764615,151,1,663
10627620@N06,98,3,1322875579,1322878568,27,1,2989
10627620@N06,99,3,1331605212,1331605212,1,3,0
10627620@N06,99,23,1331610248,1331610377,2,3,129
10627620@N06,99,27,1331612583,1331612583,1,3,0
10627620@N06,100,21,1332543210,1332543396,4,3,186
10627620@N06,100,23,1332546123,1332546308,2,3,185
10627620@N06,100,30,1332553614,1332556920,25,3,3306
10627620@N06,101,6,1333504966,1333504966,1,1,0
10627620@N06,102,23,1333922515,1333922585,2,2,70
10627620@N06,102,30,1333930354,1333930354,1,2,0
10627620@N06,103,7,1335066198,1335066632,4,2,434
10627620@N06,103,30,1335065858,1335067358,7,2,1500
10627620@N06,104,23,1335652379,1335652379,1,2,0
10627620@N06,104,30,1335653410,1335673404,59,2,19994
10627620@N06,105,21,1336614578,1336614578,1,2,0
10627620@N06,105,30,1336609219,1336609219,1,2,0
10627620@N06,106,30,1336730190,1336730211,2,1,21
10627620@N06,107,30,1336874413,1336874413,1,1,0
10627620@N06,108,7,1338083147,1338083199,3,1,52
10627620@N06,109,25,1340341213,1340341505,3,1,292
10627620@N06,110,7,1343546753,1343546767,2,1,14
10627620@N06,111,1,1344047684,1344049407,25,2,1723
10627620@N06,111,30,1344047320,1344047505,3,2,185
10627620@N06,112,30,1345789395,1345790139,5,1,744
10627620@N06,113,7,1346500090,1346500175,4,2,85
10627620@N06,113,30,1346499139,1346500262,3,2,1123
10647023@N04,114,20,1367819743,1367819743,1,1,0
10789562@N08,115,1,1327123816,1327123816,1,1,0
10789562@N08,116,4,1338613741,1338613741,1,1,0
10789562@N08,117,17,1345204454,1345204454,1,1,0
10789562@N08,118,30,1349948601,1349949337,2,1,736
10789562@N08,119,8,1357196978,1357196978,1,1,0
10789562@N08,120,1,1358806253,1358806253,1,1,0
10789562@N08,121,30,1360276518,1360276699,2,1,181
10789562@N08,122,4,1366104244,1366104244,1,1,0
10789562@N08,123,8,1366147272,1366147272,1,1,0
10789562@N08,124,1,1367382115,1367382115,1,1,0
10789562@N08,125,7,1375234591,1375236381,2,1,1790
10789562@N08,126,22,1377044846,1377045110,2,1,264
10789562@N08,127,8,1378281875,1378281875,1,1,0
10789562@N08,128,11,1385813481,1385813481,1,1,0
10859651@N06,129,7,1237761258,1237761273,3,1,15
10891813@N04,130,28,1283243042,1283243608,2,1,566
11036650@N00,131,15,1249263619,1249265452,2,1,1833
11036650@N00,132,13,1249344360,1249344582,4,1,222
11090433@N05,133,18,1207201884,1207201884,1,1,0
11090433@N05,134,3,1214566807,1214582660,6,1,15853
11090433@N05,135,3,1214634858,1214634858,1,1,0
11090433@N05,136,3,1214668014,1214668491,5,1,477
11090433@N05,137,15,1217227389,1217227409,2,1,20
11090433@N05,138,7,1219401654,1219401684,2,1,30
11090433@N05,139,3,1223126698,1223126959,6,4,261
11090433@N05,139,22,1223129228,1223170932,8,4,41704
11090433@N05,139,23,1223128760,1223128905,5,4,145
11090433@N05,139,30,1223140871,1223162520,10,4,21649
11090433@N05,140,17,1242543612,1242543612,1,1,0
11090433@N05,141,10,1244955430,1244957432,10,1,2002
11090433@N05,142,3,1246033190,1246033214,2,1,24
11090433@N05,143,3,1246170400,1246184831,3,1,14431
11090433@N05,144,14,1252130443,1252130443,1,1,0
11090433@N05,145,3,1256995257,1256995257,1,1,0
11090433@N05,146,1,1263783828,1263783828,1,1,0
11090433@N05,147,3,1278132745,1278132784,2,1,39
11090433@N05,148,3,1278233666,1278233666,1,1,0
11090433@N05,149,2,1283229134,1283229261,2,2,127
11090433@N05,149,17,1283231960,1283231960,1,2,0
11191102@N07,150,28,1300259639,1300259639,1,1,0
11191102@N07,151,13,1316838416,1316838416,1,1,0
11191102@N07,152,22,1317476700,1317476700,1,1,0
11191102@N07,153,16,1325830531,1325830531,1,1,0
11191102@N07,154,18,1331442068,1331442068,1,1,0
11191102@N07,155,4,1359157949,1359157949,1,3,0
11191102@N07,155,16,1359156533,1359157638,5,3,1105
11191102@N07,155,22,1359177182,1359177573,2,3,391
11191102@N07,156,6,1364456719,1364457017,2,1,298
11191102@N07,157,11,1369454965,1369454965,1,3,0
11191102@N07,157,23,1369453726,1369453726,1,3,0
11191102@N07,157,27,1369445048,1369460177,7,3,15129
11191102@N07,158,1,1376121221,1376121221,1,2,0
11191102@N07,158,15,1376099461,1376100028,2,2,567
11191102@N07,159,7,1376362594,1376362594,1,1,0
11191102@N07,160,13,1376566497,1376566497,1,1,0
11191102@N07,161,16,1377225369,1377225369,1,1,0
11191102@N07,162,7,1387003156,1387003795,6,3,639
11191102@N07,162,22,1387007295,1387008510,3,3,1215
11191102@N07,162,30,1387004413,1387004413,1,3,0
11191102@N07,163,23,1388973233,1388973255,2,1,22
11191102@N07,164,11,1392436977,1392437137,2,2,160
11191102@N07,164,29,1392420996,1392422221,4,2,1225
11211909@N00,165,7,1348042674,1348042679,3,1,5
11241023@N03,166,7,1190171771,1190174968,31,3,3197
11241023@N03,166,22,1190180725,1190180739,2,3,14
11241023@N03,166,28,1190181054,1190185237,5,3,4183
11241023@N03,167,22,1197604160,1197604641,11,1,481
11293226@N05,168,19,1346397078,1346397078,1,1,0
11349639@N00,169,4,1148917453,1148917453,1,3,0
11349639@N00,169,16,1148917293,1148917293,1,3,0
11349639@N00,169,30,1148917698,1148917698,1,3,0
11349639@N00,170,8,1148964962,1148964962,1,1,0
11349639@N00,171,22,1149523223,1149523496,3,2,273
11349639@N00,171,28,1149520989,1149523299,2,2,2310
11349639@N00,172,8,1155460279,1155460279,1,1,0
11349639@N00,173,8,1155805990,1155805990,1,1,0
11349639@N00,174,16,1155962139,1155980699,5,1,18560
11349639@N00,175,16,1156057585,1156057585,1,2,0
11349639@N00,175,30,1156041637,1156041637,1,2,0
11393990@N00,176,28,1294439738,1294439738,1,1,0
11405645@N04,177,20,1379741932,1379741932,1,1,0
11451700@N00,178,25,1289637293,1289637293,1,1,0
11463621@N03,179,23,1262054599,1262054599,1,1,0
11463621@N03,180,21,1272437444,1272437444,1,1,0
11463621@N03,181,21,1279704177,1279704177,1,1,0
11463621@N03,182,21,1285149136,1285149136,1,1,0
11463621@N03,183,21,1292407434,1292407434,1,1,0
11463621@N03,184,23,1294122933,1294123461,2,1,528
11463621@N03,185,23,1299052567,1299052567,1,1,0
11463621@N03,186,21,1306031066,1306039786,2,1,8720
11463621@N03,187,22,1310112135,1310112137,4,1,2
11463621@N03,188,23,1317373446,1317373446,1,1,0
11463621@N03,189,27,1322781632,1322781632,1,1,0
11463621@N03,190,28,1324663797,1324663797,1,1,0
11463621@N03,191,23,1360663848,1360663848,1,1,0
11463621@N03,192,21,1369126906,1369126906,1,1,0
11463621@N03,193,25,1370066444,1370069713,2,1,3269
11531843@N07,194,21,1251630045,1251630144,2,1,99
119057835@N05,195,16,1378608699,1378608699,1,1,0
11956371@N07,196,6,1341110572,1341110572,1,1,0
12023006@N05,197,3,1342661858,1342661858,1,2,0
12023006@N05,197,25,1342652767,1342652767,1,2,0
12072678@N00,198,28,1291098874,1291098874,1,1,0
12072678@N00,199,27,1291359876,1291359876,1,1,0
12072678@N00,200,28,1291851861,1291851861,1,1,0
12072678@N00,201,28,1292046974,1292047009,2,1,35
12072678@N00,202,21,1292447752,1292447752,1,1,0
12072678@N00,203,21,1292526757,1292537992,5,1,11235
12072678@N00,204,21,1293925327,1293925327,1,1,0
12072678@N00,205,21,1295223142,1295223142,1,1,0
12072678@N00,206,21,1295824902,1295824902,1,1,0
12072678@N00,207,21,1297037665,1297037665,1,1,0
12072678@N00,208,21,1297796471,1297796471,1,1,0
12072678@N00,209,23,1298758974,1298758974,1,1,0
12072678@N00,210,21,1298920244,1298923640,2,1,3396
12072678@N00,211,21,1299092898,1299097517,3,1,4619
12072678@N00,212,23,1301180776,1301180776,1,1,0
12072678@N00,213,26,1313207528,1313209736,3,1,2208
12072678@N00,214,23,1315372428,1315372428,1,1,0
12072678@N00,215,21,1315707604,1315707604,1,1,0
12072678@N00,216,26,1322524491,1322524555,2,1,64
12072678@N00,217,21,1327187726,1327192056,2,1,4330
12072678@N00,218,1,1343040903,1343040903,1,1,0
12072678@N00,219,7,1347752316,1347752316,1,1,0
12073315@N03,220,6,1313483725,1313483725,1,2,0
12073315@N03,220,23,1313476766,1313476766,1,2,0
12172493@N07,221,23,1195968405,1195974896,2,1,6491
12172493@N07,222,22,1211602330,1211603483,5,1,1153
12172493@N07,223,11,1223619344,1223627891,6,1,8547
12172493@N07,224,23,1248321269,1248322842,5,1,1573
12288823@N07,225,25,1217166638,1217166638,1,1,0
12313953@N03,226,28,1331272994,1331272994,1,1,0
12313953@N03,227,7,1334791485,1334791485,1,1,0
12316147@N05,228,7,1283567423,1283568250,9,1,827
12316147@N05,229,12,1286605743,1286605810,3,1,67
12316147@N05,230,8,1298250460,1298253382,37,2,2922
12316147@N05,230,16,1298248542,1298253444,35,2,4902
12316147@N05,231,8,1299965590,1299965590,1,1,0
12316147@N05,232,2,1313890763,1313893203,5,2,2440
12316147@N05,232,14,1313889272,1313890263,11,2,991
12316147@N05,233,6,1325636102,1325636409,14,1,307
12316147@N05,234,2,1346487728,1346489373,9,1,1645
12316147@N05,235,7,1357006039,1357010561,12,1,4522
12316147@N05,236,8,1361150454,1361153705,64,2,3251
12316147@N05,236,16,1361143922,1361148499,50,2,4577
12323473@N00,237,22,1109131865,1109131965,2,1,100
12369809@N07,238,24,1186923898,1186923898,1,1,0
12369809@N07,239,21,1187008143,1187011670,3,2,3527
12369809@N07,239,23,1187011450,1187011450,1,2,0
12369809@N07,240,11,1187070090,1187076810,3,1,6720
12422456@N07,241,21,1239378603,1239378603,1,1,0
12422456@N07,242,21,1239525220,1239525220,1,1,0
12422456@N07,243,1,1239618379,1239618379,1,1,0
12445963@N00,244,28,1339404794,1339404794,1,1,0
12445963@N00,245,16,1340186716,1340187037,2,1,321
12518297@N00,246,3,1157427378,1157427408,2,2,30
12518297@N00,246,22,1157442911,1157442911,1,2,0
12518297@N00,247,3,1157528520,1157545168,2,1,16648
12518297@N00,248,11,1157597584,1157597584,1,1,0
12544530@N06,249,1,1302959688,1302959695,2,1,7
12544530@N06,250,4,1376190577,1376197061,4,1,6484
12602671@N04,251,25,1347526940,1347526940,1,1,0
12602671@N04,252,23,1347593433,1347593433,1,1,0
12641532@N00,253,11,1280108852,1280109024,3,2,172
12641532@N00,253,24,1280095118,1280096626,5,2,1508
12659736@N02,254,22,1353391279,1353391430,4,2,151
12659736@N02,254,28,1353391105,1353391105,1,2,0
12693197@N06,255,16,1178415575,1178417549,4,1,1974
12693966@N07,256,7,1310443922,1310444239,2,2,317
12693966@N07,256,16,1310444267,1310454508,77,2,10241
12693966@N07,257,3,1334158268,1334159846,21,1,1578
12693966@N07,258,4,1354348982,1354349448,2,1,466
12693966@N07,259,4,1366360439,1366362694,5,1,2255
12693966@N07,260,4,1374929932,1374947129,100,1,17197
12693966@N07,261,4,1374977437,1374987968,4,1,10531
12829633@N05,262,13,1218713092,1218713092,1,2,0
12829633@N05,262,16,1218702177,1218710721,70,2,8544
12859363@N04,263,16,1202574621,1202574621,1,1,0
12874594@N08,264,6,1242540032,1242542819,4,1,2787
12874594@N08,265,30,1245394874,1245395026,2,1,152
12874594@N08,266,30,1304664200,1304664200,1,1,0
12874594@N08,267,21,1377406913,1377406913,1,2,0
12874594@N08,267,23,1377412795,1377415686,2,2,2891
12925338@N07,268,12,1221956376,1221956376,1,1,0
12925338@N07,269,12,1273020618,1273020618,1,1,0
12925338@N07,270,23,1386590964,1386590964,1,2,0
12925338@N07,270,28,1386589023,1386589328,2,2,305
12982516@N02,271,16,778341600,778341600,6,2,0
12982516@N02,271,28,778341600,778341600,1,2,0
13094294@N00,272,16,1189340841,1189340841,1,1,0
13094294@N00,273,16,1189418690,1189418690,1,1,0
13113559@N00,274,21,1153031873,1153031941,2,1,68
13113559@N00,275,21,1160880120,1160880120,1,1,0
13113559@N00,276,21,1163921781,1163922142,3,1,361
13113559@N00,277,21,1166940753,1166940753,2,1,0
13113559@N00,278,21,1167161621,1167161621,1,1,0
13113559@N00,279,21,1170558524,1170558524,1,1,0
13113559@N00,280,21,1170625135,1170625687,3,1,552
13113559@N00,281,22,1250071325,1250071325,1,1,0
13113559@N00,282,16,1315251925,1315251925,1,1,0
13119082@N03,283,16,1314924875,1314924875,1,1,0
13127232@N00,284,11,1210558764,1210558909,3,1,145
13145059@N07,285,16,1224638841,1224638841,1,1,0
13195134@N00,286,25,1185696518,1185696518,1,1,0
13237887@N02,287,7,1371604386,1371604386,1,1,0
13273343@N00,288,8,1116654998,1116654998,1,3,0
13273343@N00,288,16,1116653308,1116653308,1,3,0
13273343@N00,288,30,1116646263,1116646263,1,3,0
13411198@N00,289,1,1299151587,1299152466,3,2,879
13411198@N00,289,8,1299153612,1299153612,1,2,0
13411198@N00,290,1,1360332286,1360332286,1,1,0
13453601@N03,291,11,1191074915,1191079204,3,2,4289
13453601@N03,291,27,1191091214,1191091372,2,2,158
13511601@N00,292,25,1154241190,1154241549,2,1,359
13528098@N00,293,30,1395990419,1395992354,2,1,1935
13528098@N00,294,8,1396057588,1396057588,1,3,0
13528098@N00,294,16,1396057333,1396058111,2,3,778
13528098@N00,294,30,1396074369,1396077252,2,3,2883
13613374@N00,295,16,1329728017,1329730500,4,1,2483
13639989@N00,296,21,1334845216,1334845216,1,1,0
13639989@N00,297,21,1354773179,1354773179,1,1,0
13644648@N03,298,1,1371517315,1371517315,1,13,0
13644648@N03,298,4,1371519708,1371519708,2,13,0
13644648@N03,298,6,1371518365,1371518365,1,13,0
13644648@N03,298,7,1371514471,1371514472,2,13,1
13644648@N03,298,8,1371517748,1371520749,2,13,3001
13644648@N03,298,11,1371519010,1371519010,1,13,0
13644648@N03,298,16,1371519708,1371519708,1,13,0
13644648@N03,298,22,1371514467,1371519707,3,13,5240
13644648@N03,298,23,1371516913,1371518368,2,13,1455
13644648@N03,298,24,1371519010,1371519010,1,13,0
13644648@N03,298,28,1371516914,1371518366,5,13,1452
13644648@N03,298,29,1371517318,1371519707,3,13,2389
13644648@N03,298,30,1371517318,1371520751,6,13,3433
13661433@N00,299,23,1121761204,1121761204,1,1,0
13668544@N03,300,11,1182330289,1182330536,2,1,247
13672753@N00,301,14,1314677364,1314677364,1,2,0
13672753@N00,301,17,1314687660,1314692882,5,2,5222
13672753@N00,302,4,1314785488,1314785488,1,4,0
13672753@N00,302,8,1314778187,1314778424,3,4,237
13672753@N00,302,16,1314778737,1314782009,5,4,3272
13672753@N00,302,22,1314790680,1314790758,3,4,78
13672753@N00,303,8,1317027848,1317027848,1,1,0
13785615@N00,304,12,1280275038,1280275812,4,1,774
13785615@N00,305,12,1281484662,1281484662,1,1,0
13794832@N00,306,16,1299904366,1299904366,1,1,0
13833167@N00,307,11,1296203584,1296217915,13,1,14331
13833167@N00,308,6,1297930837,1297930837,1,1,0
13833167@N00,309,11,1299230072,1299237985,34,1,7913
13833167@N00,310,28,1333574566,1333579387,9,1,4821
13833167@N00,311,21,1351146991,1351157803,9,1,10812
13837307@N05,312,13,1266029739,1266036751,5,1,7012
13907834@N00,313,16,1172235600,1172235601,9,1,1
13907834@N00,314,16,1203133611,1203140129,18,1,6518
13907834@N00,315,4,1266621284,1266621284,1,3,0
13907834@N00,315,8,1266628019,1266628674,9,3,655
13907834@N00,315,16,1266621257,1266629053,75,3,7796
13907834@N00,316,11,1268635781,1268635938,2,3,157
13907834@N00,316,21,1268634484,1268634484,1,3,0
13907834@N00,316,27,1268635612,1268635848,3,3,236
13907834@N00,317,12,1271547378,1271560477,80,1,13099
13907834@N00,318,27,1274322367,1274322367,1,1,0
13907834@N00,319,21,1285414114,1285414114,1,1,0
13907834@N00,320,16,1298103569,1298113580,167,1,10011
13907834@N00,321,16,1298244206,1298250898,59,1,6692
13907834@N00,322,20,1306562864,1306562864,1,1,0
13907834@N00,323,7,1306645706,1306645706,1,1,0
13907834@N00,324,20,1319233465,1319233465,1,1,0
13907834@N00,325,20,1329521919,1329521919,1,1,0
13907834@N00,326,20,1339884792,1339884792,1,1,0
13907834@N00,327,26,1350698187,1350698187,1,1,0
13918219@N00,328,11,1189845142,1189845970,2,1,828
13941015@N02,329,21,1373722034,1373722034,1,2,0
13941015@N02,329,24,1373711043,1373715960,13,2,4917
14036428@N00,330,6,1369037365,1369037365,1,1,0
14036428@N00,331,22,1369093520,1369093520,1,1,0
14036428@N00,332,6,1376713917,1376713917,1,1,0
14036428@N00,333,6,1376798935,1376798935,1,1,0
14036428@N00,334,8,1377838970,1377838970,1,1,0
14036428@N00,335,6,1378436074,1378436074,1,1,0
14036428@N00,336,15,1380249505,1380249644,5,2,139
14036428@N00,336,19,1380247289,1380249042,16,2,1753
14036428@N00,337,28,1380969395,1380969395,1,1,0
14036428@N00,338,22,1381035062,1381035062,1,1,0
14036428@N00,339,25,1382927184,1382927184,1,1,0
14036428@N00,340,7,1386439866,1386439866,1,1,0
14036428@N00,341,11,1387064922,1387078704,10,1,13782
14036428@N00,342,11,1387143298,1387170490,3,1,27192
14036428@N00,343,11,1387222031,1387249332,2,1,27301
14036428@N00,344,11,1387390567,1387390567,1,1,0
14036428@N00,345,11,1387563845,1387568046,2,1,4201
14036428@N00,346,10,1388099926,1388109936,30,1,10010
14036428@N00,347,10,1388170432,1388198282,4,1,27850
14036428@N00,348,10,1388255163,1388255163,1,1,0
14036428@N00,349,22,1388355812,1388355812,1,1,0
14036428@N00,350,11,1388520732,1388520732,1,1,0
14036428@N00,351,11,1388977629,1388977629,1,1,0
14036428@N00,352,11,1389204100,1389204100,1,1,0
14036428@N00,353,6,1390528895,1390528895,1,1,0
14036428@N00,354,8,1390631986,1390631986,1,1,0
14036428@N00,355,8,1390663242,1390698974,4,1,35732
14036428@N00,356,8,1390778569,1390805210,4,1,26641
14036428@N00,357,11,1391145922,1391145922,1,1,0
14036428@N00,358,11,1391279062,1391302586,2,1,23524
14036428@N00,359,16,1391548570,1391548570,1,1,0
14036428@N00,360,25,1391729608,1391729608,1,1,0
14036428@N00,361,25,1391790692,1391790692,1,1,0
14036428@N00,362,10,1393122530,1393122530,1,1,0
14107738@N07,363,16,1272026855,1272026855,1,1,0
14112399@N00,364,27,1162352588,1162352671,3,1,83
14112399@N00,365,27,1162422043,1162422240,2,1,197
14125170@N02,366,25,1344311060,1344313678,9,1,2618
14146962@N07,367,16,1092889323,1092899222,5,1,9899
14351900@N00,368,8,1161315946,1161315946,1,1,0
14351900@N00,369,21,1267342123,1267342123,1,1,0
14351900@N00,370,25,1306901463,1306901463,1,1,0
14351900@N00,371,7,1322852612,1322852612,1,1,0
14351900@N00,372,20,1334959066,1334959066,1,1,0
14351900@N00,373,7,1338442906,1338442985,2,1,79
14351900@N00,374,6,1342839000,1342845773,2,1,6773
14351900@N00,375,25,1347702525,1347702933,6,1,408
14351900@N00,376,7,1351309104,1351309262,2,1,158
14391210@N00,377,30,1206882467,1206882467,1,1,0
14391210@N00,378,23,1220675045,1220677266,4,1,2221
14391210@N00,379,6,1223120674,1223121003,3,3,329
14391210@N00,379,22,1223116536,1223117527,25,3,991
14391210@N00,379,30,1223115278,1223115278,1,3,0
14391210@N00,380,22,1224310452,1224310452,1,4,0
14391210@N00,380,23,1224312515,1224312597,6,4,82
14391210@N00,380,28,1224311436,1224311455,2,4,19
14391210@N00,380,30,1224292838,1224292838,1,4,0
14421071@N00,381,13,1377521654,1377521654,1,1,0
14423848@N00,382,22,1086046200,1086046200,1,2,0
14423848@N00,382,28,1086046500,1086046500,1,2,0
14423848@N00,383,7,1086418800,1086418800,1,1,0
14617133@N05,384,22,1319307733,1319310807,25,2,3074
14617133@N05,384,28,1319309497,1319310807,16,2,1310
14678786@N00,385,21,1235175981,1235199426,24,1,23445
14678786@N00,386,3,1307454938,1307454938,1,2,0
14678786@N00,386,21,1307441772,1307449544,13,2,7772
14718163@N08,387,21,1198915200,1198915200,1,1,0
14718163@N08,388,13,1199172600,1199172900,2,1,300
14718163@N08,389,22,1204587000,1204587900,2,1,900
14718163@N08,390,21,1209740400,1209740400,3,1,0
14718163@N08,391,11,1210573800,1210573800,1,1,0
14718163@N08,392,27,1211605200,1211605200,2,1,0
14718163@N08,393,27,1212685225,1212685225,1,1,0
14718163@N08,394,4,1214452645,1214452645,1,1,0
14718163@N08,395,21,1217300345,1217300345,1,1,0
14718163@N08,396,21,1218696300,1218696300,1,1,0
14718163@N08,397,22,1221978385,1221978644,2,1,259
14718163@N08,398,27,1223737200,1223737200,1,1,0
14718163@N08,399,27,1233414900,1233414900,1,1,0
14718163@N08,400,27,1235183636,1235183636,1,1,0
14718163@N08,401,22,1245991884,1245991884,1,1,0
14718163@N08,402,27,1248428184,1248428184,1,1,0
14718163@N08,403,30,1249896709,1249896709,1,1,0
14718163@N08,404,21,1283000492,1283000492,1,2,0
14718163@N08,404,25,1283001997,1283001997,1,2,0
14718163@N08,405,24,1283677751,1283678131,2,2,380
14718163@N08,405,27,1283675595,1283675595,1,2,0
14718163@N08,406,21,1283963494,1283963494,1,1,0
14718163@N08,407,27,1284236406,1284236406,1,1,0
14718163@N08,408,16,1287732300,1287732300,1,1,0
14718163@N08,409,22,1301958445,1301979449,3,1,21004
14718163@N08,410,22,1302576472,1302576472,1,2,0
14718163@N08,410,27,1302578840,1302578840,1,2,0
14718163@N08,411,13,1322542254,1322542254,1,1,0
14718163@N08,412,30,1324975622,1324975622,1,1,0
14718163@N08,413,28,1325073370,1325073370,1,1,0
14718163@N08,414,16,1350787664,1350787664,1,1,0
14743391@N04,415,7,1304471881,1304471881,1,1,0
14743391@N04,416,7,1304504354,1304504354,1,1,0
14750766@N02,417,16,1274009943,1274009943,1,2,0
14750766@N02,417,23,1274007381,1274007381,1,2,0
14750766@N02,418,16,1275144180,1275144180,1,1,0
14750766@N02,419,28,1284979985,1284979985,1,1,0
14750766@N02,420,22,1286019563,1286019563,1,1,0
14750766@N02,421,28,1289639626,1289639626,1,1,0
14750766@N02,422,23,1290070500,1290072265,3,1,1765
14750766@N02,423,16,1299484013,1299486118,6,1,2105
14750766@N02,424,11,1301800430,1301800920,3,1,490
14750766@N02,425,12,1304830251,1304830251,1,1,0
14750766@N02,426,12,1308380539,1308380539,1,1,0
14750766@N02,427,15,1308456780,1308476169,2,1,19389
14750766@N02,428,28,1317465134,1317465134,1,1,0
14750766@N02,429,20,1318051635,1318051635,1,1,0
14750766@N02,430,12,1318219313,1318219355,2,1,42
14816925@N00,431,23,1287063294,1287064164,2,1,870
14816925@N00,432,21,1290650624,1290655796,3,1,5172
14816925@N00,433,16,1296118310,1296143806,12,1,25496
14816925@N00,434,6,1302245901,1302252457,2,1,6556
14816925@N00,435,21,1315642655,1315642655,1,1,0
14816925@N00,436,22,1336000025,1336000025,1,1,0
14816925@N00,437,22,1339556562,1339556562,1,1,0
14816925@N00,438,22,1345804121,1345804121,1,1,0
14816925@N00,439,23,1364031283,1364036362,6,1,5079
14816925@N00,440,8,1377055999,1377055999,1,1,0
14816925@N00,441,1,1380878461,1380880978,3,1,2517
14816925@N00,442,28,1392092117,1392092117,1,1,0
14816925@N00,443,7,1396081320,1396081320,1,1,0
14853721@N00,444,16,1228803028,1228803375,4,1,347
14853721@N00,445,13,1229749962,1229750558,9,1,596
14853721@N00,446,7,1235531333,1235532030,4,2,697
14853721@N00,446,30,1235532320,1235532320,1,2,0
14853721@N00,447,29,1243055727,1243055759,2,1,32
14864718@N02,448,21,1236929281,1236929281,1,2,0
14864718@N02,448,23,1236927456,1236927456,1,2,0
14864718@N02,449,28,1296009372,1296009380,4,1,8
14864718@N02,450,22,1296122164,1296123736,2,1,1572
14871980@N05,451,22,1355003345,1355003355,2,1,10
14878709@N00,452,16,1213682230,1213682230,1,1,0
14878709@N00,453,16,1221334608,1221352960,28,3,18352
14878709@N00,453,23,1221334000,1221334000,1,3,0
14878709@N00,453,28,1221334134,1221354769,4,3,20635
14878709@N00,454,8,1347004906,1347015456,7,7,10550
14878709@N00,454,16,1347001647,1347015624,47,7,13977
14878709@N00,454,21,1347002520,1347002677,2,7,157
14878709@N00,454,22,1347017055,1347017055,1,7,0
14878709@N00,454,23,1347002832,1347019719,6,7,16887
14878709@N00,454,27,1347025523,1347025555,2,7,32
14878709@N00,454,28,1347016943,1347017384,6,7,441
14878709@N00,455,16,1347960610,1347960610,1,1,0
14934133@N00,456,8,1359581662,1359581662,1,1,0
14954127@N00,457,25,1238545893,1238545893,1,1,0
14954127@N00,458,25,1251621063,1251621063,1,1,0
14954127@N00,459,11,1264742867,1264742867,1,2,0
14954127@N00,459,25,1264732874,1264742121,4,2,9247
14954127@N00,460,25,1265084637,1265084654,2,1,17
14954127@N00,461,25,1265241190,1265241190,1,1,0
14954127@N00,462,25,1271319374,1271319374,1,1,0
14954127@N00,463,29,1277732159,1277732159,1,1,0
14954127@N00,464,21,1321679830,1321679830,1,1,0
14972286@N00,465,3,536119200,536119220,21,1,20
14972286@N00,466,3,1349610990,1349612714,5,1,1724
14993164@N00,467,19,1090653157,1090653157,1,1,0
15056061@N00,468,7,1160443387,1160444529,2,1,1142
15205252@N00,469,22,1307777330,1307777330,1,1,0
15205252@N00,470,6,1314852190,1314852271,2,2,81
15205252@N00,470,22,1314847990,1314847990,1,2,0
15205252@N00,471,6,1345613742,1345613762,2,1,20
15205252@N00,472,2,1346487419,1346487459,2,3,40
15205252@N00,472,14,1346495559,1346496308,8,3,749
15205252@N00,472,17,1346479507,1346479507,1,3,0
15249769@N00,473,23,1254184449,1254184449,1,1,0
15249769@N00,474,23,1308645657,1308645657,1,1,0
15268840@N08,475,25,1199590569,1199590698,89,1,129
15268840@N08,476,22,1337767951,1337767951,1,1,0
15273063@N00,477,16,1270808295,1270808295,1,1,0
15273063@N00,478,30,1270860717,1270860799,3,1,82
15345244@N00,479,21,1235175981,1235175981,1,1,0
15345244@N00,480,25,1263004512,1263004512,1,1,0
15345244@N00,481,25,1263075069,1263075069,1,1,0
15345244@N00,482,21,1361674126,1361674209,3,1,83
15351091@N07,483,21,1195887909,1195887909,1,1,0
15511507@N00,484,1,1297259901,1297265450,3,1,5549
15511507@N00,485,1,1297346447,1297350132,3,1,3685
15511507@N00,486,23,1297501526,1297501526,1,1,0
15563028@N05,487,1,1326966339,1326966339,1,1,0
15563028@N05,488,4,1344740761,1344740761,1,1,0
15580384@N05,489,30,1296887225,1296903638,19,1,16413
15580384@N05,490,30,1296937782,1296937782,1,1,0
15588970@N02,491,4,1303202943,1303215493,2,1,12550
15588970@N02,492,4,1304174201,1304174201,1,1,0
15609463@N03,493,7,1323479084,1323479084,1,2,0
15609463@N03,493,30,1323480969,1323481402,2,2,433
15609463@N03,494,7,1323517148,1323517550,2,2,402
15609463@N03,494,30,1323518925,1323518925,1,2,0
15609463@N03,495,7,1361520052,1361520052,1,1,0
15609463@N03,496,29,1367017584,1367024614,19,1,7030
15609463@N03,497,21,1367133670,1367135397,2,2,1727
15609463@N03,497,25,1367113936,1367113936,1,2,0
15609463@N03,498,21,1367202393,1367202393,1,1,0
15609463@N03,499,21,1367234916,1367234916,1,1,0
15609463@N03,500,23,1393670807,1393670807,1,1,0
15609463@N03,501,21,1393726118,1393726118,1,1,0
15743963@N08,502,8,1314498879,1314505157,9,1,6278
15805806@N08,503,30,1309585737,1309585737,1,1,0
15901111@N00,504,25,1185631200,1185631209,7,1,9
15925704@N00,505,3,1022853600,1022853600,1,1,0
15925704@N00,506,24,1120971523,1120982827,3,1,11304
15925704@N00,507,28,1139016739,1139016739,1,1,0
15925704@N00,508,6,1142043466,1142046410,5,1,2944
15925704@N00,509,22,1146567204,1146567204,1,1,0
16048448@N00,510,7,1184815990,1184815990,1,8,0
16048448@N00,510,16,1184816860,1184820507,18,8,3647
16048448@N00,510,21,1184827314,1184827323,2,8,9
16048448@N00,510,22,1184805380,1184805665,3,8,285
16048448@N00,510,23,1184806322,1184806322,1,8,0
16048448@N00,510,28,1184804839,1184805080,5,8,241
16048448@N00,510,29,1184808595,1184808995,3,8,400
16048448@N00,510,30,1184816013,1184816013,1,8,0
16073996@N00,511,13,1206151198,1206158153,23,1,6955
16125685@N04,512,7,1203679643,1203680796,5,2,1153
16125685@N04,512,21,1203685717,1203687144,3,2,1427
16125685@N04,513,21,1203763175,1203770051,6,2,6876
16125685@N04,513,23,1203753849,1203753997,7,2,148
16326397@N02,514,4,1213884968,1213885224,2,2,256
16326397@N02,514,16,1213860624,1213891948,3,2,31324
16326397@N02,515,11,1213966481,1213972499,7,3,6018
16326397@N02,515,16,1213949534,1213957572,29,3,8038
16326397@N02,515,23,1213977573,1213977573,1,3,0
16326397@N02,516,8,1214042920,1214042920,1,2,0
16326397@N02,516,21,1214058393,1214060081,2,2,1688
16326397@N02,517,4,1214317962,1214318136,2,2,174
16326397@N02,517,8,1214305596,1214305824,3,2,228
16478858@N00,518,21,1178271821,1178271821,1,1,0
16478858@N00,519,30,1180147740,1180152005,4,1,4265
16503481@N04,520,16,1284362843,1284369311,4,1,6468
16503481@N04,521,21,1284538262,1284541717,3,1,3455
16503481@N04,522,21,1284577448,1284577448,1,1,0
16693950@N00,523,16,1241192016,1241192161,2,3,145
16693950@N00,523,22,1241194763,1241194763,1,3,0
16693950@N00,523,23,1241194866,1241194866,1,3,0
16693950@N00,524,15,1339116618,1339118321,4,3,1703
16693950@N00,524,19,1339113045,1339119461,3,3,6416
16693950@N00,524,25,1339108548,1339108548,1,3,0
16693950@N00,525,7,1340089362,1340090186,10,8,824
16693950@N00,525,8,1340083282,1340090206,2,8,6924
16693950@N00,525,16,1340090227,1340090264,2,8,37
16693950@N00,525,21,1340089808,1340103471,8,8,13663
16693950@N00,525,22,1340083266,1340089675,2,8,6409
16693950@N00,525,23,1340089735,1340089788,3,8,53
16693950@N00,525,28,1340089510,1340089700,6,8,190
16693950@N00,525,30,1340083600,1340090650,9,8,7050
16846345@N07,526,8,1219388180,1219402964,66,1,14784
16846345@N07,527,8,1219452399,1219495901,57,1,43502
16846345@N07,528,8,1219548587,1219558547,61,1,9960
16846345@N07,529,8,1251441608,1251455459,11,1,13851
16846345@N07,530,8,1251511905,1251529163,33,1,17258
16846345@N07,531,8,1251595135,1251615277,18,1,20142
16846345@N07,532,16,1282898951,1282901758,5,1,2807
16846345@N07,533,8,1282987921,1282993698,72,2,5777
16846345@N07,533,16,1282954984,1282994284,37,2,39300
16846345@N07,534,16,1283044803,1283060738,4,1,15935
16846345@N07,535,21,1315380328,1315380328,1,1,0
16926694@N06,536,28,1262143868,1262143868,1,1,0
16926694@N06,537,13,1262489443,1262494316,10,2,4873
16926694@N06,537,28,1262500072,1262500072,1,2,0
16926694@N06,538,11,1268038795,1268038795,1,1,0
16926694@N06,539,11,1282895177,1282904307,14,1,9130
16926694@N06,540,11,1287448113,1287448113,1,1,0
16926694@N06,541,11,1302155729,1302155729,1,1,0
16926694@N06,542,13,1303875517,1303875528,2,1,11
16926694@N06,543,13,1361162601,1361164852,4,1,2251
16926694@N06,544,7,1362023190,1362027321,12,3,4131
16926694@N06,544,8,1362024471,1362025417,5,3,946
16926694@N06,544,30,1362024130,1362024161,3,3,31
17123407@N00,545,4,1312452728,1312452728,1,1,0
17304462@N00,546,22,1201920865,1201920865,1,1,0
17304462@N00,547,28,1254574854,1254574854,1,1,0
17304462@N00,548,21,1267346619,1267346777,3,1,158
17373191@N00,549,1,1372747884,1372750857,3,5,2973
17373191@N00,549,8,1372758599,1372758599,1,5,0
17373191@N00,549,21,1372764005,1372764005,1,5,0
17373191@N00,549,22,1372723949,1372766276,8,5,42327
17373191@N00,549,28,1372766056,1372766056,1,5,0
17373191@N00,550,1,1372819267,1372848597,4,2,29330
17373191@N00,550,21,1372826334,1372826334,1,2,0
17373191@N00,551,1,1372906734,1372906734,1,2,0
17373191@N00,551,22,1372925243,1372928446,7,2,3203
17373191@N00,552,1,1373023837,1373023837,1,1,0
17373191@N00,553,22,1373149420,1373149420,1,1,0
17447763@N08,554,25,1392882086,1392882086,1,1,0
17559979@N00,555,22,1285481413,1285481413,1,2,0
17559979@N00,555,30,1285490186,1285490304,2,2,118
17559979@N00,556,28,1365564284,1365564284,1,1,0
17593639@N08,557,21,934084800,934088400,2,1,3600
17643132@N00,558,11,1259124111,1259128127,65,1,4016
17643382@N00,559,23,1196069914,1196069914,1,1,0
17643382@N00,560,24,1201336574,1201337556,2,1,982
17643382@N00,561,22,1201947267,1201949178,5,1,1911
17643382@N00,562,22,1202011959,1202015114,21,1,3155
17643382@N00,563,21,1208667649,1208667649,1,1,0
17643382@N00,564,21,1223134768,1223135166,3,2,398
17643382@N00,564,23,1223134361,1223134435,2,2,74
17643382@N00,565,22,1233457739,1233458870,12,1,1131
17643382@N00,566,22,1233908030,1233910366,12,1,2336
17643382@N00,567,24,1246442741,1246447944,2,1,5203
17728973@N00,568,7,1113649898,1113649898,1,1,0
17728973@N00,569,24,1156569763,1156569795,4,1,32
17728973@N00,570,21,1167391881,1167392449,3,1,568
17728973@N00,571,9,1199587500,1199588400,36,1,900
17728973@N00,572,9,1232851594,1232853162,31,1,1568
17728973@N00,573,9,1250654393,1250655241,25,1,848
17759914@N00,574,6,1291696685,1291696685,1,1,0
17759914@N00,575,25,1292962402,1292962402,1,1,0
17759914@N00,576,23,1296288843,1296288843,1,1,0
17759914@N00,577,6,1301043897,1301043897,1,1,0
17759914@N00,578,21,1302325801,1302325801,1,2,0
17759914@N00,578,22,1302325620,1302325620,1,2,0
17759914@N00,579,25,1306126829,1306126829,1,1,0
17759914@N00,580,24,1306393425,1306393425,1,1,0
17759914@N00,581,6,1307176143,1307176143,1,1,0
17759914@N00,582,22,1310100021,1310100021,1,1,0
17759914@N00,583,11,1313892357,1313899255,2,2,6898
17759914@N00,583,25,1313892300,1313892300,1,2,0
17759914@N00,584,22,1314004775,1314004775,1,1,0
17759914@N00,585,11,1316726133,1316726133,1,1,0
17759914@N00,586,2,1330582748,1330587490,4,1,4742
17759914@N00,587,2,1330831555,1330831555,1,1,0
17759914@N00,588,6,1336196018,1336196018,1,1,0
17759914@N00,589,28,1336541465,1336541465,1,1,0
17759914@N00,590,22,1341721705,1341721705,1,1,0
17759914@N00,591,4,1342841291,1342844862,2,2,3571
17759914@N00,591,21,1342836721,1342836721,1,2,0
17759914@N00,592,25,1347014322,1347014322,1,1,0
17759914@N00,593,6,1348907063,1348910961,2,1,3898
17759914@N00,594,6,1353644004,1353644614,2,1,610
17759914@N00,595,22,1354419229,1354419229,1,1,0
17759914@N00,596,22,1372136843,1372140998,2,1,4155
17759914@N00,597,21,1380272645,1380272645,1,1,0
17759914@N00,598,22,1380549600,1380549600,3,1,0
17759914@N00,599,6,1381884488,1381884488,1,1,0
17759914@N00,600,22,1383691585,1383691585,1,1,0
17856604@N00,601,20,1369163257,1369163257,1,2,0
17856604@N00,601,24,1369153137,1369153619,3,2,482
17856604@N00,602,6,1369255889,1369257167,3,2,1278
17856604@N00,602,23,1369245021,1369250173,2,2,5152
17886387@N00,603,28,1295586214,1295586214,1,1,0
18091121@N00,604,27,1265412759,1265412759,1,1,0
18091121@N00,605,27,1308464457,1308464457,1,1,0
18091121@N00,606,27,1308636930,1308636930,1,1,0
18091121@N00,607,27,1349487743,1349493495,3,1,5752
18222776@N00,608,16,1244872837,1244876005,4,2,3168
18222776@N00,608,22,1244870060,1244870400,4,2,340
18222776@N00,609,22,1244968503,1244968503,1,2,0
18222776@N00,609,28,1244968155,1244968251,2,2,96
18378305@N00,610,7,1289702514,1289702514,1,1,0
18378305@N00,611,23,1330829380,1330829380,1,1,0
18378305@N00,612,7,1340525475,1340525532,2,1,57
18378305@N00,613,11,1353754716,1353754716,1,1,0
18378305@N00,614,24,1353858309,1353862302,4,1,3993
18378305@N00,615,28,1363481382,1363481617,6,1,235
18378655@N00,616,23,1258711016,1258711323,2,1,307
18383768@N00,617,16,1153960934,1153964618,10,2,3684
18383768@N00,617,25,1153950679,1153955400,5,2,4721
18412989@N00,618,16,1182486586,1182490059,17,1,3473
18412989@N00,619,16,1213450346,1213450352,3,3,6
18412989@N00,619,22,1213450100,1213450124,2,3,24
18412989@N00,619,23,1213449952,1213449952,1,3,0
18412989@N00,620,22,1262146278,1262146714,7,1,436
18412989@N00,621,23,1262254542,1262254726,2,1,184
18412989@N00,622,16,1270205451,1270205554,2,1,103
18412989@N00,623,21,1270290444,1270290444,1,3,0
18412989@N00,623,23,1270291031,1270291949,2,3,918
18412989@N00,623,24,1270294625,1270294917,5,3,292
18412989@N00,624,1,1370510760,1370524979,46,3,14219
18412989@N00,624,7,1370498907,1370498907,1,3,0
18412989@N00,624,23,1370504681,1370508737,2,3,4056
18412989@N00,625,21,1377923654,1377933203,8,1,9549
18432549@N00,626,22,1350624737,1350645464,7,1,20727
18432549@N00,627,22,1350694738,1350714878,9,1,20140
18484540@N00,628,27,1374043542,1374043542,1,1,0
18484540@N00,629,16,1374125220,1374125220,1,1,0
18532235@N00,630,6,1349949271,1349949271,1,1,0
18532235@N00,631,21,1355638609,1355638640,2,2,31
18532235@N00,631,22,1355638570,1355638570,1,2,0
18597872@N04,632,21,1367033648,1367033648,1,1,0
18728817@N00,633,29,1159071278,1159071278,1,1,0
18948547@N00,634,22,1197094279,1197102807,4,3,8528
18948547@N00,634,23,1197095381,1197095381,1,3,0
18948547@N00,634,28,1197094831,1197098972,2,3,4141
18948547@N00,635,6,1270038149,1270038149,1,1,0
18948547@N00,636,30,1320825016,1320833185,6,1,8169
18948547@N00,637,25,1325913544,1325913544,1,1,0
18948547@N00,638,4,1331858748,1331872288,8,1,13540
18948547@N00,639,1,1332486245,1332489768,4,1,3523
18948547@N00,640,30,1332551566,1332551566,1,1,0
18948547@N00,641,30,1332622380,1332622394,2,1,14
18948547@N00,642,23,1347188032,1347188032,1,1,0
18948547@N00,643,23,1347270529,1347279574,2,1,9045
18948547@N00,644,23,1353049287,1353049287,1,1,0
18983894@N00,645,11,1164699066,1164699066,1,2,0
18983894@N00,645,27,1164711894,1164711895,4,2,1
18983894@N00,646,11,1168427676,1168427676,2,1,0
18983894@N00,647,11,1169208095,1169208095,1,1,0
18983894@N00,648,11,1170996260,1170996260,1,1,0
18983894@N00,649,11,1171364309,1171364309,5,1,0
18983894@N00,650,11,1172661067,1172661067,3,1,0
18983894@N00,651,25,1178362412,1178362413,6,1,1
18983894@N00,652,27,1183987098,1183987100,3,1,2
18983894@N00,653,22,1186834888,1186834888,1,1,0
18983894@N00,654,11,1187528200,1187528724,62,1,524
18983894@N00,655,25,1222509420,1222509420,1,1,0
18983894@N00,656,25,1244373769,1244373769,1,1,0
19511310@N00,657,22,1380969433,1380969433,1,1,0
19611789@N00,658,22,1349762365,1349762385,2,1,20
19611789@N00,659,1,1349905395,1349910322,2,2,4927
19611789@N00,659,7,1349905072,1349905072,1,2,0
19611789@N00,660,7,1358805821,1358805821,1,1,0
19611789@N00,661,1,1361491792,1361491792,1,1,0
19614198@N00,662,22,1363338086,1363338086,1,1,0
19614198@N00,663,21,1390532535,1390532535,1,1,0
19614198@N00,664,7,1393130198,1393130373,3,2,175
19614198@N00,664,30,1393131270,1393131270,1,2,0
19720483@N04,665,26,1387489033,1387495919,3,1,6886
19761391@N06,666,29,1297996159,1297996224,2,1,65
19761391@N06,667,16,1298417854,1298425222,33,1,7368
19761391@N06,668,22,1306547312,1306547312,1,2,0
19761391@N06,668,23,1306549425,1306549425,1,2,0
19761391@N06,669,23,1306628337,1306644047,5,1,15710
19761391@N06,670,13,1333876572,1333876572,1,1,0
19761391@N06,671,11,1335607083,1335607083,1,1,0
19763323@N00,672,8,1025403275,1025403275,1,2,0
19763323@N00,672,16,1025421830,1025421830,1,2,0
19987278@N00,673,8,1359461046,1359461046,1,1,0
20025990@N00,674,4,1154882203,1154882234,5,1,31
20075574@N00,675,6,1247268480,1247271900,4,3,3420
20075574@N00,675,22,1247262960,1247265060,4,3,2100
20075574@N00,675,25,1247269560,1247270040,3,3,480
20138806@N00,676,11,1249710910,1249710992,2,1,82
20169331@N00,677,17,1279247212,1279253329,62,1,6117
20275330@N00,678,23,1113900340,1113902436,13,1,2096
20324540@N00,679,16,1339832982,1339835308,2,1,2326
20342758@N00,680,28,1311941764,1311941764,1,1,0
20342758@N00,681,4,1312003305,1312003305,1,7,0
20342758@N00,681,8,1312003398,1312008158,7,7,4760
20342758@N00,681,16,1311984140,1312008338,2,7,24198
20342758@N00,681,23,1311981888,1311981936,2,7,48
20342758@N00,681,24,1311990381,1312009422,3,7,19041
20342758@N00,681,28,1311982214,1311982214,1,7,0
20342758@N00,681,30,1312003597,1312003597,1,7,0
20342758@N00,682,24,1313220420,1313220420,1,1,0
20344209@N00,683,13,1157418856,1157425751,17,3,6895
20344209@N00,683,16,1157430153,1157433350,4,3,3197
20344209@N00,683,29,1157437391,1157437391,1,3,0
20371069@N00,684,21,1309437055,1309437055,1,1,0
20408296@N00,685,11,954242339,954242339,1,1,0
20456447@N03,686,1,1337322965,1337324886,3,7,1921
20456447@N03,686,7,1337322054,1337322464,4,7,410
20456447@N03,686,8,1337323752,1337323752,1,7,0
20456447@N03,686,16,1337323885,1337324144,4,7,259
20456447@N03,686,21,1337329653,1337329653,1,7,0
20456447@N03,686,22,1337320924,1337321115,3,7,191
20456447@N03,686,30,1337321815,1337321866,2,7,51
20456447@N03,687,4,1337388117,1337401397,49,4,13280
20456447@N03,687,7,1337381658,1337383412,17,4,1754
20456447@N03,687,8,1337389296,1337389361,2,4,65
20456447@N03,687,16,1337387676,1337424914,20,4,37238
20456447@N03,688,3,1337468776,1337468776,1,4,0
20456447@N03,688,6,1337471653,1337471653,1,4,0
20456447@N03,688,22,1337472762,1337477708,2,4,4946
20456447@N03,688,29,1337470153,1337470153,1,4,0
20532289@N00,689,11,1139638965,1139638965,1,1,0
20532289@N00,690,24,1148709234,1148719348,5,1,10114
20532289@N00,691,21,1151244011,1151244011,1,2,0
20532289@N00,691,23,1151243493,1151243493,1,2,0
20532289@N00,692,23,1152267930,1152267930,1,2,0
20532289@N00,692,28,1152268199,1152268199,1,2,0
20532289@N00,693,18,1154093230,1154099946,3,1,6716
20532289@N00,694,27,1156239171,1156239171,1,1,0
20532289@N00,695,27,1189466396,1189468176,2,1,1780
20605823@N00,696,22,1166426878,1166428723,4,1,1845
20605823@N00,697,11,1168585975,1168596137,14,1,10162
20624342@N00,698,21,1222165038,1222165038,1,1,0
20634971@N00,699,7,1155867975,1155867975,1,1,0
20675126@N00,700,17,1376790314,1376814958,13,1,24644
20675795@N00,701,7,1136276140,1136278765,58,1,2625
20688578@N00,702,30,1218294866,1218295050,4,1,184
20688578@N00,703,7,1218329429,1218339212,14,1,9783
20705618@N00,704,16,1370137526,1370137526,1,1,0
20741443@N00,705,21,1102497585,1102497585,1,1,0
20741443@N00,706,21,1148728680,1148728680,1,1,0
20741443@N00,707,23,1157100774,1157110776,38,1,10002
20741443@N00,708,7,1160213392,1160224452,4,5,11060
20741443@N00,708,21,1160215990,1160216293,3,5,303
20741443@N00,708,23,1160214708,1160215087,3,5,379
20741443@N00,708,28,1160214879,1160214879,1,5,0
20741443@N00,708,30,1160222055,1160222178,2,5,123
20741443@N00,709,21,1165039651,1165042537,2,1,2886
20741443@N00,710,21,1166777002,1166777014,2,2,12
20741443@N00,710,23,1166773442,1166775618,19,2,2176
20741443@N00,711,7,1170499869,1170500077,2,2,208
20741443@N00,711,22,1170502239,1170503334,5,2,1095
20741443@N00,712,7,1170541310,1170548979,7,3,7669
20741443@N00,712,23,1170550446,1170558000,2,3,7554
20741443@N00,712,30,1170549887,1170549893,2,3,6
20741443@N00,713,21,1183121640,1183122076,2,1,436
20741443@N00,714,2,1187771111,1187783880,2,1,12769
20741443@N00,715,21,1190532525,1190535813,14,1,3288
20741443@N00,716,1,1199448606,1199448606,1,3,0
20741443@N00,716,7,1199448522,1199448522,1,3,0
20741443@N00,716,21,1199442900,1199447710,7,3,4810
20741443@N00,717,21,1214047233,1214047233,1,1,0
20741443@N00,718,7,1215862418,1215862418,1,2,0
20741443@N00,718,13,1215841045,1215841045,1,2,0
20741443@N00,719,7,1224146049,1224156743,9,1,10694
20741443@N00,720,21,1226737578,1226745300,5,2,7722
20741443@N00,720,28,1226735505,1226735895,2,2,390
20741443@N00,721,6,1237091943,1237098673,8,1,6730
20741443@N00,722,7,1237169658,1237169658,1,3,0
20741443@N00,722,22,1237178011,1237182264,2,3,4253
20741443@N00,722,23,1237181691,1237181691,1,3,0
20741443@N00,723,21,1237607700,1237608971,4,2,1271
20741443@N00,723,22,1237610280,1237610280,1,2,0
20741443@N00,724,7,1239709278,1239709278,1,1,0
20741443@N00,725,21,1240115803,1240117440,4,1,1637
20741443@N00,726,11,1244890863,1244891112,3,2,249
20741443@N00,726,21,1244899515,1244899892,2,2,377
20741443@N00,727,6,1250510955,1250511551,2,2,596
20741443@N00,727,22,1250509740,1250509740,1,2,0
20741443@N00,728,21,1252231620,1252231620,1,1,0
20741443@N00,729,7,1254593982,1254595052,8,5,1070
20741443@N00,729,21,1254587761,1254587761,1,5,0
20741443@N00,729,22,1254590376,1254592286,18,5,1910
20741443@N00,729,23,1254585127,1254599331,7,5,14204
20741443@N00,729,28,1254596104,1254596104,1,5,0
20741443@N00,730,7,1256196535,1256198822,4,3,2287
20741443@N00,730,23,1256205722,1256205722,1,3,0
20741443@N00,730,28,1256201747,1256201821,2,3,74
20741443@N00,731,21,1256450532,1256450532,1,3,0
20741443@N00,731,22,1256451358,1256451407,2,3,49
20741443@N00,731,23,1256450876,1256450876,1,3,0
20741443@N00,732,21,1259922198,1259926209,5,1,4011
20741443@N00,733,21,1260943135,1260953721,7,2,10586
20741443@N00,733,23,1260935725,1260945413,4,2,9688
20741443@N00,734,21,1262180963,1262180963,1,1,0
20741443@N00,735,16,1266723762,1266736599,3,1,12837
20741443@N00,736,21,1269420000,1269420780,2,1,780
20741443@N00,737,21,1270539497,1270542802,4,2,3305
20741443@N00,737,23,1270531363,1270531363,1,2,0
20741443@N00,738,6,1271835143,1271836061,2,1,918
20741443@N00,739,21,1273826528,1273828525,2,2,1997
20741443@N00,739,28,1273822680,1273822680,1,2,0
20741443@N00,740,6,1275381900,1275382014,3,2,114
20741443@N00,740,21,1275376698,1275376704,2,2,6
20741443@N00,741,21,1275650775,1275656589,6,2,5814
20741443@N00,741,23,1275655667,1275655667,1,2,0
20741443@N00,742,30,1276069168,1276069168,1,1,0
20741443@N00,743,21,1276861224,1276863834,4,1,2610
20741443@N00,744,21,1277280500,1277280559,2,3,59
20741443@N00,744,28,1277253989,1277253989,1,3,0
20741443@N00,744,30,1277282689,1277282803,2,3,114
20741443@N00,745,6,1277890081,1277890081,1,3,0
20741443@N00,745,21,1277883455,1277883455,1,3,0
20741443@N00,745,30,1277882120,1277882120,1,3,0
20741443@N00,746,30,1278330642,1278330642,1,1,0
20741443@N00,747,21,1278986958,1278987778,2,1,820
20741443@N00,748,30,1279061681,1279082045,2,1,20364
20741443@N00,749,7,1279248082,1279248082,1,2,0
20741443@N00,749,28,1279266186,1279266186,1,2,0
20741443@N00,750,7,1279509738,1279509738,1,1,0
20741443@N00,751,30,1279609209,1279609209,1,1,0
20741443@N00,752,28,1279679556,1279679556,1,1,0
20741443@N00,753,7,1279769351,1279769351,1,4,0
20741443@N00,753,23,1279767710,1279768320,3,4,610
20741443@N00,753,28,1279767219,1279767219,1,4,0
20741443@N00,753,30,1279764861,1279764861,1,4,0
20741443@N00,754,30,1280209206,1280209206,1,1,0
20741443@N00,755,21,1280305313,1280305313,1,2,0
20741443@N00,755,28,1280305602,1280305602,1,2,0
20741443@N00,756,7,1280458383,1280460739,4,2,2356
20741443@N00,756,30,1280460926,1280460926,1,2,0
20741443@N00,757,21,1280663491,1280663491,1,1,0
20741443@N00,758,1,1280801636,1280801636,1,2,0
20741443@N00,758,30,1280801323,1280804336,2,2,3013
20741443@N00,759,30,1280913272,1280919370,6,1,6098
20741443@N00,760,16,1281079563,1281079563,1,1,0
20741443@N00,761,11,1281169019,1281169019,1,2,0
20741443@N00,761,21,1281172200,1281176571,2,2,4371
20741443@N00,762,7,1281321273,1281321273,1,1,0
20741443@N00,763,21,1281666535,1281666535,1,3,0
20741443@N00,763,23,1281666402,1281666402,1,3,0
20741443@N00,763,28,1281666140,1281666140,1,3,0
20741443@N00,764,7,1282013768,1282036656,3,1,22888
20741443@N00,765,7,1282288130,1282288332,3,2,202
20741443@N00,765,30,1282287712,1282287712,1,2,0
20741443@N00,766,30,1282702001,1282702201,4,1,200
20741443@N00,767,22,1282792983,1282793178,3,1,195
20741443@N00,768,7,1282875869,1282899062,2,2,23193
20741443@N00,768,30,1282875707,1282875707,1,2,0
20741443@N00,769,21,1283254947,1283254947,1,1,0
20741443@N00,770,27,1283688688,1283689072,2,1,384
20741443@N00,771,22,1283828424,1283828689,3,1,265
20741443@N00,772,30,1283929686,1283929835,2,1,149
20741443@N00,773,7,1283998372,1283998372,1,1,0
20741443@N00,774,30,1284073712,1284073712,1,1,0
20741443@N00,775,21,1284107612,1284107612,1,3,0
20741443@N00,775,22,1284104807,1284104886,2,3,79
20741443@N00,775,30,1284108660,1284108660,1,3,0
20741443@N00,776,7,1284362505,1284362670,2,1,165
20741443@N00,777,30,1284534972,1284534972,1,1,0
20741443@N00,778,7,1284621772,1284622331,3,3,559
20741443@N00,778,28,1284623583,1284623583,1,3,0
20741443@N00,778,30,1284624606,1284624762,3,3,156
20741443@N00,779,7,1284709824,1284710318,4,1,494
20741443@N00,780,30,1284937889,1284937889,1,1,0
20741443@N00,781,30,1284966768,1284966768,1,1,0
20741443@N00,782,7,1285039770,1285056314,13,2,16544
20741443@N00,782,30,1285054050,1285054050,1,2,0
20741443@N00,783,7,1285231106,1285231617,2,5,511
20741443@N00,783,21,1285234741,1285244771,3,5,10030
20741443@N00,783,22,1285247001,1285248830,4,5,1829
20741443@N00,783,23,1285245851,1285245851,1,5,0
20741443@N00,783,30,1285231852,1285231852,1,5,0
20741443@N00,784,7,1285553975,1285556271,6,1,2296
20741443@N00,785,30,1285640587,1285640607,2,1,20
20741443@N00,786,7,1285812617,1285838619,5,4,26002
20741443@N00,786,21,1285814040,1285814851,8,4,811
20741443@N00,786,23,1285813611,1285813611,1,4,0
20741443@N00,786,28,1285815544,1285815544,1,4,0
20741443@N00,787,30,1285923064,1285923064,1,1,0
20741443@N00,788,11,1286043922,1286045600,13,5,1678
20741443@N00,788,21,1286039243,1286039354,2,5,111
20741443@N00,788,22,1286046544,1286048513,5,5,1969
20741443@N00,788,23,1286038421,1286038421,1,5,0
20741443@N00,788,28,1286038037,1286038037,1,5,0
20741443@N00,789,23,1286245929,1286245929,1,1,0
20741443@N00,790,21,1286415060,1286415941,7,3,881
20741443@N00,790,23,1286414838,1286414838,1,3,0
20741443@N00,790,28,1286414565,1286414565,1,3,0
20741443@N00,791,30,1286519523,1286519523,1,1,0
20741443@N00,792,30,1286956142,1286956200,2,1,58
20741443@N00,793,7,1287383477,1287383477,1,1,0
20741443@N00,794,7,1287540834,1287558014,2,1,17180
20741443@N00,795,28,1287991567,1287992471,6,1,904
20741443@N00,796,30,1288076127,1288076127,1,1,0
20741443@N00,797,16,1288162702,1288162702,1,2,0
20741443@N00,797,30,1288154401,1288154401,1,2,0
20741443@N00,798,22,1288349737,1288349737,1,1,0
20741443@N00,799,7,1288747800,1288751824,10,2,4024
20741443@N00,799,30,1288749600,1288749600,1,2,0
20741443@N00,800,7,1288939713,1288939713,1,2,0
20741443@N00,800,30,1288921398,1288940687,2,2,19289
20741443@N00,801,7,1289197409,1289197409,1,2,0
20741443@N00,801,30,1289197710,1289198141,2,2,431
20741443@N00,802,30,1289354480,1289354480,1,1,0
20741443@N00,803,30,1289441572,1289441572,1,1,0
20741443@N00,804,7,1289544171,1289544171,1,2,0
20741443@N00,804,30,1289525325,1289531585,10,2,6260
20741443@N00,805,30,1289858652,1289858652,1,1,0
20741443@N00,806,30,1289974585,1289974585,1,1,0
20741443@N00,807,7,1290062330,1290062432,2,3,102
20741443@N00,807,22,1290045350,1290045883,6,3,533
20741443@N00,807,30,1290032031,1290063261,2,3,31230
20741443@N00,808,30,1290147480,1290147480,1,1,0
20741443@N00,809,7,1290391838,1290422809,7,5,30971
20741443@N00,809,21,1290417377,1290421042,6,5,3665
20741443@N00,809,23,1290419388,1290422138,9,5,2750
20741443@N00,809,28,1290422480,1290422480,1,5,0
20741443@N00,809,30,1290407222,1290407222,1,5,0
20741443@N00,810,30,1290579289,1290579289,1,1,0
20741443@N00,811,1,1290651377,1290651377,1,1,0
20741443@N00,812,21,1290739362,1290739362,1,2,0
20741443@N00,812,28,1290736498,1290736498,1,2,0
20741443@N00,813,8,1290982087,1290982087,1,4,0
20741443@N00,813,23,1291017302,1291017302,1,4,0
20741443@N00,813,28,1291013786,1291013786,1,4,0
20741443@N00,813,30,1290995948,1290995948,1,4,0
20741443@N00,814,7,1291079790,1291079790,1,4,0
20741443@N00,814,23,1291080816,1291081961,2,4,1145
20741443@N00,814,28,1291080539,1291080539,1,4,0
20741443@N00,814,30,1291069792,1291098305,4,4,28513
20741443@N00,815,7,1291168260,1291168506,2,2,246
20741443@N00,815,30,1291154953,1291168798,2,2,13845
20741443@N00,816,23,1291341600,1291341600,3,3,0
20741443@N00,816,28,1291341600,1291341600,3,3,0
20741443@N00,816,30,1291341600,1291357480,4,3,15880
20741443@N00,817,30,1291616006,1291616006,1,1,0
20741443@N00,818,30,1291846022,1291846022,1,1,0
20741443@N00,819,30,1291875531,1291875531,1,1,0
20741443@N00,820,7,1292568399,1292569037,3,2,638
20741443@N00,820,30,1292551806,1292568051,5,2,16245
20741443@N00,821,22,1292810400,1292810400,1,3,0
20741443@N00,821,23,1292809957,1292810071,2,3,114
20741443@N00,821,28,1292810214,1292810214,1,3,0
20741443@N00,822,7,1292896800,1292896800,2,4,0
20741443@N00,822,23,1292896800,1292896800,1,4,0
20741443@N00,822,28,1292896800,1292915700,2,4,18900
20741443@N00,822,30,1292915700,1292915700,1,4,0
20741443@N00,823,21,1292999734,1292999742,2,2,8
20741443@N00,823,23,1292983219,1292983230,2,2,11
20741443@N00,824,21,1293597621,1293606793,6,2,9172
20741443@N00,824,23,1293598511,1293606522,3,2,8011
20741443@N00,825,22,1293780371,1293782632,9,3,2261
20741443@N00,825,23,1293770424,1293775096,3,3,4672
20741443@N00,825,28,1293783437,1293785533,6,3,2096
20741443@N00,826,21,1294019215,1294019798,3,1,583
20741443@N00,827,28,1294725819,1294725819,1,1,0
20741443@N00,828,30,1294784450,1294793347,2,1,8897
20741443@N00,829,23,1294883641,1294883641,1,1,0
20741443@N00,830,7,1294972203,1294972203,1,2,0
20741443@N00,830,23,1294987092,1294987092,1,2,0
20741443@N00,831,30,1295216666,1295216666,1,1,0
20741443@N00,832,30,1295832443,1295832580,2,1,137
20741443@N00,833,30,1296111699,1296111699,1,1,0
20741443@N00,834,23,1296438249,1296438449,3,1,200
20741443@N00,835,7,1296538057,1296538057,1,1,0
20741443@N00,836,7,1296714329,1296714593,3,2,264
20741443@N00,836,30,1296714167,1296714222,2,2,55
20741443@N00,837,23,1297044442,1297044580,2,1,138
20741443@N00,838,23,1297407971,1297407971,1,2,0
20741443@N00,838,30,1297410715,1297410715,1,2,0
20741443@N00,839,7,1297923691,1297923763,2,2,72
20741443@N00,839,30,1297905358,1297905358,1,2,0
20741443@N00,840,28,1297990927,1297995411,2,1,4484
20741443@N00,841,16,1298182020,1298187161,3,1,5141
20741443@N00,842,7,1298424720,1298424720,1,1,0
20741443@N00,843,16,1298623028,1298630140,2,3,7112
20741443@N00,843,23,1298601354,1298601354,1,3,0
20741443@N00,843,30,1298632398,1298632398,1,3,0
20741443@N00,844,21,1298943260,1298943260,1,1,0
20741443@N00,845,7,1299221261,1299221261,1,1,0
20741443@N00,846,7,1299635536,1299635536,1,2,0
20741443@N00,846,23,1299650483,1299650483,1,2,0
20741443@N00,847,7,1299739623,1299740224,4,1,601
20741443@N00,848,7,1300066207,1300066207,1,2,0
20741443@N00,848,30,1300086364,1300086490,2,2,126
20741443@N00,849,8,1300153402,1300153402,1,1,0
20741443@N00,850,30,1300265267,1300265267,1,1,0
20741443@N00,851,23,1300326619,1300326619,1,1,0
20741443@N00,852,1,1300399775,1300430511,2,3,30736
20741443@N00,852,7,1300429533,1300429533,1,3,0
20741443@N00,852,30,1300428275,1300430132,3,3,1857
20741443@N00,853,7,1300614278,1300614278,1,1,0
20741443@N00,854,23,1300759031,1300759031,1,1,0
20741443@N00,855,7,1300861313,1300861895,3,1,582
20741443@N00,856,23,1301017732,1301019586,5,1,1854
20741443@N00,857,21,1301364351,1301364449,2,1,98
20741443@N00,858,30,1301458613,1301458613,1,1,0
20741443@N00,859,30,1301639690,1301639690,1,1,0
20741443@N00,860,21,1301734902,1301736939,13,1,2037
20741443@N00,861,7,1302143787,1302143812,2,1,25
20741443@N00,862,7,1303368305,1303377178,3,2,8873
20741443@N00,862,21,1303375793,1303375793,1,2,0
20741443@N00,863,30,1303888687,1303888834,2,1,147
20741443@N00,864,7,1303959600,1303977600,4,2,18000
20741443@N00,864,30,1303977600,1303984800,4,2,7200
20741443@N00,865,11,1304149477,1304149580,2,2,103
20741443@N00,865,23,1304157600,1304159244,3,2,1644
20741443@N00,866,28,1304564075,1304564075,1,1,0
20741443@N00,867,7,1304669700,1304669700,1,3,0
20741443@N00,867,8,1304650800,1304650800,3,3,0
20741443@N00,867,30,1304652600,1304668800,4,3,16200
20741443@N00,868,7,1304909861,1304909861,1,1,0
20741443@N00,869,23,1305255600,1305255600,1,2,0
20741443@N00,869,30,1305255600,1305274500,6,2,18900
20741443@N00,870,3,1305791667,1305791667,1,3,0
20741443@N00,870,21,1305794052,1305794163,2,3,111
20741443@N00,870,28,1305789983,1305789983,1,3,0
20741443@N00,871,28,1305860342,1305860342,1,1,0
20741443@N00,872,7,1306495793,1306496082,2,2,289
20741443@N00,872,23,1306478041,1306478041,1,2,0
20741443@N00,873,7,1306654019,1306654200,2,2,181
20741443@N00,873,30,1306660179,1306660179,1,2,0
20741443@N00,874,1,1306828327,1306828351,2,2,24
20741443@N00,874,30,1306828965,1306828965,1,2,0
20741443@N00,875,7,1306912224,1306912262,2,2,38
20741443@N00,875,22,1306898324,1306898324,1,2,0
20741443@N00,876,7,1306985365,1306985365,1,1,0
20741443@N00,877,30,1307072679,1307078089,2,1,5410
20741443@N00,878,6,1307164547,1307164547,1,1,0
20741443@N00,879,7,1308020400,1308022200,6,3,1800
20741443@N00,879,21,1308038400,1308038400,2,3,0
20741443@N00,879,23,1308020400,1308039300,2,3,18900
20741443@N00,880,7,1308108600,1308108600,1,3,0
20741443@N00,880,22,1308108600,1308108600,1,3,0
20741443@N00,880,30,1308125700,1308125700,2,3,0
20741443@N00,881,7,1308279600,1308290646,7,1,11046
20741443@N00,882,28,1308885287,1308885287,1,2,0
20741443@N00,882,30,1308900595,1308900672,2,2,77
20741443@N00,883,21,1309057200,1309076100,3,3,18900
20741443@N00,883,23,1309057200,1309057200,1,3,0
20741443@N00,883,30,1309075200,1309076100,2,3,900
20741443@N00,884,21,1309231800,1309231800,1,4,0
20741443@N00,884,23,1309230000,1309230000,1,4,0
20741443@N00,884,28,1309247649,1309247649,1,4,0
20741443@N00,884,30,1309249620,1309249620,1,4,0
20741443@N00,885,23,1309835334,1309835334,1,2,0
20741443@N00,885,30,1309852193,1309852193,1,2,0
20741443@N00,886,23,1309919969,1309920005,2,2,36
20741443@N00,886,30,1309936319,1309936319,1,2,0
20741443@N00,887,30,1310009563,1310009563,1,1,0
20741443@N00,888,28,1310097101,1310097101,1,1,0
20741443@N00,889,7,1310539716,1310540172,5,1,456
20741443@N00,890,7,1310632328,1310632328,1,1,0
20741443@N00,891,22,1310721168,1310721168,1,1,0
20741443@N00,892,23,1311338035,1311338035,1,1,0
20741443@N00,893,7,1311844443,1311844720,4,1,277
20741443@N00,894,7,1313035605,1313035605,1,2,0
20741443@N00,894,30,1313035354,1313035354,1,2,0
20741443@N00,895,27,1313238467,1313238467,1,1,0
20741443@N00,896,23,1315218600,1315218600,1,1,0
20741443@N00,897,21,1315382454,1315389129,4,1,6675
20741443@N00,898,8,1315623600,1315623600,1,3,0
20741443@N00,898,16,1315639800,1315639800,1,3,0
20741443@N00,898,30,1315623600,1315623600,1,3,0
20741443@N00,899,1,1315970183,1315970183,1,2,0
20741443@N00,899,30,1315969104,1315969104,1,2,0
20741443@N00,900,7,1316249833,1316263880,3,2,14047
20741443@N00,900,19,1316237541,1316246785,4,2,9244
20741443@N00,901,16,1316487600,1316487600,1,1,0
20741443@N00,902,21,1316519759,1316519759,1,2,0
20741443@N00,902,23,1316516454,1316516527,2,2,73
20741443@N00,903,21,1317197700,1317207600,5,2,9900
20741443@N00,903,23,1317197700,1317205864,4,2,8164
20741443@N00,904,22,1317488747,1317488747,1,3,0
20741443@N00,904,23,1317490943,1317492458,2,3,1515
20741443@N00,904,30,1317496078,1317497205,3,3,1127
20741443@N00,905,7,1317952800,1317974400,3,7,21600
20741443@N00,905,11,1317977104,1317977104,1,7,0
20741443@N00,905,21,1317964560,1317964560,1,7,0
20741443@N00,905,22,1317966728,1317966728,1,7,0
20741443@N00,905,23,1317952800,1317971700,27,7,18900
20741443@N00,905,28,1317952800,1317966555,7,7,13755
20741443@N00,905,30,1317962010,1317974400,2,7,12390
20741443@N00,906,23,1319612967,1319612967,1,1,0
20741443@N00,907,11,1319958523,1319961844,5,1,3321
20741443@N00,908,21,1320222286,1320222286,1,2,0
20741443@N00,908,23,1320219769,1320220056,4,2,287
20741443@N00,909,3,1321000474,1321000474,1,2,0
20741443@N00,909,21,1321006063,1321006063,1,2,0
20741443@N00,910,23,1321434272,1321434344,2,1,72
20741443@N00,911,21,1321608108,1321608108,1,3,0
20741443@N00,911,23,1321602784,1321604023,5,3,1239
20741443@N00,911,29,1321583738,1321583738,1,3,0
20741443@N00,912,11,1321867706,1321867892,2,2,186
20741443@N00,912,29,1321868426,1321868426,1,2,0
20741443@N00,913,11,1322813184,1322814677,9,2,1493
20741443@N00,913,29,1322812502,1322812502,1,2,0
20741443@N00,914,21,1323165943,1323166134,2,2,191
20741443@N00,914,23,1323164339,1323164339,1,2,0
20741443@N00,915,1,1323298129,1323298129,1,1,0
20741443@N00,916,21,1324541803,1324542113,2,2,310
20741443@N00,916,23,1324541350,1324541350,1,2,0
20741443@N00,917,21,1324623425,1324628529,2,2,5104
20741443@N00,917,23,1324625025,1324626759,5,2,1734
20741443@N00,918,21,1326270744,1326270744,1,1,0
20741443@N00,919,21,1326356114,1326356209,2,2,95
20741443@N00,919,23,1326355574,1326355574,1,2,0
20741443@N00,920,7,1326518460,1326520163,3,3,1703
20741443@N00,920,21,1326536161,1326536331,2,3,170
20741443@N00,920,30,1326518175,1326526846,2,3,8671
20741443@N00,921,7,1326611049,1326611144,2,2,95
20741443@N00,921,30,1326610626,1326610626,1,2,0
20741443@N00,922,21,1328352033,1328355483,4,2,3450
20741443@N00,922,23,1328337963,1328340695,3,2,2732
20741443@N00,923,7,1328772732,1328774510,8,3,1778
20741443@N00,923,21,1328771164,1328771258,4,3,94
20741443@N00,923,30,1328775305,1328775528,2,3,223
20741443@N00,924,21,1329900976,1329900976,1,1,0
20741443@N00,925,16,1330144608,1330162594,12,1,17986
20741443@N00,926,21,1331019315,1331021152,2,1,1837
20741443@N00,927,6,1331713797,1331713882,2,1,85
20741443@N00,928,21,1331892120,1331894055,2,3,1935
20741443@N00,928,27,1331883907,1331883907,1,3,0
20741443@N00,928,29,1331878951,1331878951,1,3,0
20741443@N00,929,7,1331962051,1331967328,7,4,5277
20741443@N00,929,21,1331978618,1331978618,1,4,0
20741443@N00,929,23,1331984942,1331984942,1,4,0
20741443@N00,929,28,1331983915,1331983981,2,4,66
20741443@N00,930,23,1332314687,1332314687,1,1,0
20741443@N00,931,21,1332921775,1332921775,1,1,0
20741443@N00,932,21,1333530687,1333530690,2,2,3
20741443@N00,932,23,1333532387,1333532558,2,2,171
20741443@N00,933,23,1333959506,1333959506,1,1,0
20741443@N00,934,3,1334135046,1334135046,1,1,0
20741443@N00,935,22,1335524400,1335524400,1,2,0
20741443@N00,935,28,1335524400,1335524400,1,2,0
20741443@N00,936,21,1337760018,1337760018,1,2,0
20741443@N00,936,23,1337760348,1337760578,3,2,230
20741443@N00,937,21,1338801147,1338801147,1,1,0
20741443@N00,938,11,1339244876,1339244876,1,2,0
20741443@N00,938,27,1339239133,1339243802,2,2,4669
20741443@N00,939,21,1339382677,1339382677,1,1,0
20741443@N00,940,16,1339665991,1339665991,1,2,0
20741443@N00,940,21,1339670798,1339670798,1,2,0
20741443@N00,941,21,1341404315,1341407436,2,1,3121
20741443@N00,942,30,1341998629,1341999210,2,1,581
20741443@N00,943,21,1342602562,1342610434,3,2,7872
20741443@N00,943,22,1342611722,1342611722,1,2,0
20741443@N00,944,21,1343379600,1343386800,5,2,7200
20741443@N00,944,23,1343376900,1343386800,4,2,9900
20741443@N00,945,21,1343811946,1343811946,1,2,0
20741443@N00,945,28,1343817716,1343817716,1,2,0
20741443@N00,946,11,1343984629,1343984629,1,1,0
20741443@N00,947,6,1345023091,1345025424,4,1,2333
20741443@N00,948,2,1346572309,1346572309,1,1,0
20741443@N00,949,21,1346920794,1346922439,2,1,1645
20741443@N00,950,11,1347012313,1347012313,1,1,0
20741443@N00,951,25,1347441287,1347443729,5,1,2442
20741443@N00,952,23,1348023216,1348023216,1,1,0
20741443@N00,953,23,1348113584,1348113584,1,1,0
20741443@N00,954,28,1348562266,1348566146,4,1,3880
20741443@N00,955,23,1348630486,1348630502,2,2,16
20741443@N00,955,28,1348629225,1348629225,1,2,0
20741443@N00,956,21,1348948269,1348948989,2,2,720
20741443@N00,956,22,1348942853,1348944628,4,2,1775
20741443@N00,957,21,1349258400,1349258400,1,1,0
20741443@N00,958,11,1350028367,1350028367,1,1,0
20741443@N00,959,11,1352455083,1352461331,6,1,6248
20741443@N00,960,16,1352716377,1352716377,1,1,0
20741443@N00,961,28,1353550867,1353554118,3,1,3251
20741443@N00,962,21,1353655943,1353655943,1,3,0
20741443@N00,962,23,1353656506,1353656506,1,3,0
20741443@N00,962,28,1353656626,1353656626,1,3,0
20741443@N00,963,23,1355904140,1355904355,2,3,215
20741443@N00,963,28,1355903417,1355903417,1,3,0
20741443@N00,963,30,1355901534,1355901534,1,3,0
20741443@N00,964,21,1357715729,1357723470,2,2,7741
20741443@N00,964,23,1357719793,1357719793,1,2,0
20741443@N00,965,7,1358320990,1358320990,1,3,0
20741443@N00,965,21,1358325733,1358325733,1,3,0
20741443@N00,965,30,1358320229,1358320835,4,3,606
20741443@N00,966,21,1359535118,1359535187,2,1,69
20741443@N00,967,30,1361342756,1361351755,6,1,8999
20741443@N00,968,7,1361617161,1361617161,1,1,0
20741443@N00,969,3,1367048657,1367049899,2,3,1242
20741443@N00,969,21,1367045081,1367045081,1,3,0
20741443@N00,969,28,1367043154,1367043154,1,3,0
20741443@N00,970,11,1367402282,1367402282,1,1,0
20741443@N00,971,21,1368277421,1368277724,2,2,303
20741443@N00,971,23,1368276988,1368276988,1,2,0
20741443@N00,972,7,1369812510,1369821808,2,2,9298
20741443@N00,972,30,1369817578,1369817578,1,2,0
20741443@N00,973,11,1370170781,1370170781,1,1,0
20741443@N00,974,7,1371634947,1371635607,3,2,660
20741443@N00,974,22,1371632333,1371633409,4,2,1076
20741443@N00,975,22,1373534018,1373537201,4,1,3183
20741443@N00,976,11,1374394117,1374394117,1,2,0
20741443@N00,976,27,1374409474,1374409474,1,2,0
20741443@N00,977,21,1374665661,1374666182,3,1,521
20741443@N00,978,23,1378978977,1378978977,1,2,0
20741443@N00,978,25,1378966874,1378984405,3,2,17531
20741443@N00,979,7,1380988386,1381007126,2,4,18740
20741443@N00,979,22,1380988826,1380991455,7,4,2629
20741443@N00,979,23,1380992192,1380993132,2,4,940
20741443@N00,979,29,1380996875,1380996875,1,4,0
20741443@N00,980,7,1381476868,1381484969,3,3,8101
20741443@N00,980,24,1381467406,1381475336,4,3,7930
20741443@N00,980,28,1381489726,1381489836,2,3,110
20741443@N00,981,6,1382331835,1382332000,2,2,165
20741443@N00,981,7,1382328062,1382328160,2,2,98
20741443@N00,982,6,1382507329,1382508397,6,2,1068
20741443@N00,982,22,1382518373,1382519258,5,2,885
20741443@N00,983,11,1383632616,1383632727,2,1,111
20741443@N00,984,22,1384419838,1384419942,3,2,104
20741443@N00,984,28,1384419585,1384419585,1,2,0
20741443@N00,985,21,1385696929,1385712544,4,2,15615
20741443@N00,985,23,1385707193,1385707193,1,2,0
20741443@N00,986,16,1392616521,1392616521,1,1,0
20741443@N00,987,7,1394158301,1394185205,5,2,26904
20741443@N00,987,21,1394176867,1394176867,1,2,0
20741443@N00,988,7,1394520794,1394520981,3,4,187
20741443@N00,988,23,1394524544,1394524544,1,4,0
20741443@N00,988,24,1394501818,1394502263,2,4,445
20741443@N00,988,28,1394529396,1394529396,1,4,0
20741443@N00,989,7,1395122845,1395122845,1,1,0
20741443@N00,990,21,1395366098,1395366098,1,1,0
20741443@N00,991,11,1395557982,1395557982,1,1,0
20741443@N00,992,30,1397721159,1397721159,1,1,0
20757913@N00,993,12,1179616380,1179616460,3,1,80
21012141@N00,994,23,1153622958,1153623946,4,1,988
21116747@N02,995,16,1317173648,1317177425,7,1,3777
21116747@N02,996,16,1317296087,1317296087,1,2,0
21116747@N02,996,24,1317288349,1317288349,1,2,0
21133927@N05,997,16,1294955260,1294964116,2,1,8856
21133927@N05,998,23,1295041181,1295041258,2,1,77
21196647@N02,999,22,1253355336,1253356021,2,1,685
21196647@N02,1000,15,1253408924,1253409321,3,2,397
21196647@N02,1000,19,1253407425,1253407503,2,2,78
21196647@N02,1001,11,1253503171,1253504243,3,2,1072
21196647@N02,1001,13,1253495068,1253500175,13,2,5107
21319985@N00,1002,21,1325468674,1325468674,1,1,0
21394882@N00,1003,8,1271284945,1271284945,1,1,0
21444820@N02,1004,16,1198135288,1198135288,1,2,0
21444820@N02,1004,24,1198136121,1198136121,1,2,0
21470941@N07,1005,25,1193214123,1193214123,1,1,0
21470941@N07,1006,30,1209269994,1209270758,5,1,764
21488397@N00,1007,23,1304631824,1304631824,1,1,0
21488397@N00,1008,22,1324343346,1324343346,1,1,0
21488397@N00,1009,21,1348725684,1348725684,1,1,0
21491187@N08,1010,25,1256432920,1256432920,1,1,0
21491187@N08,1011,25,1256634002,1256634002,1,1,0
21491187@N08,1012,6,1259036609,1259036609,1,2,0
21491187@N08,1012,25,1259035925,1259035925,1,2,0
21491187@N08,1013,11,1263616997,1263616997,1,1,0
21491187@N08,1014,25,1267231073,1267231726,3,1,653
21491187@N08,1015,6,1282021363,1282021363,1,1,0
21491187@N08,1016,11,1290838354,1290838459,3,1,105
21491187@N08,1017,7,1310767770,1310767780,2,1,10
21578016@N08,1018,21,1197093316,1197093316,1,1,0
21784565@N04,1019,22,1193795902,1193795902,1,2,0
21784565@N04,1019,30,1193805032,1193805318,2,2,286
21784565@N04,1020,25,1213576238,1213576238,1,2,0
21784565@N04,1020,30,1213571649,1213575428,4,2,3779
21854604@N00,1021,16,1280822021,1280822021,1,1,0
21895912@N02,1022,23,1252656404,1252657331,3,1,927
21895912@N02,1023,23,1252749884,1252749884,1,1,0
22034326@N08,1024,30,1341370325,1341370325,1,1,0
22044565@N00,1025,24,1277984734,1277988445,2,2,3711
22044565@N00,1025,29,1277968813,1277977285,2,2,8472
22044565@N00,1026,24,1295075161,1295078014,55,1,2853
22057420@N00,1027,7,1311343221,1311343606,5,1,385
22057420@N00,1028,16,1336101771,1336101771,1,1,0
22111831@N05,1029,21,1354014205,1354014205,1,2,0
22111831@N05,1029,22,1354015527,1354015527,1,2,0
22111831@N05,1030,7,1354099434,1354102823,4,2,3389
22111831@N05,1030,23,1354099675,1354099675,1,2,0
22111831@N05,1031,7,1366105442,1366105442,1,3,0
22111831@N05,1031,22,1366098670,1366098670,1,3,0
22111831@N05,1031,23,1366097643,1366097643,1,3,0
22131083@N08,1032,7,1249090740,1249090740,1,1,0
22139500@N06,1033,21,1254575482,1254575955,2,1,473
22139500@N06,1034,25,1335949889,1335949889,1,1,0
22139500@N06,1035,24,1336043111,1336043111,1,1,0
22139500@N06,1036,22,1348922113,1348922740,2,1,627
22139500@N06,1037,22,1352360214,1352360214,1,1,0
22139500@N06,1038,21,1354173815,1354173815,1,1,0
22139500@N06,1039,21,1354699660,1354699660,1,1,0
22139500@N06,1040,22,1368688993,1368688993,1,1,0
22139500@N06,1041,21,1369902627,1369902627,1,1,0
22168167@N00,1042,16,1188787487,1188790545,6,1,3058
22168167@N00,1043,24,1201146028,1201146028,1,1,0
22168167@N00,1044,30,1316162822,1316162822,1,1,0
22168167@N00,1045,30,1357112479,1357112723,3,1,244
22180762@N02,1046,16,1219059184,1219059184,1,1,0
22209148@N05,1047,11,1382839601,1382839601,1,1,0
22240293@N05,1048,22,1254855004,1254857334,3,1,2330
22292214@N00,1049,22,1277538788,1277538811,2,2,23
22292214@N00,1049,28,1277539500,1277539594,2,2,94
22292214@N00,1050,23,1317970974,1317970974,1,1,0
22372585@N07,1051,4,1279143432,1279143432,1,1,0
22397858@N00,1052,16,1125014196,1125014196,1,1,0
22489773@N02,1053,4,1224782030,1224782175,13,2,145
22489773@N02,1053,7,1224780789,1224780927,30,2,138
22605449@N06,1054,16,1320059275,1320059275,1,1,0
22605449@N06,1055,11,1330058535,1330058535,1,1,0
22605449@N06,1056,1,1348058860,1348058860,1,1,0
22607526@N00,1057,16,1227407741,1227411211,68,2,3470
22607526@N00,1057,30,1227415135,1227415146,3,2,11
22750939@N03,1058,23,1357730741,1357730741,1,1,0
22852813@N04,1059,28,1271702993,1271703118,5,1,125
22852813@N04,1060,11,1271757658,1271757658,1,1,0
22929018@N06,1061,23,1280683024,1280685320,5,1,2296
22929018@N06,1062,23,1280717600,1280717600,1,2,0
22929018@N06,1062,29,1280723878,1280724307,6,2,429
22979982@N06,1063,23,1303019488,1303019508,2,3,20
22979982@N06,1063,25,1303019260,1303019276,3,3,16
22979982@N06,1063,29,1303019558,1303019558,1,3,0
22991234@N04,1064,6,1334474194,1334474194,1,1,0
22996605@N05,1065,22,1273476442,1273476442,1,2,0
22996605@N05,1065,29,1273478409,1273478409,1,2,0
22996605@N05,1066,7,1308562699,1308562699,1,4,0
22996605@N05,1066,8,1308561363,1308561832,2,4,469
22996605@N05,1066,16,1308560993,1308561961,2,4,968
22996605@N05,1066,30,1308562372,1308562372,1,4,0
22996605@N05,1067,21,1309337207,1309337207,1,1,0
22996605@N05,1068,12,1343434913,1343444618,26,1,9705
22996605@N05,1069,23,1347015530,1347015530,1,1,0
22996605@N05,1070,4,1347761348,1347770539,20,2,9191
22996605@N05,1070,16,1347766897,1347766897,1,2,0
23017169@N08,1071,11,1279940689,1279950132,2,1,9443
23042598@N08,1072,16,1192861601,1192861601,1,1,0
23056733@N05,1073,11,1381889805,1381897386,6,1,7581
23072179@N00,1074,24,1154748231,1154748343,2,1,112
23081419@N00,1075,6,1259666825,1259666825,1,1,0
23088800@N06,1076,23,1289451783,1289451783,1,1,0
23109903@N08,1077,1,1333798744,1333798744,1,1,0
23119895@N00,1078,7,1343704533,1343710732,9,3,6199
23119895@N00,1078,8,1343710721,1343721921,4,3,11200
23119895@N00,1078,16,1343714017,1343718859,6,3,4842
23119895@N00,1079,13,1343966756,1343972321,13,1,5565
23196822@N00,1080,30,1353726658,1353726658,1,1,0
23196822@N00,1081,4,1353825163,1353825163,1,2,0
23196822@N00,1081,30,1353806216,1353806216,1,2,0
23269969@N00,1082,6,1221178525,1221178525,1,4,0
23269969@N00,1082,8,1221186639,1221187708,5,4,1069
23269969@N00,1082,16,1221173007,1221173007,1,4,0
23269969@N00,1082,30,1221179388,1221179388,1,4,0
23269969@N00,1083,11,1221770412,1221770412,1,1,0
23277275@N06,1084,22,1087589877,1087589877,1,1,0
23337613@N00,1085,1,1298620955,1298620955,1,1,0
23337613@N00,1086,7,1333181529,1333181529,1,2,0
23337613@N00,1086,21,1333193593,1333193593,1,2,0
23337613@N00,1087,21,1339844536,1339844536,1,1,0
23337613@N00,1088,1,1342848978,1342848978,1,2,0
23337613@N00,1088,8,1342849424,1342849440,2,2,16
23339848@N00,1089,11,1224283202,1224287692,2,3,4490
23339848@N00,1089,13,1224298415,1224301961,2,3,3546
23339848@N00,1089,30,1224302234,1224302234,1,3,0
23386158@N00,1090,22,1208159668,1208159808,2,1,140
23386158@N00,1091,15,1220086107,1220086107,1,1,0
23386158@N00,1092,27,1241656659,1241656659,1,1,0
23453214@N04,1093,30,1244534246,1244534246,1,1,0
23453214@N04,1094,11,1244705171,1244705171,1,1,0
23582291@N03,1095,21,1213928946,1213930607,2,2,1661
23582291@N03,1095,28,1213929825,1213929825,1,2,0
23582291@N03,1096,22,1214450598,1214450730,2,2,132
23582291@N03,1096,28,1214450839,1214450971,2,2,132
23582291@N03,1097,21,1237701777,1237701777,1,1,0
23664989@N00,1098,6,1331352006,1331352006,1,1,0
23664989@N00,1099,7,1361004411,1361004411,1,1,0
23664989@N00,1100,22,1371925669,1371925669,1,1,0
23664989@N00,1101,22,1373643282,1373643282,1,1,0
23664989@N00,1102,1,1375160078,1375160078,1,1,0
23664989@N00,1103,1,1375976203,1375976203,1,1,0
23664989@N00,1104,10,1377096546,1377096546,1,1,0
23664989@N00,1105,1,1379668769,1379668769,1,1,0
23739231@N00,1106,16,1129464143,1129464213,35,1,70
23740710@N04,1107,22,1381540825,1381541891,5,1,1066
23775118@N06,1108,24,1295485574,1295485574,1,1,0
23836265@N00,1109,11,1171168376,1171175997,8,1,7621
23836265@N00,1110,16,1247906062,1247906062,1,1,0
23877016@N03,1111,16,1298165532,1298173662,2,1,8130
23877016@N03,1112,17,1310088921,1310102407,2,1,13486
23877016@N03,1113,17,1310163782,1310183968,22,1,20186
23877016@N03,1114,17,1310252279,1310281867,50,1,29588
23879561@N06,1115,16,1248936331,1248948497,13,1,12166
23879561@N06,1116,21,1283748361,1283749011,2,1,650
23908938@N02,1117,4,1249688503,1249704601,35,3,16098
23908938@N02,1117,22,1249707088,1249707088,1,3,0
23908938@N02,1117,30,1249705517,1249705565,2,3,48
23908938@N02,1118,7,1249878053,1249881647,14,4,3594
23908938@N02,1118,16,1249883374,1249895293,104,4,11919
23908938@N02,1118,28,1249903349,1249903785,21,4,436
23908938@N02,1118,30,1249882815,1249882827,3,4,12
23908938@N02,1119,11,1249961081,1249963470,43,1,2389
23908938@N02,1120,16,1278395915,1278399221,2,1,3306
23908938@N02,1121,11,1278564328,1278564328,1,3,0
23908938@N02,1121,13,1278566048,1278566048,1,3,0
23908938@N02,1121,16,1278544392,1278544392,1,3,0
23908938@N02,1122,8,1278648737,1278648737,1,1,0
23987663@N00,1123,11,1223124951,1223125162,4,4,211
23987663@N00,1123,21,1223131001,1223131001,1,4,0
23987663@N00,1123,22,1223129420,1223129769,3,4,349
23987663@N00,1123,23,1223130368,1223130368,1,4,0
23987663@N00,1124,6,1236156602,1236156602,1,1,0
23987663@N00,1125,28,1240107534,1240107534,1,1,0
23987663@N00,1126,21,1241769037,1241769037,1,1,0
23987663@N00,1127,3,1242202310,1242202310,1,1,0
23987663@N00,1128,10,1254573071,1254573209,2,4,138
23987663@N00,1128,21,1254578993,1254580106,6,4,1113
23987663@N00,1128,22,1254583311,1254583311,1,4,0
23987663@N00,1128,28,1254581097,1254581097,1,4,0
23987663@N00,1129,1,1255079578,1255085251,3,1,5673
23987663@N00,1130,7,1271664335,1271664335,1,1,0
23987663@N00,1131,23,1305507791,1305507791,1,1,0
23987663@N00,1132,3,1309539171,1309539171,1,1,0
23987663@N00,1133,3,1309676705,1309676705,3,1,0
23987663@N00,1134,23,1317434642,1317434642,1,1,0
23987663@N00,1135,22,1317480568,1317481105,2,3,537
23987663@N00,1135,23,1317480026,1317480026,1,3,0
23987663@N00,1135,28,1317481628,1317483584,2,3,1956
23987663@N00,1136,23,1319187721,1319187721,1,1,0
23987663@N00,1137,3,1321088292,1321088901,2,1,609
23987663@N00,1138,23,1321999158,1321999158,1,1,0
23987663@N00,1139,7,1323153262,1323153262,1,1,0
23987663@N00,1140,21,1339301374,1339301374,1,1,0
23987663@N00,1141,3,1339829048,1339829048,1,1,0
23987663@N00,1142,7,1340322777,1340322777,1,1,0
23987663@N00,1143,24,1340356304,1340356304,1,1,0
23987663@N00,1144,23,1344487547,1344488344,2,1,797
23987663@N00,1145,19,1345018005,1345018005,1,1,0
23987663@N00,1146,23,1345160584,1345160584,1,1,0
23987663@N00,1147,21,1345860267,1345860267,1,1,0
23987663@N00,1148,19,1346559235,1346559235,1,1,0
23987663@N00,1149,7,1349232390,1349232390,1,1,0
23987663@N00,1150,23,1350526812,1350526812,1,1,0
23987663@N00,1151,1,1350615592,1350615592,1,2,0
23987663@N00,1151,7,1350607178,1350607178,1,2,0
23987663@N00,1152,1,1352338258,1352338258,1,1,0
23987663@N00,1153,28,1352802455,1352802455,1,1,0
23987663@N00,1154,21,1352936466,1352936466,1,1,0
23987663@N00,1155,21,1353134980,1353134980,1,1,0
23987663@N00,1156,23,1353210810,1353210810,1,1,0
23987663@N00,1157,21,1355024432,1355024432,1,1,0
23987663@N00,1158,23,1355103859,1355103859,1,1,0
23987663@N00,1159,21,1356830322,1356830322,1,1,0
23987663@N00,1160,16,1359626431,1359626431,1,1,0
23987663@N00,1161,23,1363849299,1363849299,1,1,0
23987663@N00,1162,22,1364438811,1364438811,1,1,0
23987663@N00,1163,23,1364886457,1364886457,1,1,0
23987663@N00,1164,23,1375675837,1375675837,1,1,0
23987663@N00,1165,1,1379580072,1379580072,1,1,0
23987663@N00,1166,21,1387416445,1387416541,2,1,96
23993156@N00,1167,11,1365219740,1365219740,1,1,0
23995405@N00,1168,24,1223898360,1223898360,1,1,0
24085129@N07,1169,16,1241166804,1241166804,1,1,0
24128704@N08,1170,16,1371702676,1371702843,2,1,167
24128704@N08,1171,1,1371754345,1371754345,1,3,0
24128704@N08,1171,8,1371755272,1371755272,1,3,0
24128704@N08,1171,24,1371758403,1371758786,2,3,383
24186340@N03,1172,16,1220677567,1220677567,1,1,0
24186340@N03,1173,22,1261044278,1261044850,2,1,572
24186340@N03,1174,1,1363489284,1363495641,3,1,6357
24306356@N00,1175,9,1314663817,1314680759,22,1,16942
24306356@N00,1176,16,1314748233,1314752406,19,1,4173
24306356@N00,1177,11,1314923113,1314934497,41,1,11384
24366947@N08,1178,25,1330780847,1330780847,1,1,0
24395354@N02,1179,6,1267224151,1267234989,3,3,10838
24395354@N02,1179,11,1267235662,1267235662,1,3,0
24395354@N02,1179,26,1267252728,1267252728,1,3,0
24431382@N03,1180,21,1344517959,1344517959,1,1,0
24431382@N03,1181,21,1349739075,1349739075,1,1,0
24484507@N00,1182,16,838821600,838821600,1,1,0
24503701@N02,1183,7,1344655741,1344657608,2,1,1867
24566752@N05,1184,4,1272260437,1272287863,36,2,27426
24566752@N05,1184,16,1272263035,1272263421,4,2,386
24566752@N05,1185,4,1272319062,1272321823,2,1,2761
24585780@N00,1186,13,1156648595,1156648672,2,1,77
24616128@N00,1187,11,1175922484,1175928908,15,1,6424
24616128@N00,1188,13,1187302761,1187308620,9,1,5859
24616128@N00,1189,23,1213833847,1213864114,44,1,30267
24616128@N00,1190,23,1213911727,1213911727,1,1,0
24616128@N00,1191,29,1229565882,1229571460,29,1,5578
24616128@N00,1192,29,1253513571,1253513571,1,1,0
24616128@N00,1193,8,1253580874,1253599362,39,1,18488
24616128@N00,1194,8,1253665846,1253669507,17,3,3661
24616128@N00,1194,23,1253672817,1253672817,2,3,0
24616128@N00,1194,29,1253664073,1253664073,1,3,0
24616128@N00,1195,11,1270875683,1270875683,1,1,0
24616128@N00,1196,22,1272615856,1272615897,3,1,41
24616128@N00,1197,9,1272687318,1272687318,1,1,0
24616128@N00,1198,26,1282977584,1282977758,3,1,174
24616128@N00,1199,8,1285120503,1285132678,16,1,12175
24616128@N00,1200,22,1285460060,1285469262,9,1,9202
24616128@N00,1201,12,1289619349,1289621095,8,1,1746
24616128@N00,1202,4,1315387008,1315387586,11,2,578
24616128@N00,1202,8,1315356418,1315373581,17,2,17163
24616128@N00,1203,8,1315435076,1315461047,17,1,25971
24616128@N00,1204,8,1345766681,1345795902,137,1,29221
24616128@N00,1205,8,1345877816,1345877862,2,1,46
24694793@N05,1206,9,1338885641,1338885759,2,1,118
24741597@N00,1207,23,1316055804,1316055804,1,1,0
24741597@N00,1208,4,1316153692,1316153783,2,1,91
24741597@N00,1209,3,1316222467,1316222467,1,2,0
24741597@N00,1209,7,1316209335,1316210304,3,2,969
24741597@N00,1210,8,1369946474,1369946474,1,1,0
24819841@N06,1211,11,1184297048,1184322677,29,1,25629
24850040@N07,1212,4,1246081731,1246081731,1,1,0
24854893@N00,1213,11,7740000,7740000,1,1,0
24854893@N00,1214,16,110296800,110296800,1,1,0
24854893@N00,1215,11,133970400,133970400,26,1,0
24854893@N00,1216,29,136562400,136562400,1,1,0
24854893@N00,1217,27,141832800,141832800,1,1,0
24854893@N00,1218,22,157726800,157726800,3,2,0
24854893@N00,1218,29,157726800,157726800,1,2,0
24854893@N00,1219,11,165506400,165506400,1,2,0
24854893@N00,1219,16,165506400,165506400,2,2,0
24854893@N00,1220,6,173368800,173368800,2,1,0
24854893@N00,1221,22,176047200,176047200,1,2,0
24854893@N00,1221,28,176047200,176047200,2,2,0
24854893@N00,1222,16,186584400,186584400,1,1,0
24854893@N00,1223,16,207669600,207669600,1,2,0
24854893@N00,1223,22,207669600,207669600,3,2,0
24854893@N00,1224,22,210348000,210348000,5,1,0
24854893@N00,1225,16,228664800,228664800,2,3,0
24854893@N00,1225,17,228664800,228664800,4,3,0
24854893@N00,1225,19,228664800,228664800,1,3,0
24854893@N00,1226,22,236527200,236527200,2,1,0
24854893@N00,1227,22,239205600,239205600,1,2,0
24854893@N00,1227,24,239205600,239205600,1,2,0
24854893@N00,1228,16,260200800,260200800,1,1,0
24854893@N00,1229,24,262792800,262792800,1,1,0
24854893@N00,1230,27,268063200,268063200,1,1,0
24854893@N00,1231,6,299599200,299599200,1,1,0
24854893@N00,1232,15,457452000,457452000,6,1,0
24854893@N00,1233,1,460130400,460130400,1,1,0
24854893@N00,1234,11,470667600,470667600,4,1,0
24854893@N00,1235,30,1125992078,1125992085,2,1,7
24854893@N00,1236,30,1149575062,1149575062,2,1,0
24854893@N00,1237,11,1239595854,1239596310,6,4,456
24854893@N00,1237,24,1239583251,1239583251,1,4,0
24854893@N00,1237,25,1239584316,1239584322,2,4,6
24854893@N00,1237,30,1239582977,1239597120,7,4,14143
24854893@N00,1238,13,1242366128,1242366966,11,1,838
24854893@N00,1239,17,1246370400,1246370400,1,1,0
24854893@N00,1240,17,1249036670,1249036670,1,2,0
24854893@N00,1240,22,1249043311,1249043311,1,2,0
24854893@N00,1241,8,1250053092,1250054100,2,2,1008
24854893@N00,1241,30,1250055128,1250055196,2,2,68
24854893@N00,1242,30,1255476888,1255477314,3,1,426
24854893@N00,1243,16,1264751752,1264751752,1,1,0
24854893@N00,1244,30,1271114922,1271114922,1,1,0
24854893@N00,1245,22,1276589850,1276590642,9,2,792
24854893@N00,1245,28,1276589515,1276589515,1,2,0
24854893@N00,1246,1,1292822672,1292822672,1,1,0
24854893@N00,1247,16,1308545680,1308545680,1,3,0
24854893@N00,1247,24,1308547605,1308547915,5,3,310
24854893@N00,1247,25,1308545184,1308545184,1,3,0
24854893@N00,1248,30,1323663785,1323663785,1,1,0
24854893@N00,1249,28,1386648976,1386649072,5,1,96
24871797@N00,1250,21,1256643492,1256643492,1,1,0
24871797@N00,1251,7,1256771438,1256771438,1,2,0
24871797@N00,1251,28,1256772347,1256772347,1,2,0
24887466@N06,1252,22,1350717149,1350717149,1,1,0
24910973@N03,1253,11,1235909267,1235910874,15,1,1607
24914070@N07,1254,7,1257017389,1257018002,15,1,613
24930529@N07,1255,25,1374379174,1374379174,1,1,0
25009109@N06,1256,11,1210320038,1210320312,2,2,274
25009109@N06,1256,29,1210320905,1210320905,1,2,0
25113640@N00,1257,13,1374820146,1374820178,3,1,32
25123564@N08,1258,16,1122597749,1122597749,1,1,0
25133522@N00,1259,8,1215079159,1215083416,4,4,4257
25133522@N00,1259,13,1215070869,1215076092,5,4,5223
25133522@N00,1259,21,1215066105,1215066353,2,4,248
25133522@N00,1259,24,1215083949,1215083949,1,4,0
25133522@N00,1260,24,1215148327,1215150210,2,1,1883
25196404@N05,1261,22,1339814974,1339814974,1,1,0
25377075@N07,1262,10,1210654379,1210654379,1,1,0
25377075@N07,1263,10,1211073711,1211076822,8,1,3111
25384365@N00,1264,16,1203159788,1203159788,1,1,0
25384365@N00,1265,2,1220237013,1220237013,1,1,0
25396215@N00,1266,4,1153466882,1153466882,1,1,0
25475928@N04,1267,7,1258404562,1258404562,1,2,0
25475928@N04,1267,30,1258386677,1258405331,7,2,18654
25475928@N04,1268,16,1260291173,1260291173,1,2,0
25475928@N04,1268,24,1260291985,1260291985,1,2,0
25475928@N04,1269,16,1260699251,1260701094,3,1,1843
25475928@N04,1270,21,1260793945,1260861192,5,4,67247
25475928@N04,1270,23,1260796211,1260806422,5,4,10211
25475928@N04,1270,28,1260834356,1260834356,1,4,0
25475928@N04,1270,30,1260815155,1260815155,1,4,0
25475928@N04,1271,16,1260986182,1260986182,1,1,0
25475928@N04,1272,30,1261125924,1261125924,1,1,0
25475928@N04,1273,21,1261210302,1261210302,1,1,0
25475928@N04,1274,16,1262037957,1262038216,5,1,259
25561968@N00,1275,4,1350207738,1350207738,1,3,0
25561968@N00,1275,8,1350201713,1350201713,1,3,0
25561968@N00,1275,16,1350207486,1350207824,3,3,338
25644479@N05,1276,16,1343571087,1343571087,1,2,0
25644479@N05,1276,23,1343560532,1343560532,1,2,0
25652622@N00,1277,30,1233553304,1233565602,2,1,12298
25653648@N08,1278,8,1350876512,1350876512,1,2,0
25653648@N08,1278,16,1350875959,1350876637,2,2,678
25716750@N06,1279,22,1383877126,1383877126,1,1,0
25779700@N00,1280,22,1142046414,1142047408,4,2,994
25779700@N00,1280,25,1142043374,1142043439,2,2,65
25802393@N02,1281,4,1367058117,1367058133,2,6,16
25802393@N02,1281,7,1367054530,1367054530,1,6,0
25802393@N02,1281,8,1367057239,1367059164,2,6,1925
25802393@N02,1281,16,1367056744,1367059991,9,6,3247
25802393@N02,1281,23,1367053682,1367053682,1,6,0
25802393@N02,1281,30,1367054702,1367054915,4,6,213
25803652@N04,1282,25,1239937631,1239937631,1,1,0
25846522@N00,1283,1,1281407647,1281407647,1,4,0
25846522@N00,1283,22,1281398999,1281398999,1,4,0
25846522@N00,1283,23,1281397538,1281398390,2,4,852
25846522@N00,1283,28,1281399217,1281399753,4,4,536
25846522@N00,1284,8,1281517331,1281517331,1,2,0
25846522@N00,1284,11,1281509416,1281513306,3,2,3890
25846522@N00,1285,21,1281610658,1281610658,1,1,0
25846522@N00,1286,13,1281654943,1281662239,8,1,7296
25846522@N00,1287,21,1336633321,1336633970,3,1,649
25846522@N00,1288,23,1336733853,1336733853,1,1,0
25869172@N07,1289,8,1232861359,1232861359,1,1,0
25897810@N00,1290,11,1346560622,1346560622,1,1,0
25897810@N00,1291,22,1377927618,1377927618,1,1,0
25964835@N02,1292,11,1210326319,1210330558,4,1,4239
25964835@N02,1293,15,1210408110,1210408110,1,1,0
25964835@N02,1294,4,1215081186,1215081186,1,1,0
25964835@N02,1295,7,1221871548,1221871673,2,1,125
25964835@N02,1296,22,1223133857,1223133857,1,2,0
25964835@N02,1296,28,1223133442,1223133729,2,2,287
25964835@N02,1297,11,1231295400,1231295405,2,1,5
25964835@N02,1298,11,1231545600,1231545600,4,1,0
25970113@N08,1299,7,1303696238,1303696360,4,1,122
26010466@N07,1300,25,1254446404,1254446404,1,1,0
26010466@N07,1301,6,1255585690,1255585852,2,1,162
26010466@N07,1302,3,1263606567,1263606740,4,1,173
26010466@N07,1303,29,1263967597,1263967597,1,1,0
26036678@N07,1304,1,1330094495,1330094495,1,1,0
26125239@N00,1305,16,1288124900,1288137091,66,1,12191
26125239@N00,1306,16,1288233731,1288235435,14,1,1704
26150046@N06,1307,7,1243132752,1243132752,1,1,0
26150046@N06,1308,16,1247645580,1247645580,1,1,0
26150046@N06,1309,12,1255836530,1255836560,2,1,30
26195569@N00,1310,6,1191068993,1191068993,1,3,0
26195569@N00,1310,11,1191063112,1191063112,1,3,0
26195569@N00,1310,27,1191065865,1191065865,1,3,0
26240579@N05,1311,16,1344500312,1344500312,1,1,0
26240579@N05,1312,16,1344641772,1344642894,7,4,1122
26240579@N05,1312,21,1344677429,1344677437,2,4,8
26240579@N05,1312,28,1344653156,1344653156,1,4,0
26240579@N05,1312,30,1344646287,1344646302,2,4,15
26240579@N05,1313,23,1344725971,1344728705,2,1,2734
26263283@N00,1314,25,1304057419,1304057419,1,1,0
26263283@N00,1315,6,1306312341,1306312341,1,1,0
26263283@N00,1316,21,1306398349,1306398349,1,1,0
26263283@N00,1317,25,1310617156,1310617156,1,1,0
26263283@N00,1318,28,1315019922,1315019922,1,1,0
26344918@N04,1319,23,1256202607,1256202607,1,1,0
26344918@N04,1320,7,1309753820,1309753970,2,1,150
26344918@N04,1321,1,1310747477,1310747531,2,4,54
26344918@N04,1321,7,1310748231,1310748231,1,4,0
26344918@N04,1321,22,1310738755,1310738755,1,4,0
26344918@N04,1321,28,1310738104,1310738104,1,4,0
26344918@N04,1322,11,1312109431,1312112868,9,1,3437
26372307@N03,1323,4,1343128846,1343134638,3,1,5792
26394264@N04,1324,24,1211225134,1211225134,1,1,0
26408216@N06,1325,23,1350800638,1350800654,4,1,16
26416016@N02,1326,7,1215414505,1215415205,4,1,700
26416016@N02,1327,11,1215484625,1215485959,6,1,1334
26487906@N00,1328,21,1318079889,1318079889,1,2,0
26487906@N00,1328,28,1318080567,1318080762,2,2,195
26736723@N00,1329,8,1359178079,1359178079,1,1,0
26736723@N00,1330,6,1359251496,1359274295,8,1,22799
26736723@N00,1331,8,1359344952,1359345589,6,1,637
26736723@N00,1332,16,1359374618,1359374618,1,1,0
26736723@N00,1333,8,1359409511,1359460178,19,1,50667
26736723@N00,1334,8,1359496902,1359515140,23,1,18238
26736723@N00,1335,4,1359601174,1359601174,1,3,0
26736723@N00,1335,8,1359599984,1359599984,1,3,0
26736723@N00,1335,16,1359601405,1359602233,4,3,828
26761048@N05,1336,24,1215170239,1215171384,4,1,1145
26761048@N05,1337,23,1382359171,1382359273,4,1,102
26771458@N08,1338,12,1216431326,1216440970,26,1,9644
26771458@N08,1339,11,1216519442,1216520550,2,1,1108
26788043@N02,1340,29,1244353350,1244353350,1,1,0
26860638@N08,1341,8,1282484829,1282484829,1,1,0
26908338@N07,1342,11,1221810401,1221810401,1,1,0
26968823@N07,1343,4,1253071045,1253106952,14,1,35907
27008470@N00,1344,8,1140940063,1140940063,1,3,0
27008470@N00,1344,22,1140938215,1140938215,1,3,0
27008470@N00,1344,30,1140939537,1140939537,1,3,0
27031977@N04,1345,22,1214887803,1214887893,2,3,90
27031977@N04,1345,23,1214888788,1214888788,1,3,0
27031977@N04,1345,28,1214887528,1214887528,1,3,0
27065387@N00,1346,10,1157856109,1157857363,2,1,1254
27065387@N00,1347,7,1158322328,1158322351,2,1,23
27065387@N00,1348,22,1184111784,1184117005,5,1,5221
27065387@N00,1349,6,1257640549,1257640549,1,1,0
27124254@N00,1350,1,1196243717,1196244968,6,1,1251
27124254@N00,1351,1,1209465685,1209466062,5,1,377
27124254@N00,1352,30,1239093515,1239093873,2,1,358
27124254@N00,1353,12,1241919889,1241932822,4,1,12933
27124254@N00,1354,16,1253105599,1253105599,1,1,0
27124254@N00,1355,12,1254622038,1254625211,3,1,3173
27124254@N00,1356,4,1341030130,1341035713,2,1,5583
27124254@N00,1357,11,1343884218,1343887751,2,1,3533
27168489@N00,1358,8,1304303661,1304303778,2,6,117
27168489@N00,1358,16,1304299538,1304303495,7,6,3957
27168489@N00,1358,21,1304315802,1304315802,1,6,0
27168489@N00,1358,22,1304311161,1304311408,2,6,247
27168489@N00,1358,23,1304313194,1304313194,1,6,0
27168489@N00,1358,28,1304310840,1304310840,1,6,0
27291676@N06,1359,16,1277560800,1277560810,17,1,10
27291676@N06,1360,16,1277619023,1277638570,5,1,19547
27319399@N02,1361,12,1252590400,1252590400,1,1,0
27369554@N06,1362,30,1384212434,1384212434,1,1,0
27369554@N06,1363,25,1384319803,1384319803,1,1,0
27369554@N06,1364,22,1384581915,1384581915,1,1,0
27404953@N06,1365,16,1277560800,1277560805,6,1,5
27404953@N06,1366,16,1277593985,1277638570,16,1,44585
27582868@N00,1367,22,1332320811,1332320811,1,1,0
27633308@N05,1368,7,1356764368,1356766723,2,1,2355
27663349@N07,1369,16,1252802242,1252802242,1,1,0
27663349@N07,1370,16,1252904146,1252904146,1,1,0
27703725@N00,1371,8,1259984716,1259984814,2,2,98
27703725@N00,1371,27,1259976953,1259976953,1,2,0
27712418@N02,1372,27,1276247174,1276254746,10,1,7572
27712418@N02,1373,27,1370713283,1370713283,1,1,0
27725047@N00,1374,16,1157406867,1157406867,1,1,0
27725047@N00,1375,16,1157462629,1157463782,6,1,1153
27725047@N00,1376,16,1157579259,1157579319,3,1,60
27728294@N05,1377,14,1326849495,1326849495,1,1,0
27895744@N00,1378,1,1199872434,1199872434,1,3,0
27895744@N00,1378,8,1199854750,1199854750,1,3,0
27895744@N00,1378,16,1199858617,1199858617,1,3,0
27914970@N04,1379,29,1380255726,1380263968,20,1,8242
27914970@N04,1380,4,1380330252,1380346960,41,2,16708
27914970@N04,1380,15,1380326278,1380326507,3,2,229
27914970@N04,1381,4,1380703527,1380703527,1,1,0
27933068@N03,1382,7,1292201561,1292201561,1,1,0
27935231@N00,1383,21,1211675706,1211675706,1,1,0
27937533@N08,1384,16,1285580807,1285580807,1,1,0
27947906@N08,1385,13,1215582661,1215584316,20,3,1655
27947906@N08,1385,16,1215567557,1215567985,39,3,428
27947906@N08,1385,24,1215568956,1215568956,1,3,0
27952950@N06,1386,8,1270881721,1270881721,1,1,0
27952950@N06,1387,7,1274081507,1274081507,1,1,0
27952950@N06,1388,4,1275710664,1275710664,1,1,0
27952950@N06,1389,30,1284873415,1284873415,1,1,0
27952950@N06,1390,28,1290304499,1290304499,1,1,0
27952950@N06,1391,27,1317295187,1317295187,1,1,0
28011375@N04,1392,21,1290776494,1290776494,1,1,0
28011375@N04,1393,24,1295580393,1295580393,1,1,0
28066281@N03,1394,6,1390729065,1390729089,4,2,24
28066281@N03,1394,11,1390729502,1390729545,7,2,43
28066281@N03,1395,16,1393761348,1393761348,1,1,0
28066281@N03,1396,6,1395135794,1395135879,9,1,85
28085418@N07,1397,6,1319524792,1319524876,2,1,84
28085418@N07,1398,7,1319607772,1319607772,1,1,0
28085418@N07,1399,21,1342772241,1342772241,1,1,0
28085418@N07,1400,11,1342834537,1342849819,2,1,15282
28085418@N07,1401,23,1354345344,1354345344,1,1,0
28085418@N07,1402,23,1392779236,1392779236,1,1,0
28157992@N03,1403,7,1315109582,1315110808,3,1,1226
28157992@N03,1404,1,1341055580,1341055580,1,3,0
28157992@N03,1404,15,1341044354,1341044354,1,3,0
28157992@N03,1404,19,1341051456,1341051456,1,3,0
28157992@N03,1405,11,1381018486,1381027610,12,1,9124
28179139@N08,1406,28,1214571876,1214571876,1,1,0
28179139@N08,1407,28,1215605890,1215606027,2,1,137
28179139@N08,1408,7,1219838731,1219839253,3,1,522
28185541@N00,1409,25,1195867203,1195867249,2,1,46
28185541@N00,1410,25,1248662011,1248662011,1,1,0
28185541@N00,1411,11,1248747607,1248747607,1,1,0
28232089@N04,1412,29,1381290690,1381290690,2,1,0
28288718@N03,1413,21,1283917940,1283920725,3,1,2785
28288718@N03,1414,30,1284018995,1284019008,2,1,13
28288718@N03,1415,21,1284086256,1284093349,9,1,7093
28288718@N03,1416,7,1288154395,1288154395,1,2,0
28288718@N03,1416,21,1288147706,1288147706,1,2,0
28288718@N03,1417,3,1311136205,1311136219,2,1,14
28288718@N03,1418,23,1311738998,1311739166,2,1,168
28288718@N03,1419,21,1313247008,1313247008,1,1,0
28288718@N03,1420,6,1347236157,1347236157,1,2,0
28288718@N03,1420,7,1347240317,1347240317,1,2,0
28288718@N03,1421,21,1360208270,1360208391,4,3,121
28288718@N03,1421,27,1360206638,1360206638,1,3,0
28288718@N03,1421,30,1360205175,1360205175,1,3,0
28288718@N03,1422,21,1366691936,1366691936,1,1,0
28288718@N03,1423,21,1367469766,1367469766,1,3,0
28288718@N03,1423,28,1367482626,1367482714,3,3,88
28288718@N03,1423,30,1367483190,1367483283,3,3,93
28288718@N03,1424,23,1368673718,1368673718,1,3,0
28288718@N03,1424,28,1368687198,1368687198,1,3,0
28288718@N03,1424,30,1368669385,1368669385,1,3,0
28288718@N03,1425,7,1368778415,1368778437,2,2,22
28288718@N03,1425,21,1368765282,1368777239,4,2,11957
28309363@N07,1426,25,1273896073,1273896116,2,1,43
28309363@N07,1427,24,1275203098,1275203098,1,1,0
28309363@N07,1428,25,1275467630,1275467630,1,1,0
28309363@N07,1429,29,1278310302,1278310302,1,1,0
28309363@N07,1430,6,1279094628,1279095076,2,1,448
28309363@N07,1431,30,1344559473,1344559473,1,1,0
28426408@N00,1432,11,1180788324,1180800689,8,1,12365
28426408@N00,1433,23,1284194273,1284195915,4,1,1642
28518251@N00,1434,28,1135575641,1135575641,1,1,0
28518251@N00,1435,21,1167699079,1167699079,1,1,0
28550826@N08,1436,28,1217562738,1217563251,16,2,513
28550826@N08,1436,30,1217573109,1217597492,4,2,24383
28581121@N00,1437,29,1156815955,1156816029,2,1,74
28581121@N00,1438,6,1159486874,1159486874,1,1,0
28581121@N00,1439,21,1168083579,1168083579,1,1,0
28587936@N03,1440,22,1240019274,1240019274,1,1,0
28621544@N00,1441,28,1075778748,1075778769,2,1,21
28621544@N00,1442,24,1134641316,1134644684,5,1,3368
28621544@N00,1443,24,1134725398,1134734122,15,1,8724
28621544@N00,1444,21,1158390000,1158390001,2,1,1
28621544@N00,1445,24,1166177805,1166186160,5,1,8355
28621544@N00,1446,23,1179308196,1179311522,8,1,3326
28621544@N00,1447,23,1180087020,1180093411,8,1,6391
28621544@N00,1448,24,1183276958,1183286452,12,1,9494
28621544@N00,1449,21,1219730951,1219731525,2,1,574
28621544@N00,1450,21,1219911259,1219911259,1,1,0
28621544@N00,1451,23,1229432400,1229432404,5,1,4
28621544@N00,1452,24,1229678340,1229686022,36,2,7682
28621544@N00,1452,30,1229671471,1229671471,1,2,0
28621544@N00,1453,24,1229764533,1229772029,22,1,7496
28622838@N00,1454,22,1335350119,1335350119,1,1,0
28636659@N05,1455,11,1340654960,1340654960,1,1,0
28636659@N05,1456,11,1345295166,1345295166,1,1,0
28636659@N05,1457,11,1345352840,1345370764,2,1,17924
28686493@N08,1458,13,1224062023,1224062442,2,1,419
28686493@N08,1459,8,1224134913,1224135399,2,1,486
28686493@N08,1460,16,1224223503,1224225538,12,1,2035
28721558@N07,1461,2,1252205795,1252211821,15,2,6026
28721558@N07,1461,17,1252214046,1252214046,1,2,0
28721558@N07,1462,8,1252735682,1252735682,1,2,0
28721558@N07,1462,24,1252746650,1252751288,17,2,4638
28721558@N07,1463,21,1266631300,1266631335,2,1,35
28721558@N07,1464,21,1267348671,1267354427,63,1,5756
28721558@N07,1465,21,1274338455,1274349032,89,1,10577
28721558@N07,1466,23,1277561795,1277561795,1,1,0
28721558@N07,1467,1,1281177133,1281177133,1,1,0
28721558@N07,1468,1,1283335665,1283336097,4,1,432
28721558@N07,1469,4,1285751509,1285764319,5,1,12810
28752281@N07,1470,27,1331446906,1331447876,3,1,970
28752281@N07,1471,25,1334571939,1334571939,1,1,0
28774111@N07,1472,30,1374120720,1374120720,1,1,0
28801512@N00,1473,27,1175146161,1175146198,2,1,37
28853433@N02,1474,29,1136773167,1136773167,1,1,0
28853433@N02,1475,29,1217367939,1217367939,1,1,0
28853433@N02,1476,29,1277157492,1277157492,1,1,0
28853433@N02,1477,29,1321329914,1321329914,1,1,0
28853433@N02,1478,29,1339560782,1339560782,1,1,0
28919631@N00,1479,13,1172205713,1172210903,2,1,5190
28980639@N02,1480,16,1372503141,1372503141,1,1,0
29052829@N00,1481,12,1237157961,1237162309,4,1,4348
29052829@N00,1482,1,1237623504,1237623504,1,1,0
29052829@N00,1483,2,1272447297,1272451592,2,1,4295
29052829@N00,1484,22,1283395500,1283395506,7,1,6
29052829@N00,1485,11,1303699886,1303699886,1,1,0
29052829@N00,1486,12,1334024092,1334024092,1,1,0
29114387@N08,1487,16,1280623272,1280623272,1,1,0
29114387@N08,1488,16,1281692016,1281692016,1,1,0
29125594@N03,1489,22,1219812473,1219812614,3,2,141
29125594@N03,1489,28,1219812774,1219812774,1,2,0
29125594@N03,1490,30,1230341934,1230342165,2,1,231
29125594@N03,1491,25,1248250393,1248254032,4,1,3639
29125594@N03,1492,11,1248331244,1248331675,3,2,431
29125594@N03,1492,21,1248343424,1248343424,1,2,0
29136114@N05,1493,16,1368698945,1368698945,1,1,0
29146273@N03,1494,28,1222774125,1222774125,1,1,0
29146273@N03,1495,23,1228553571,1228553571,1,1,0
29146273@N03,1496,28,1241100000,1241100000,1,1,0
29146273@N03,1497,21,1242738093,1242738093,1,1,0
29146273@N03,1498,28,1242825753,1242825753,1,1,0
29146273@N03,1499,22,1243517842,1243517842,1,1,0
29146273@N03,1500,23,1243778400,1243778400,3,2,0
29146273@N03,1500,28,1243778400,1243778400,1,2,0
29146273@N03,1501,22,1243840848,1243840848,1,1,0
29146273@N03,1502,23,1244673025,1244673025,1,1,0
29146273@N03,1503,23,1262264400,1262264400,1,1,0
29146273@N03,1504,24,1274104800,1274104800,1,1,0
29146273@N03,1505,29,1280584800,1280584800,3,1,0
29146273@N03,1506,21,1283954400,1283954401,2,1,1
29146273@N03,1507,30,1288875600,1288875600,1,1,0
29146273@N03,1508,21,1292504401,1292504401,1,1,0
29146273@N03,1509,21,1293800400,1293800400,1,1,0
29146273@N03,1510,23,1301576400,1301576400,1,1,0
29146273@N03,1511,28,1305813607,1305813607,1,2,0
29146273@N03,1511,30,1305813601,1305813602,2,2,1
29146273@N03,1512,11,1306418401,1306418401,1,1,0
29146273@N03,1513,6,1306850400,1306850400,1,1,0
29146273@N03,1514,25,1312120800,1312120800,1,1,0
29146273@N03,1515,10,1353070800,1353070801,2,1,1
29171313@N00,1516,22,1221632770,1221632770,1,1,0
29241649@N02,1517,11,1222617891,1222617891,1,1,0
29242611@N05,1518,6,1358193777,1358193777,1,1,0
29242611@N05,1519,22,1359446288,1359446288,1,1,0
29242611@N05,1520,6,1360225004,1360230374,2,1,5370
29242611@N05,1521,6,1362745330,1362745330,1,1,0
29258829@N04,1522,8,1181354745,1181354745,1,2,0
29258829@N04,1522,16,1181365294,1181365558,2,2,264
29352917@N00,1523,16,1305158805,1305158805,1,4,0
29352917@N00,1523,22,1305167894,1305167894,1,4,0
29352917@N00,1523,23,1305161232,1305164871,3,4,3639
29352917@N00,1523,28,1305166603,1305166603,1,4,0
29352917@N00,1524,16,1305277845,1305280694,2,3,2849
29352917@N00,1524,29,1305272994,1305282167,8,3,9173
29352917@N00,1524,30,1305275885,1305275885,1,3,0
29352917@N00,1525,6,1305332302,1305341720,2,3,9418
29352917@N00,1525,23,1305347420,1305347588,3,3,168
29352917@N00,1525,25,1305334737,1305334737,1,3,0
29401025@N06,1526,22,1258776552,1258776552,1,1,0
29401025@N06,1527,28,1304740547,1304740547,1,1,0
29401025@N06,1528,22,1305174200,1305174200,1,1,0
29401025@N06,1529,16,1329875713,1329875713,1,1,0
29401025@N06,1530,18,1334736814,1334736814,1,1,0
29413243@N00,1531,23,1386383940,1386383940,1,1,0
29488788@N06,1532,30,1280911091,1280913997,8,1,2906
29593526@N07,1533,16,1248996920,1248996961,3,1,41
29619840@N00,1534,21,1215379849,1215379849,1,1,0
29619840@N00,1535,22,1230724779,1230724779,1,2,0
29619840@N00,1535,26,1230706641,1230706641,1,2,0
29619840@N00,1536,4,1234666565,1234667789,13,3,1224
29619840@N00,1536,8,1234664190,1234666198,18,3,2008
29619840@N00,1536,16,1234668160,1234669889,19,3,1729
29619840@N00,1537,15,1253337190,1253337190,1,1,0
29668249@N06,1538,28,1204981200,1204981200,1,1,0
29853282@N06,1539,1,1280306265,1280306265,1,1,0
29855929@N00,1540,17,1181297051,1181297051,1,1,0
30129139@N04,1541,11,1273567312,1273568433,2,1,1121
30129139@N04,1542,7,1273675080,1273675080,1,2,0
30129139@N04,1542,22,1273671752,1273671752,1,2,0
30129139@N04,1543,16,1273911887,1273913256,3,2,1369
30129139@N04,1543,22,1273917152,1273917152,1,2,0
30194349@N06,1544,22,1353143584,1353143973,23,1,389
30245869@N07,1545,30,1236918779,1236918779,1,1,0
30245869@N07,1546,25,1334285394,1334285394,1,1,0
30441723@N00,1547,22,1324881529,1324881529,1,2,0
30441723@N00,1547,23,1324880824,1324880824,1,2,0
30441723@N00,1548,6,1333528736,1333528736,1,1,0
30441723@N00,1549,25,1334925598,1334925598,1,1,0
30441723@N00,1550,6,1345536352,1345536352,1,1,0
30441723@N00,1551,11,1383044758,1383044758,1,1,0
30441723@N00,1552,11,1385166166,1385166166,1,1,0
30460784@N04,1553,30,1322028519,1322028519,1,1,0
30460784@N04,1554,22,1322300106,1322300106,1,1,0
30460784@N04,1555,8,1327115143,1327115143,1,1,0
30460784@N04,1556,22,1331871201,1331871850,2,1,649
30460784@N04,1557,22,1348915111,1348915111,1,1,0
30624156@N00,1558,25,1224993577,1224993880,2,1,303
30624156@N00,1559,3,1229552781,1229552858,3,1,77
30624156@N00,1560,11,1240034053,1240035689,12,1,1636
30624156@N00,1561,27,1240632207,1240632207,1,1,0
30624156@N00,1562,3,1242465959,1242466020,2,1,61
30624156@N00,1563,27,1242539054,1242539242,3,1,188
30624156@N00,1564,3,1242629151,1242629151,1,1,0
30624156@N00,1565,22,1243005446,1243005733,3,2,287
30624156@N00,1565,28,1243005733,1243005733,1,2,0
30624156@N00,1566,24,1243065900,1243065900,2,1,0
30624156@N00,1567,21,1243145128,1243148820,8,1,3692
30624156@N00,1568,21,1243609288,1243609288,1,1,0
30624156@N00,1569,25,1243664917,1243664917,1,1,0
30624156@N00,1570,22,1244355300,1244355300,1,1,0
30624156@N00,1571,22,1244644117,1244644117,1,2,0
30624156@N00,1571,28,1244644117,1244644117,2,2,0
30624156@N00,1572,6,1244724930,1244725016,6,1,86
30624156@N00,1573,24,1244807520,1244807520,1,1,0
30624156@N00,1574,21,1245668400,1245668400,1,1,0
30624156@N00,1575,3,1246965555,1246965555,3,1,0
30624156@N00,1576,30,1247377405,1247377405,1,1,0
30624156@N00,1577,3,1247566794,1247575793,4,1,8999
30624156@N00,1578,7,1247888087,1247888087,1,2,0
30624156@N00,1578,24,1247890795,1247900406,5,2,9611
30624156@N00,1579,12,1247966796,1247983295,5,1,16499
30624156@N00,1580,12,1251522001,1251522001,1,1,0
30624156@N00,1581,27,1252825758,1252825758,1,1,0
30624156@N00,1582,21,1254833204,1254833204,1,1,0
30624156@N00,1583,21,1254903357,1254903512,3,1,155
30624156@N00,1584,21,1256449724,1256449724,1,1,0
30624156@N00,1585,23,1257579013,1257579013,1,1,0
30624156@N00,1586,6,1262412700,1262412913,3,2,213
30624156@N00,1586,21,1262417405,1262417406,2,2,1
30624156@N00,1587,21,1266643324,1266643324,1,1,0
30624156@N00,1588,21,1266740413,1266742742,4,1,2329
30624156@N00,1589,21,1271481251,1271491975,2,1,10724
30624156@N00,1590,7,1276946930,1276947178,3,1,248
30624156@N00,1591,7,1277112898,1277112898,1,4,0
30624156@N00,1591,8,1277111999,1277112103,3,4,104
30624156@N00,1591,16,1277111425,1277111687,3,4,262
30624156@N00,1591,30,1277112469,1277112607,2,4,138
30624156@N00,1592,21,1277612520,1277612578,2,4,58
30624156@N00,1592,22,1277613837,1277613837,1,4,0
30624156@N00,1592,23,1277612915,1277615318,2,4,2403
30624156@N00,1592,28,1277615137,1277615137,1,4,0
30624156@N00,1593,15,1278497033,1278497033,1,1,0
30624156@N00,1594,29,1280032811,1280032811,1,1,0
30624156@N00,1595,11,1282034447,1282034447,1,1,0
30624156@N00,1596,2,1283241751,1283241751,1,2,0
30624156@N00,1596,14,1283243578,1283243578,1,2,0
30624156@N00,1597,22,1284789655,1284789924,3,1,269
30624156@N00,1598,7,1286018306,1286018425,2,5,119
30624156@N00,1598,22,1286022563,1286022563,1,5,0
30624156@N00,1598,27,1286030627,1286030627,1,5,0
30624156@N00,1598,28,1286017396,1286022401,3,5,5005
30624156@N00,1598,30,1286019538,1286019538,1,5,0
30624156@N00,1599,3,1288525150,1288526274,3,1,1124
30624156@N00,1600,29,1290313737,1290317894,33,1,4157
30624156@N00,1601,21,1294110683,1294113233,5,1,2550
30624156@N00,1602,27,1302254257,1302255051,4,1,794
30624156@N00,1603,21,1302418175,1302418175,1,1,0
30624156@N00,1604,21,1305026094,1305026094,1,1,0
30624156@N00,1605,7,1308312570,1308312842,6,2,272
30624156@N00,1605,21,1308314561,1308314684,2,2,123
30624156@N00,1606,27,1308453356,1308453856,3,1,500
30624156@N00,1607,2,1313830031,1313830031,1,1,0
30624156@N00,1608,22,1314436419,1314437501,2,1,1082
30624156@N00,1609,22,1314511928,1314511928,1,1,0
30624156@N00,1610,21,1338089629,1338090757,7,2,1128
30624156@N00,1610,22,1338100555,1338101930,15,2,1375
30624156@N00,1611,10,1342265196,1342265196,1,1,0
30649486@N07,1612,22,1230004844,1230004844,1,1,0
30739892@N03,1613,23,1279056596,1279056596,1,1,0
30739892@N03,1614,25,1283554591,1283556306,5,1,1715
30739892@N03,1615,25,1286012266,1286012266,1,1,0
30739892@N03,1616,16,1287365820,1287367126,5,1,1306
30739892@N03,1617,25,1290136654,1290137049,12,1,395
30739892@N03,1618,21,1291177235,1291179847,2,2,2612
30739892@N03,1618,22,1291200629,1291200629,1,2,0
30739892@N03,1619,25,1309695617,1309695968,6,1,351
30739892@N03,1620,21,1311162011,1311162011,1,3,0
30739892@N03,1620,22,1311141262,1311141633,5,3,371
30739892@N03,1620,28,1311141188,1311141212,2,3,24
30739892@N03,1621,25,1311232451,1311238376,37,1,5925
30739892@N03,1622,22,1335937607,1335939996,21,2,2389
30739892@N03,1622,28,1335937856,1335939400,2,2,1544
30757616@N03,1623,21,1324180918,1324180918,1,1,0
30769448@N00,1624,11,1362731664,1362732269,2,1,605
30769448@N00,1625,6,1376637702,1376638700,8,1,998
30769448@N00,1626,6,1391918412,1391918424,2,1,12
30855862@N07,1627,1,1245737156,1245737156,1,3,0
30855862@N07,1627,7,1245729150,1245729930,3,3,780
30855862@N07,1627,16,1245738975,1245739626,2,3,651
30855862@N07,1628,7,1248496961,1248497140,3,1,179
30928442@N08,1629,25,1370269276,1370269276,1,1,0
30934989@N06,1630,16,1335691985,1335691985,1,1,0
30934989@N06,1631,11,1335763752,1335763855,2,2,103
30934989@N06,1631,27,1335748443,1335748443,1,2,0
30934989@N06,1632,11,1337474297,1337474297,1,1,0
30981722@N00,1633,30,1311882475,1311882475,1,1,0
30981722@N00,1634,11,1343965267,1343969398,2,1,4131
31018257@N00,1635,30,1126363433,1126363433,1,1,0
31018257@N00,1636,14,1191056970,1191056970,1,1,0
31018257@N00,1637,30,1191145193,1191145193,1,1,0
31018257@N00,1638,22,1191229121,1191229121,1,1,0
31018257@N00,1639,22,1297674491,1297674491,1,1,0
31105156@N08,1640,21,1254585396,1254585569,2,2,173
31105156@N08,1640,22,1254583303,1254583473,2,2,170
31105156@N08,1641,2,1283250459,1283250459,1,1,0
31114347@N05,1642,8,1246694625,1246694625,1,3,0
31114347@N05,1642,24,1246688121,1246689124,5,3,1003
31114347@N05,1642,30,1246695336,1246695869,2,3,533
31185142@N00,1643,22,1393911159,1393911159,1,1,0
31185142@N00,1644,6,1395275766,1395275766,1,1,0
31185142@N00,1645,11,1397875617,1397878850,4,1,3233
31199821@N06,1646,7,1238192781,1238192781,1,1,0
31199821@N06,1647,21,1241430175,1241430175,1,1,0
31334159@N07,1648,28,1379748503,1379748503,1,1,0
31349854@N00,1649,30,1180237494,1180237494,1,1,0
31349854@N00,1650,22,1213687292,1213687292,1,1,0
31349854@N00,1651,30,1267934112,1267935075,2,1,963
31349854@N00,1652,22,1275273788,1275273788,1,1,0
31349854@N00,1653,22,1315633426,1315633426,1,3,0
31349854@N00,1653,23,1315632024,1315632024,1,3,0
31349854@N00,1653,25,1315637558,1315637558,1,3,0
31349854@N00,1654,23,1316317326,1316317326,1,1,0
31349854@N00,1655,23,1318047649,1318047649,1,1,0
31349854@N00,1656,12,1325122352,1325122352,1,1,0
31349854@N00,1657,21,1344303835,1344303835,1,1,0
31349854@N00,1658,1,1346307401,1346307401,1,1,0
31349854@N00,1659,6,1352606851,1352606851,1,1,0
31361169@N05,1660,16,268063200,268063200,15,1,0
31363435@N07,1661,1,1173244942,1173244942,1,1,0
31499593@N03,1662,12,1248911255,1248911255,1,1,0
31499593@N03,1663,12,1250391088,1250393874,2,1,2786
31499593@N03,1664,12,1270428598,1270428598,1,1,0
31499593@N03,1665,7,1273442633,1273442752,6,1,119
31499593@N03,1666,12,1273984483,1273984607,4,1,124
31499593@N03,1667,7,1275545826,1275547443,2,1,1617
31499593@N03,1668,12,1275804674,1275804838,4,1,164
31499593@N03,1669,12,1277613416,1277614560,10,1,1144
31499593@N03,1670,30,1278021896,1278021907,2,1,11
31499593@N03,1671,7,1279137795,1279137795,1,1,0
31499593@N03,1672,19,1283064509,1283064578,4,1,69
31499593@N03,1673,11,1283481129,1283481966,3,1,837
31499593@N03,1674,12,1284264439,1284265899,6,1,1460
31499593@N03,1675,12,1298160424,1298168602,2,1,8178
31499593@N03,1676,12,1303441494,1303441657,3,1,163
31499593@N03,1677,30,1303855792,1303855792,1,1,0
31499593@N03,1678,11,1305163770,1305164708,6,2,938
31499593@N03,1678,27,1305163437,1305163447,4,2,10
31499593@N03,1679,12,1325480950,1325481065,4,1,115
31499593@N03,1680,12,1329709057,1329709057,1,1,0
31499593@N03,1681,12,1333686524,1333686524,1,1,0
31499593@N03,1682,11,1340414778,1340424329,33,1,9551
31499593@N03,1683,11,1340457662,1340457910,2,1,248
31499593@N03,1684,11,1340760392,1340760853,5,1,461
31499593@N03,1685,12,1345854871,1345877091,15,1,22220
31499593@N03,1686,11,1356740449,1356753691,30,1,13242
31499593@N03,1687,11,1357948471,1357958937,19,1,10466
31499593@N03,1688,11,1357990889,1357990889,1,1,0
31499593@N03,1689,11,1358069302,1358069318,3,1,16
31499593@N03,1690,12,1363400167,1363400592,3,1,425
31499593@N03,1691,12,1364525308,1364526070,6,1,762
31499593@N03,1692,11,1371958263,1371966250,8,1,7987
31624976@N00,1693,7,1307844475,1307844736,4,1,261
31624976@N00,1694,6,1373083096,1373089940,5,1,6844
31671926@N00,1695,4,1121840556,1121844503,13,1,3947
31857543@N04,1696,23,1322736747,1322736747,1,1,0
31874779@N00,1697,23,1346384658,1346384658,1,1,0
31911001@N00,1698,25,1306036475,1306037056,5,1,581
31911001@N00,1699,24,1306405136,1306405136,1,1,0
31911001@N00,1700,25,1307161357,1307164285,7,1,2928
31911001@N00,1701,20,1316502532,1316502532,1,1,0
31911001@N00,1702,20,1316647547,1316647547,1,1,0
31911001@N00,1703,25,1316917970,1316922253,11,1,4283
31911001@N00,1704,20,1317969734,1317969734,1,1,0
31911001@N00,1705,20,1319322435,1319323155,2,1,720
31911001@N00,1706,25,1320372986,1320373729,2,1,743
31911001@N00,1707,25,1321519151,1321519257,3,1,106
31911001@N00,1708,25,1321580306,1321581487,2,1,1181
31911001@N00,1709,18,1322031943,1322032301,2,1,358
31911001@N00,1710,25,1323848818,1323849623,4,1,805
31911001@N00,1711,24,1325898757,1325900699,8,1,1942
31911001@N00,1712,24,1327713541,1327714473,4,1,932
31911001@N00,1713,23,1336996661,1336996661,1,1,0
31911001@N00,1714,7,1337140117,1337140117,1,1,0
31911001@N00,1715,27,1338635849,1338635849,1,1,0
31911001@N00,1716,25,1339466645,1339469367,2,1,2722
31911001@N00,1717,24,1346635193,1346636388,7,1,1195
31911001@N00,1718,1,1354700335,1354706633,7,1,6298
31911001@N00,1719,25,1361757873,1361757873,1,1,0
31911001@N00,1720,25,1362131277,1362132140,4,1,863
31911001@N00,1721,8,1388880233,1388880233,1,1,0
31925743@N00,1722,3,1247591146,1247591146,1,1,0
32038338@N02,1723,7,488982173,488982173,1,1,0
32038338@N02,1724,23,1049514346,1049514346,1,1,0
32038338@N02,1725,7,1166139482,1166139482,1,2,0
32038338@N02,1725,23,1166138653,1166139153,3,2,500
32044903@N04,1726,7,1299261425,1299261498,4,3,73
32044903@N04,1726,27,1299261453,1299261468,2,3,15
32044903@N04,1726,28,1299261409,1299261416,2,3,7
32099449@N00,1727,16,1096174800,1096174800,2,1,0
32132568@N06,1728,30,1303945398,1303945524,2,1,126
32155291@N05,1729,7,1290012420,1290012880,2,1,460
32155291@N05,1730,30,1304226037,1304226037,1,1,0
32155291@N05,1731,30,1306435674,1306435674,1,1,0
32155291@N05,1732,4,1311944525,1311945603,3,1,1078
32188688@N00,1733,26,1140873858,1140873892,7,1,34
32188688@N00,1734,26,1140952141,1140960252,6,1,8111
32188688@N00,1735,4,1152414024,1152414641,2,1,617
32188688@N00,1736,23,1178881692,1178889936,15,1,8244
32188688@N00,1737,22,1275119369,1275119369,1,2,0
32188688@N00,1737,30,1275116730,1275116864,2,2,134
32188688@N00,1738,11,1289388521,1289388521,1,1,0
32188688@N00,1739,6,1289552036,1289552036,1,1,0
32188688@N00,1740,6,1289620613,1289620613,1,1,0
32188688@N00,1741,21,1291283428,1291283428,1,1,0
32188688@N00,1742,23,1292316399,1292319252,2,1,2853
32188688@N00,1743,27,1292484831,1292485450,2,1,619
32188688@N00,1744,27,1292568144,1292568144,1,1,0
32188688@N00,1745,25,1293093622,1293093622,1,1,0
32188688@N00,1746,25,1293157519,1293157519,1,1,0
32188688@N00,1747,21,1294037733,1294037733,1,1,0
32188688@N00,1748,25,1294547705,1294547705,1,1,0
32188688@N00,1749,25,1294659014,1294659014,1,1,0
32188688@N00,1750,21,1295858101,1295858101,1,1,0
32188688@N00,1751,21,1296806552,1296806552,1,1,0
32188688@N00,1752,21,1297067452,1297067452,1,1,0
32188688@N00,1753,21,1297324140,1297324140,1,1,0
32188688@N00,1754,21,1297410899,1297410899,1,1,0
32188688@N00,1755,21,1297668912,1297668912,1,1,0
32188688@N00,1756,21,1297842693,1297842693,1,1,0
32188688@N00,1757,21,1298018051,1298018334,2,1,283
32188688@N00,1758,21,1298448134,1298448134,1,1,0
32188688@N00,1759,21,1298615192,1298622255,2,1,7063
32188688@N00,1760,21,1299225506,1299226467,2,1,961
32188688@N00,1761,21,1300261702,1300261702,1,2,0
32188688@N00,1761,28,1300262426,1300262426,1,2,0
32188688@N00,1762,21,1300780879,1300780879,1,1,0
32188688@N00,1763,21,1301386257,1301386257,1,1,0
32188688@N00,1764,21,1301470915,1301470915,1,1,0
32188688@N00,1765,27,1301559382,1301559382,1,1,0
32188688@N00,1766,27,1301607204,1301607204,1,1,0
32188688@N00,1767,27,1301639941,1301639941,1,1,0
32188688@N00,1768,21,1302680835,1302680835,1,1,0
32228245@N03,1769,27,1341111987,1341111987,1,1,0
32401601@N00,1770,11,1185426589,1185426589,1,1,0
32401601@N00,1771,16,1185541148,1185541148,1,2,0
32401601@N00,1771,19,1185524004,1185525879,2,2,1875
32437467@N00,1772,11,1286021590,1286025817,5,2,4227
32437467@N00,1772,21,1286038384,1286038384,1,2,0
32437467@N00,1773,11,1316734508,1316764117,7,1,29609
32567307@N00,1774,22,1381855875,1381855875,1,1,0
32665807@N06,1775,12,1253407379,1253427746,31,1,20367
32665807@N06,1776,21,1263542695,1263542789,4,1,94
32693718@N07,1777,23,-46951199,-46951199,1,1,0
32693718@N07,1778,23,801756012,801756012,1,1,0
32693718@N07,1779,19,1024063206,1024063206,1,1,0
32756135@N00,1780,13,1194141171,1194141171,1,1,0
32756135@N00,1781,22,1198655837,1198655837,1,1,0
32781576@N04,1782,22,1379745699,1379749686,4,3,3987
32781576@N04,1782,25,1379751219,1379754562,2,3,3343
32781576@N04,1782,28,1379745525,1379745525,1,3,0
32781576@N04,1783,13,1379895637,1379898742,7,2,3105
32781576@N04,1783,16,1379890561,1379895029,5,2,4468
32781576@N04,1784,16,1380631689,1380631689,1,1,0
32806164@N07,1785,16,1369970842,1369970842,1,1,0
32827327@N03,1786,6,1349991430,1349991430,1,6,0
32827327@N03,1786,11,1349999363,1349999363,1,6,0
32827327@N03,1786,20,1349984005,1349988336,3,6,4331
32827327@N03,1786,24,1350009164,1350009164,1,6,0
32827327@N03,1786,25,1349993585,1349994936,2,6,1351
32827327@N03,1786,30,1350005067,1350005397,3,6,330
32876255@N06,1787,15,1345878322,1345878322,1,2,0
32876255@N06,1787,19,1345878605,1345880380,3,2,1775
32876255@N06,1788,23,1347024181,1347024819,7,1,638
32876255@N06,1789,23,1347086759,1347087173,3,1,414
32876255@N06,1790,23,1347344504,1347357796,2,1,13292
32876255@N06,1791,23,1347534933,1347534933,1,1,0
32934461@N00,1792,8,1275371073,1275376129,11,4,5056
32934461@N00,1792,16,1275367345,1275370849,25,4,3504
32934461@N00,1792,21,1275388150,1275399323,7,4,11173
32934461@N00,1792,30,1275366549,1275366743,4,4,194
32934461@N00,1793,21,1275567892,1275568824,6,1,932
32934461@N00,1794,30,1275770789,1275770819,2,1,30
32944866@N04,1795,22,1217048485,1217056432,34,1,7947
32944866@N04,1796,11,1334973097,1334973097,1,3,0
32944866@N04,1796,22,1334969434,1334969461,2,3,27
32944866@N04,1796,29,1334970833,1334970873,2,3,40
33016744@N07,1797,16,1365049923,1365051858,3,1,1935
33123827@N00,1798,21,1081591880,1081591880,1,1,0
33123827@N00,1799,22,1124787220,1124787242,2,1,22
33163632@N00,1800,21,1155422069,1155424717,2,1,2648
33182025@N00,1801,19,1177145788,1177145788,1,1,0
33182025@N00,1802,7,1187416585,1187416585,1,4,0
33182025@N00,1802,19,1187413235,1187413235,1,4,0
33182025@N00,1802,21,1187418200,1187418200,1,4,0
33182025@N00,1802,23,1187416787,1187416787,1,4,0
33228691@N00,1803,4,1087095615,1087095719,3,1,104
33246890@N00,1804,1,1275778982,1275779031,8,1,49
33318362@N00,1805,3,1359174970,1359174970,1,1,0
33403520@N05,1806,21,1209124853,1209124853,1,1,0
33403520@N05,1807,28,1236422675,1236422675,1,1,0
33403520@N05,1808,7,1236516605,1236516810,3,1,205
33403520@N05,1809,21,1237603745,1237607201,16,1,3456
33403520@N05,1810,21,1237703905,1237704154,3,1,249
33403520@N05,1811,1,1248450725,1248450949,4,2,224
33403520@N05,1811,16,1248451663,1248451663,1,2,0
33403520@N05,1812,24,1251584280,1251585580,5,1,1300
33403520@N05,1813,30,1261156167,1261156167,1,1,0
33403520@N05,1814,21,1262131939,1262131939,1,1,0
33403520@N05,1815,21,1262174940,1262175046,2,1,106
33421999@N06,1816,6,1241138490,1241142064,6,1,3574
33455071@N00,1817,16,1224137702,1224137702,1,1,0
33455071@N00,1818,21,1237081385,1237084465,66,2,3080
33455071@N00,1818,22,1237085061,1237085313,5,2,252
33455071@N00,1819,21,1246547633,1246547633,1,1,0
33473816@N00,1820,30,1283302292,1283302292,1,1,0
33473816@N00,1821,11,1294446124,1294446124,1,2,0
33473816@N00,1821,27,1294452829,1294453166,3,2,337
33473816@N00,1822,7,1304023443,1304023443,1,1,0
33473816@N00,1823,1,1305872916,1305872967,2,1,51
33473816@N00,1824,23,1306221627,1306221627,1,1,0
33473816@N00,1825,11,1306304949,1306304949,1,1,0
33473816@N00,1826,27,1306737124,1306737124,1,1,0
33473816@N00,1827,11,1306910218,1306910218,1,1,0
33473816@N00,1828,13,1306991308,1306991966,2,2,658
33473816@N00,1828,21,1306995558,1306995558,1,2,0
33473816@N00,1829,30,1307078960,1307078960,1,1,0
33473816@N00,1830,27,1307430535,1307430535,1,1,0
33473816@N00,1831,30,1331696971,1331696971,1,1,0
33473816@N00,1832,30,1332301864,1332301864,1,1,0
33473816@N00,1833,30,1335329349,1335329349,1,1,0
33473816@N00,1834,30,1336543694,1336543694,1,1,0
33473816@N00,1835,8,1338001641,1338001641,1,3,0
33473816@N00,1835,22,1337998110,1337998110,1,3,0
33473816@N00,1835,30,1338002898,1338003046,2,3,148
33473816@N00,1836,30,1343596282,1343596282,1,1,0
33473816@N00,1837,30,1348989092,1348989092,1,1,0
33473816@N00,1838,30,1349212914,1349212914,1,1,0
33473816@N00,1839,30,1349387508,1349387537,2,1,29
33473816@N00,1840,27,1349852409,1349852409,1,1,0
33473816@N00,1841,1,1350285992,1350285992,1,1,0
33473816@N00,1842,30,1350937126,1350937126,1,1,0
33473816@N00,1843,30,1358198896,1358198927,2,1,31
33473816@N00,1844,11,1358285359,1358285359,1,1,0
33473816@N00,1845,30,1358750749,1358750749,1,1,0
33473816@N00,1846,30,1358805189,1358805689,2,1,500
33473816@N00,1847,30,1359408231,1359408231,1,1,0
33473816@N00,1848,30,1359580979,1359580979,1,1,0
33473816@N00,1849,30,1361525981,1361526070,2,1,89
33473816@N00,1850,7,1361827884,1361827884,1,1,0
33473816@N00,1851,30,1361999908,1361999908,1,1,0
33473816@N00,1852,30,1362086426,1362086426,1,1,0
33473816@N00,1853,30,1362347088,1362347088,1,1,0
33473816@N00,1854,1,1362432605,1362433108,2,2,503
33473816@N00,1854,30,1362433862,1362433862,1,2,0
33473816@N00,1855,1,1364331380,1364331380,1,1,0
33473816@N00,1856,30,1365140830,1365140830,1,1,0
33473816@N00,1857,30,1366180993,1366180993,1,1,0
33473816@N00,1858,30,1366236441,1366246014,2,1,9573
33473816@N00,1859,7,1366668532,1366668840,2,1,308
33473816@N00,1860,30,1366699671,1366699801,2,1,130
33473816@N00,1861,30,1367390690,1367390690,1,1,0
33473816@N00,1862,30,1367908950,1367908950,1,1,0
33473816@N00,1863,23,1368084065,1368084065,1,1,0
33473816@N00,1864,23,1368188533,1368188533,1,2,0
33473816@N00,1864,30,1368167971,1368167971,1,2,0
33473816@N00,1865,7,1368569293,1368569293,1,3,0
33473816@N00,1865,27,1368582039,1368582039,1,3,0
33473816@N00,1865,30,1368602327,1368602327,1,3,0
33473816@N00,1866,1,1369203698,1369203698,1,1,0
33473816@N00,1867,30,1369281144,1369295068,2,1,13924
33473816@N00,1868,30,1369462165,1369462165,1,1,0
33473816@N00,1869,22,1369780364,1369780364,1,1,0
33473816@N00,1870,30,1369874535,1369874535,1,1,0
33473816@N00,1871,30,1370409877,1370409877,1,1,0
33473816@N00,1872,30,1370690297,1370690297,1,1,0
33473816@N00,1873,7,1370751108,1370751108,1,2,0
33473816@N00,1873,30,1370774828,1370774828,1,2,0
33473816@N00,1874,30,1370816971,1370816971,1,1,0
33547369@N00,1875,22,1181367077,1181367120,2,3,43
33547369@N00,1875,23,1181370916,1181370916,1,3,0
33547369@N00,1875,28,1181367244,1181370078,2,3,2834
33547369@N00,1876,22,1201947303,1201954229,6,1,6926
33547369@N00,1877,21,1206067962,1206068534,10,3,572
33547369@N00,1877,22,1206069566,1206074801,11,3,5235
33547369@N00,1877,23,1206065274,1206074524,83,3,9250
33547369@N00,1878,21,1221276156,1221276303,4,1,147
33562486@N07,1879,27,1252480365,1252480365,1,1,0
33562486@N07,1880,22,1294295836,1294295836,1,1,0
33562486@N07,1881,27,1325824710,1325824710,1,1,0
33609631@N00,1882,7,1226646286,1226646286,1,2,0
33609631@N00,1882,11,1226643741,1226644868,4,2,1127
33622752@N04,1883,7,1243597908,1243600593,5,1,2685
33622752@N04,1884,22,1247054382,1247054382,1,1,0
33739230@N02,1885,16,1312893463,1312893463,1,2,0
33739230@N02,1885,30,1312879279,1312879279,1,2,0
33745415@N00,1886,24,1220087358,1220092327,4,1,4969
33795079@N06,1887,7,1300963464,1300963464,1,1,0
33795079@N06,1888,7,1301110756,1301110756,1,2,0
33795079@N06,1888,16,1301110847,1301114987,9,2,4140
33795079@N06,1889,7,1301575748,1301575748,1,1,0
33795079@N06,1890,16,1301699559,1301699559,1,1,0
33825173@N00,1891,16,1277956006,1277961294,4,1,5288
33835814@N04,1892,26,1357896281,1357896281,1,1,0
33906853@N00,1893,6,1237426094,1237432690,9,1,6596
33906853@N00,1894,1,1237535427,1237539008,3,3,3581
33906853@N00,1894,22,1237525158,1237525529,3,3,371
33906853@N00,1894,29,1237527721,1237527721,1,3,0
33938491@N07,1895,30,1320236225,1320236225,1,1,0
33938491@N07,1896,25,1320910837,1320910837,1,1,0
33938491@N07,1897,6,1322205114,1322205114,1,1,0
33938491@N07,1898,11,1326428892,1326428892,1,1,0
33938510@N00,1899,22,1142571693,1142571693,1,1,0
33956295@N04,1900,23,1293853587,1293853587,1,1,0
33956295@N04,1901,17,1314687187,1314692281,2,1,5094
33956295@N04,1902,24,1330633557,1330633557,1,1,0
33956295@N04,1903,28,1353468479,1353468479,1,1,0
33956295@N04,1904,21,1354157427,1354157427,1,1,0
33956295@N04,1905,25,1373079533,1373087603,2,1,8070
33956295@N04,1906,21,1375676311,1375676311,1,1,0
33956295@N04,1907,27,1380266662,1380266662,1,1,0
34067201@N03,1908,7,1247205248,1247212382,8,1,7134
34067201@N03,1909,7,1252404893,1252404893,1,1,0
34075985@N04,1910,11,1337847884,1337853020,13,2,5136
34075985@N04,1910,24,1337842171,1337842551,10,2,380
34075985@N04,1911,11,1338171190,1338171205,5,1,15
34128007@N04,1912,1,1348024141,1348024141,1,5,0
34128007@N04,1912,4,1348023764,1348023764,1,5,0
34128007@N04,1912,8,1348015374,1348015374,1,5,0
34128007@N04,1912,16,1348019119,1348027596,4,5,8477
34128007@N04,1912,29,1348026335,1348026662,3,5,327
34211328@N00,1913,1,1227850751,1227850751,1,2,0
34211328@N00,1913,21,1227871499,1227871499,1,2,0
34211328@N00,1914,23,1228538561,1228539888,4,1,1327
34211328@N00,1915,22,1230943265,1230943265,1,1,0
34211328@N00,1916,18,1240639715,1240640150,3,1,435
34211328@N00,1917,11,1241237741,1241237903,3,1,162
34211328@N00,1918,4,1242887882,1242887916,2,3,34
34211328@N00,1918,24,1242872871,1242873461,2,3,590
34211328@N00,1918,30,1242871053,1242871053,1,3,0
34211328@N00,1919,3,1243072073,1243081811,24,1,9738
34211328@N00,1920,21,1243505706,1243512241,7,1,6535
34211328@N00,1921,21,1243689108,1243689307,4,1,199
34211328@N00,1922,3,1243835031,1243835031,1,1,0
34211328@N00,1923,10,1246076368,1246081870,7,2,5502
34211328@N00,1923,21,1246084601,1246091653,4,2,7052
34211328@N00,1924,21,1247018674,1247020168,6,1,1494
34211328@N00,1925,14,1247182671,1247199136,47,2,16465
34211328@N00,1925,17,1247184842,1247204710,20,2,19868
34211328@N00,1926,24,1249275430,1249285045,3,1,9615
34211328@N00,1927,21,1249513306,1249513306,1,2,0
34211328@N00,1927,22,1249513850,1249513850,1,2,0
34211328@N00,1928,6,1249963618,1249989063,6,2,25445
34211328@N00,1928,22,1249989715,1249989816,3,2,101
34211328@N00,1929,11,1250311680,1250311680,1,1,0
34211328@N00,1930,21,1251007273,1251010689,14,2,3416
34211328@N00,1930,22,1251002708,1251006415,7,2,3707
34211328@N00,1931,21,1251181513,1251199767,2,3,18254
34211328@N00,1931,22,1251182312,1251182312,1,3,0
34211328@N00,1931,23,1251181875,1251183108,3,3,1233
34211328@N00,1932,7,1251251663,1251254840,23,2,3177
34211328@N00,1932,30,1251251472,1251255367,5,2,3895
34211328@N00,1933,2,1251349026,1251349037,2,3,11
34211328@N00,1933,14,1251356492,1251357821,3,3,1329
34211328@N00,1933,17,1251349211,1251368286,27,3,19075
34211328@N00,1934,7,1251525100,1251531713,3,3,6613
34211328@N00,1934,8,1251519175,1251521745,20,3,2570
34211328@N00,1934,16,1251524272,1251524272,1,3,0
34211328@N00,1935,7,1251848817,1251848817,1,2,0
34211328@N00,1935,30,1251847989,1251847989,1,2,0
34211328@N00,1936,14,1252063789,1252064102,2,2,313
34211328@N00,1936,17,1252054722,1252065480,15,2,10758
34211328@N00,1937,2,1252288388,1252307732,2,3,19344
34211328@N00,1937,14,1252308216,1252308216,1,3,0
34211328@N00,1937,17,1252288220,1252288220,1,3,0
34211328@N00,1938,11,1252758584,1252758584,1,4,0
34211328@N00,1938,14,1252736857,1252736857,1,4,0
34211328@N00,1938,17,1252736690,1252736690,1,4,0
34211328@N00,1938,27,1252743032,1252743032,1,4,0
34211328@N00,1939,21,1252826270,1252838138,24,1,11868
34211328@N00,1940,6,1254570271,1254571046,4,5,775
34211328@N00,1940,11,1254564872,1254568383,10,5,3511
34211328@N00,1940,22,1254575066,1254575986,3,5,920
34211328@N00,1940,23,1254573918,1254574263,2,5,345
34211328@N00,1940,29,1254569164,1254569164,1,5,0
34211328@N00,1941,25,1256361732,1256362204,3,1,472
34211328@N00,1942,15,1257642836,1257642836,1,1,0
34211328@N00,1943,10,1258164321,1258174763,21,1,10442
34211328@N00,1944,7,1260689379,1260689518,2,1,139
34211328@N00,1945,22,1261034641,1261040739,32,1,6098
34211328@N00,1946,25,1261379188,1261381250,8,1,2062
34211328@N00,1947,11,1263015153,1263015153,1,2,0
34211328@N00,1947,25,1263001921,1263007492,3,2,5571
34211328@N00,1948,21,1263894654,1263901346,11,1,6692
34211328@N00,1949,8,1264025027,1264025166,3,3,139
34211328@N00,1949,13,1264042147,1264045567,11,3,3420
34211328@N00,1949,16,1264027189,1264030979,5,3,3790
34211328@N00,1950,30,1266740354,1266740749,3,1,395
34211328@N00,1951,2,1267939548,1267939784,2,2,236
34211328@N00,1951,17,1267940553,1267940553,1,2,0
34211328@N00,1952,11,1268434216,1268435405,3,2,1189
34211328@N00,1952,29,1268449306,1268449306,1,2,0
34211328@N00,1953,21,1285307045,1285307045,1,1,0
34211328@N00,1954,21,1285376964,1285376964,1,2,0
34211328@N00,1954,25,1285386765,1285394763,17,2,7998
34211328@N00,1955,23,1290838798,1290839385,5,2,587
34211328@N00,1955,28,1290839974,1290839974,1,2,0
34211328@N00,1956,7,1294359804,1294360032,2,1,228
34211328@N00,1957,7,1294796945,1294796992,2,1,47
34211328@N00,1958,8,1294885138,1294885138,1,2,0
34211328@N00,1958,16,1294884705,1294884949,2,2,244
34211328@N00,1959,24,1295060520,1295062578,10,1,2058
34211328@N00,1960,1,1295311085,1295316544,38,1,5459
34211328@N00,1961,25,1295404766,1295405278,6,1,512
34211328@N00,1962,6,1295834444,1295834444,1,1,0
34211328@N00,1963,4,1295912790,1295912790,1,1,0
34211328@N00,1964,6,1296877631,1296878058,5,2,427
34211328@N00,1964,16,1296864304,1296864974,4,2,670
34211328@N00,1965,16,1298514313,1298523865,20,1,9552
34211328@N00,1966,10,1299281700,1299284796,7,1,3096
34211328@N00,1967,25,1299888951,1299888951,1,1,0
34211328@N00,1968,7,1303435200,1303463671,7,5,28471
34211328@N00,1968,21,1303450488,1303451090,2,5,602
34211328@N00,1968,22,1303440830,1303440830,1,5,0
34211328@N00,1968,23,1303451675,1303452256,2,5,581
34211328@N00,1968,30,1303436563,1303464353,6,5,27790
34211328@N00,1969,7,1304126164,1304128176,4,3,2012
34211328@N00,1969,28,1304129941,1304129941,1,3,0
34211328@N00,1969,29,1304140016,1304141225,4,3,1209
34211328@N00,1970,16,1305793278,1305793278,1,1,0
34211328@N00,1971,16,1307666732,1307666732,1,1,0
34211328@N00,1972,21,1308125661,1308126460,4,1,799
34211328@N00,1973,6,1309570640,1309575982,9,2,5342
34211328@N00,1973,21,1309583778,1309583778,1,2,0
34211328@N00,1974,8,1310691680,1310691680,1,1,0
34211328@N00,1975,25,1312081327,1312083120,6,1,1793
34211328@N00,1976,29,1312606855,1312606855,1,1,0
34211328@N00,1977,7,1314421228,1314424740,13,2,3512
34211328@N00,1977,8,1314419429,1314419672,5,2,243
34211328@N00,1978,7,1314457954,1314458075,2,1,121
34211328@N00,1979,22,1314693999,1314695396,11,1,1397
34211328@N00,1980,21,1316827855,1316827855,1,1,0
34211328@N00,1981,21,1316860928,1316864517,9,1,3589
34211328@N00,1982,6,1316918789,1316918789,1,2,0
34211328@N00,1982,25,1316908826,1316916393,8,2,7567
34211328@N00,1983,28,1320969052,1320973945,23,1,4893
34211328@N00,1984,21,1321099238,1321105179,4,1,5941
34211328@N00,1985,23,1321570618,1321571359,5,2,741
34211328@N00,1985,28,1321570051,1321570051,1,2,0
34211328@N00,1986,23,1321680238,1321682649,5,1,2411
34211328@N00,1987,11,1322008960,1322008960,1,1,0
34211328@N00,1988,27,1324101112,1324108301,13,1,7189
34268979@N05,1989,16,1368850843,1368850843,1,1,0
34289491@N03,1990,3,1290928403,1290928911,5,1,508
34289491@N03,1991,3,1298541551,1298541673,3,1,122
34289491@N03,1992,6,1316225387,1316229888,25,2,4501
34289491@N03,1992,25,1316236048,1316236869,13,2,821
34314322@N00,1993,16,1090487690,1090493036,22,5,5346
34314322@N00,1993,22,1090480560,1090480902,4,5,342
34314322@N00,1993,28,1090481347,1090481347,1,5,0
34314322@N00,1993,29,1090482606,1090484499,6,5,1893
34314322@N00,1993,30,1090470812,1090487121,8,5,16309
34342668@N00,1994,22,709912800,709912800,1,1,0
34359854@N00,1995,22,989739013,989739013,1,1,0
34359854@N00,1996,2,1149367292,1149378135,5,1,10843
34405262@N04,1997,25,1287811786,1287811787,2,1,1
34427466731@N01,1998,21,985759597,985759597,2,1,0
34427466731@N01,1999,16,1082772989,1082772989,1,1,0
34427466731@N01,2000,21,1090231405,1090231405,1,1,0
34427466731@N01,2001,21,1106266037,1106266037,1,1,0
34427466731@N01,2002,3,1106626294,1106626993,8,1,699
34427466731@N01,2003,16,1108453411,1108457865,3,1,4454
34427466731@N01,2004,25,1111223620,1111223620,1,1,0
34427466731@N01,2005,21,1111914035,1111914035,1,1,0
34427466731@N01,2006,21,1114856083,1114856083,1,1,0
34427466731@N01,2007,3,1117256528,1117256948,4,1,420
34427466731@N01,2008,21,1117450515,1117450515,1,1,0
34427466731@N01,2009,3,1117488477,1117488477,1,1,0
34427466731@N01,2010,30,1118204778,1118206223,8,1,1445
34427466731@N01,2011,1,1118780479,1118783764,3,1,3285
34427466731@N01,2012,13,1125811013,1125811013,1,1,0
34427466731@N01,2013,13,1125841994,1125842020,2,1,26
34427466731@N01,2014,14,1125912089,1125912308,2,2,219
34427466731@N01,2014,17,1125908910,1125913633,7,2,4723
34427466731@N01,2015,17,1126018172,1126018172,1,1,0
34427466731@N01,2016,28,1126441508,1126441508,2,1,0
34427466731@N01,2017,23,1127292002,1127292002,1,2,0
34427466731@N01,2017,28,1127291184,1127292335,4,2,1151
34427466731@N01,2018,23,1127352941,1127352941,1,1,0
34427466731@N01,2019,11,1159376457,1159376457,1,1,0
34427466731@N01,2020,22,1176527839,1176527839,1,2,0
34427466731@N01,2020,25,1176514301,1176521531,10,2,7230
34427466731@N01,2021,12,1177218723,1177220045,4,1,1322
34608255@N08,2022,11,1223248361,1223248769,2,2,408
34608255@N08,2022,25,1223265108,1223265108,1,2,0
34608255@N08,2023,7,1225331820,1225331820,1,1,0
34608255@N08,2024,7,1272265216,1272265216,1,1,0
34608255@N08,2025,28,1272408836,1272408836,1,1,0
34608255@N08,2026,28,1272464323,1272464323,1,1,0
34608255@N08,2027,7,1273444565,1273444565,1,1,0
34608255@N08,2028,24,1275262944,1275262944,1,1,0
34608255@N08,2029,7,1275331322,1275331322,1,2,0
34608255@N08,2029,30,1275332193,1275332193,1,2,0
34608255@N08,2030,19,1275522026,1275522026,1,1,0
34608255@N08,2031,8,1284699842,1284699842,1,2,0
34608255@N08,2031,21,1284716453,1284716453,1,2,0
34608255@N08,2032,7,1308193361,1308193361,1,1,0
34608255@N08,2033,15,1316232134,1316232134,1,1,0
34608255@N08,2034,10,1318552220,1318552453,2,1,233
34608255@N08,2035,28,1320972843,1320974465,2,1,1622
34608255@N08,2036,7,1325032805,1325032805,1,3,0
34608255@N08,2036,11,1325032001,1325032001,1,3,0
34608255@N08,2036,22,1325031466,1325031466,1,3,0
34608255@N08,2037,22,1368670543,1368672689,2,1,2146
34619038@N00,2038,16,1060247702,1060247711,2,1,9
34619038@N00,2039,6,1060329282,1060330234,3,3,952
34619038@N00,2039,22,1060294869,1060316257,4,3,21388
34619038@N00,2039,28,1060316321,1060317256,7,3,935
34619038@N00,2040,22,1060417579,1060417579,1,2,0
34619038@N00,2040,28,1060418011,1060418936,3,2,925
34619038@N00,2041,28,1327032103,1327032103,1,1,0
34619038@N00,2042,28,1327094271,1327118443,2,1,24172
34619038@N00,2043,28,1328062482,1328062482,1,1,0
34639838@N07,2044,16,1030610636,1030610636,1,1,0
34926381@N08,2045,26,1354768540,1354768540,1,1,0
34961066@N00,2046,6,1131524724,1131526149,25,1,1425
34961066@N00,2047,11,1190988000,1190988000,1,1,0
34961066@N00,2048,11,1191074402,1191074402,1,3,0
34961066@N00,2048,21,1191074411,1191074411,1,3,0
34961066@N00,2048,23,1191074401,1191074401,1,3,0
34961066@N00,2049,7,1212140334,1212140346,3,1,12
34961066@N00,2050,7,1244191650,1244192496,5,2,846
34961066@N00,2050,11,1244193481,1244193764,9,2,283
34961066@N00,2051,6,1258529665,1258532047,5,1,2382
34961066@N00,2052,22,1258690385,1258690463,2,2,78
34961066@N00,2052,28,1258688713,1258689522,6,2,809
34961066@N00,2053,29,1306630561,1306635098,11,1,4537
34961066@N00,2054,11,1309501771,1309503331,8,1,1560
34961066@N00,2055,6,1332475360,1332476696,13,1,1336
34961066@N00,2056,6,1332550613,1332561175,23,1,10562
34961066@N00,2057,6,1343790573,1343790963,2,1,390
35018975@N05,2058,7,1316485137,1316505971,2,2,20834
35018975@N05,2058,16,1316512361,1316535307,2,2,22946
35018975@N05,2059,28,1317014713,1317014713,1,1,0
35034347371@N01,2060,22,1325493445,1325501820,3,2,8375
35034347371@N01,2060,25,1325495842,1325496424,4,2,582
35034347371@N01,2061,11,1325544856,1325549909,12,1,5053
35034347371@N01,2062,4,1325634866,1325635272,3,2,406
35034347371@N01,2062,16,1325635882,1325635882,1,2,0
35034347371@N01,2063,22,1325674602,1325674790,5,1,188
35034347371@N01,2064,3,1325738105,1325738349,4,1,244
35034347371@N01,2065,25,1328761157,1328761157,1,1,0
35034347371@N01,2066,7,1383276324,1383276324,1,1,0
35034347371@N01,2067,30,1392180828,1392180912,3,1,84
35034347371@N01,2068,30,1392356207,1392356917,3,1,710
35034347485@N01,2069,6,1211766892,1211766992,4,5,100
35034347485@N01,2069,21,1211767945,1211768365,6,5,420
35034347485@N01,2069,22,1211771601,1211772491,13,5,890
35034347485@N01,2069,23,1211768782,1211768782,1,5,0
35034347485@N01,2069,28,1211769409,1211773318,16,5,3909
35034347485@N01,2070,25,1212024324,1212025141,6,1,817
35034348378@N01,2071,25,1157508526,1157508527,2,1,1
35034348378@N01,2072,1,1245055995,1245056039,2,7,44
35034348378@N01,2072,8,1245056503,1245056503,1,7,0
35034348378@N01,2072,16,1245057366,1245057366,1,7,0
35034348378@N01,2072,21,1245048297,1245048369,2,7,72
35034348378@N01,2072,22,1245046963,1245046963,1,7,0
35034348378@N01,2072,28,1245047191,1245047199,2,7,8
35034348378@N01,2072,30,1245055691,1245055691,1,7,0
35034348378@N01,2073,11,1245126050,1245126300,2,2,250
35034348378@N01,2073,29,1245120723,1245134151,4,2,13428
35034348378@N01,2074,25,1245302134,1245302134,1,1,0
35034351963@N01,2075,4,1207299579,1207305922,2,1,6343
35034355962@N01,2076,23,1287063334,1287063334,1,1,0
35034355962@N01,2077,8,1296135959,1296135959,1,2,0
35034355962@N01,2077,16,1296129677,1296136329,2,2,6652
35034355962@N01,2078,6,1343717736,1343717736,1,1,0
35034355962@N01,2079,6,1344305191,1344323311,2,1,18120
35034355962@N01,2080,7,1396059868,1396059868,1,1,0
35034358364@N01,2081,8,1316516134,1316516134,1,1,0
35034358364@N01,2082,16,1316581575,1316581575,1,1,0
35034359137@N01,2083,21,1228353836,1228357427,7,1,3591
35034359137@N01,2084,7,1284609250,1284609271,2,1,21
35034359137@N01,2085,11,1285144327,1285144327,1,2,0
35034359137@N01,2085,27,1285134848,1285134848,1,2,0
35034359137@N01,2086,30,1288734470,1288734470,1,1,0
35034359137@N01,2087,7,1288832391,1288832391,1,1,0
35034359137@N01,2088,1,1289530890,1289530890,1,1,0
35034359137@N01,2089,30,1290628174,1290628174,1,1,0
35034359137@N01,2090,11,1295832655,1295832655,1,1,0
35034359137@N01,2091,23,1299629027,1299629027,1,1,0
35034359137@N01,2092,30,1301519528,1301522699,2,1,3171
35034359137@N01,2093,2,1302933210,1302933210,1,1,0
35034359137@N01,2094,24,1306393923,1306393923,1,1,0
35034359137@N01,2095,30,1308689686,1308689686,1,1,0
35034359137@N01,2096,21,1311655800,1311655800,1,1,0
35034359137@N01,2097,30,1322108925,1322108925,1,1,0
35034359137@N01,2098,7,1333503414,1333503414,1,1,0
35034359137@N01,2099,27,1371779574,1371779574,1,1,0
35034359137@N01,2100,7,1386916287,1386916287,1,1,0
35034359137@N01,2101,24,1396137186,1396137186,1,1,0
35034363039@N01,2102,11,1125824811,1125828813,7,1,4002
35034363039@N01,2103,23,1126003680,1126004158,7,2,478
35034363039@N01,2103,30,1125993896,1125993905,2,2,9
35034363039@N01,2104,9,1126076618,1126088513,6,1,11895
35034363039@N01,2105,22,1126164567,1126169941,2,1,5374
35034363039@N01,2106,23,1126430570,1126430570,1,1,0
35098292@N00,2107,23,1160697194,1160697194,1,1,0
35098292@N00,2108,23,1160738372,1160738387,2,1,15
35107151@N04,2109,22,1350558819,1350558819,1,1,0
35107151@N04,2110,6,1350623992,1350637179,9,3,13187
35107151@N04,2110,7,1350599708,1350603069,5,3,3361
35107151@N04,2110,22,1350622921,1350622921,1,3,0
35107151@N04,2111,22,1350763395,1350766695,3,1,3300
35126193@N05,2112,6,1233368980,1233368980,1,1,0
35137530@N00,2113,7,1373235188,1373235188,1,1,0
35142635@N05,2114,28,1373239449,1373239449,1,1,0
35142635@N05,2115,11,1373410358,1373421325,3,1,10967
35149176@N02,2116,6,1261114906,1261115103,5,1,197
35149176@N02,2117,11,1311049083,1311049237,5,2,154
35149176@N02,2117,27,1311048592,1311049341,11,2,749
35149176@N02,2118,3,1326430533,1326432248,20,1,1715
35187594@N00,2119,4,1209812235,1209812235,1,1,0
35187594@N00,2120,4,1209896988,1209896988,1,1,0
35234292@N02,2121,29,1251504112,1251504112,1,1,0
35237095202@N01,2122,4,1155445968,1155445968,1,1,0
35237095202@N01,2123,4,1159520656,1159520656,1,1,0
35237095202@N01,2124,4,1184676799,1184676799,3,1,0
35237095202@N01,2125,24,1221709523,1221709523,1,1,0
35237095202@N01,2126,24,1222734302,1222734302,1,1,0
35237095202@N01,2127,24,1223005971,1223005971,1,1,0
35237095202@N01,2128,24,1224560802,1224560802,1,1,0
35237095202@N01,2129,24,1225348015,1225348015,1,1,0
35237095202@N01,2130,24,1228961065,1228961065,1,1,0
35237095202@N01,2131,24,1231813837,1231813837,1,1,0
35237095202@N01,2132,24,1234306942,1234306942,1,1,0
35237095202@N01,2133,24,1234504786,1234504786,1,1,0
35237095202@N01,2134,24,1235343098,1235343098,1,1,0
35237095202@N01,2135,24,1237327779,1237327779,1,1,0
35237095202@N01,2136,24,1247309344,1247309344,1,1,0
35237095202@N01,2137,24,1248062991,1248062991,1,1,0
35237095202@N01,2138,24,1249024488,1249024488,1,1,0
35237095202@N01,2139,24,1251341395,1251341395,1,1,0
35237095202@N01,2140,1,1255070568,1255070568,1,1,0
35237095202@N01,2141,24,1255577703,1255577703,1,1,0
35237095202@N01,2142,24,1261102374,1261102374,1,1,0
35237095202@N01,2143,24,1262748254,1262748254,1,1,0
35237095202@N01,2144,24,1265253458,1265253458,1,1,0
35237095202@N01,2145,24,1266291999,1266291999,1,1,0
35237095202@N01,2146,24,1266981536,1266981536,1,1,0
35237095202@N01,2147,21,1267349686,1267349686,1,1,0
35237095202@N01,2148,24,1273043163,1273043163,1,1,0
35237095202@N01,2149,24,1273104184,1273104184,1,1,0
35237095202@N01,2150,24,1273631428,1273631428,1,1,0
35237095202@N01,2151,22,1275116223,1275116462,2,1,239
35237095202@N01,2152,24,1276847894,1276847894,1,1,0
35237095202@N01,2153,24,1277182434,1277182434,1,1,0
35237095202@N01,2154,24,1277248463,1277248463,1,1,0
35237095202@N01,2155,7,1285935846,1285935846,1,1,0
35237095202@N01,2156,1,1290066899,1290066899,1,1,0
35237095202@N01,2157,11,1295667820,1295667820,1,1,0
35237095252@N01,2158,4,1301216901,1301216901,1,4,0
35237095252@N01,2158,7,1301209334,1301215843,7,4,6509
35237095252@N01,2158,16,1301216143,1301216925,2,4,782
35237095252@N01,2158,30,1301207898,1301215937,15,4,8039
35261188@N00,2159,30,1273824514,1273824607,2,1,93
35284396@N00,2160,16,1087007543,1087010156,5,1,2613
35284396@N00,2161,16,1111376277,1111376277,1,1,0
35284450@N00,2162,8,1220042459,1220042459,1,1,0
35322156@N00,2163,24,1325913406,1325913406,1,1,0
35322156@N00,2164,24,1326388316,1326388486,2,1,170
35322156@N00,2165,22,1341643447,1341644710,21,1,1263
35322156@N00,2166,1,1347176168,1347176168,1,1,0
35322156@N00,2167,8,1348468906,1348468906,1,1,0
35322156@N00,2168,16,1348578242,1348578242,1,1,0
35322156@N00,2169,8,1348741838,1348741838,1,1,0
35322156@N00,2170,21,1349516515,1349516515,1,1,0
35322156@N00,2171,7,1349792039,1349792039,1,2,0
35322156@N00,2171,16,1349791930,1349791930,1,2,0
35322156@N00,2172,28,1350038550,1350038550,1,1,0
35322156@N00,2173,1,1350401161,1350401161,1,1,0
35322156@N00,2174,16,1350503603,1350503603,1,1,0
35322156@N00,2175,7,1350807856,1350807856,1,1,0
35322156@N00,2176,8,1351851429,1351851429,1,1,0
35322156@N00,2177,16,1352270292,1352270292,1,1,0
35322156@N00,2178,22,1352808076,1352808076,1,1,0
35322156@N00,2179,16,1353645008,1353645008,1,1,0
35322156@N00,2180,7,1353770338,1353770338,1,1,0
35322156@N00,2181,8,1354269201,1354269201,1,1,0
35322156@N00,2182,16,1357172699,1357172699,1,1,0
35322156@N00,2183,8,1358333657,1358333657,1,1,0
35322156@N00,2184,25,1396157451,1396157451,1,1,0
35325510@N07,2185,4,1249098575,1249103825,5,1,5250
35409286@N00,2186,23,1353206668,1353206668,1,1,0
35409286@N00,2187,3,1356188267,1356188267,1,2,0
35409286@N00,2187,23,1356166831,1356166831,1,2,0
35409286@N00,2188,3,1357226617,1357226617,1,1,0
35409286@N00,2189,3,1357982808,1357988416,8,1,5608
35426585@N04,2190,11,1350706771,1350706771,1,1,0
35468141621@N01,2191,11,1362027460,1362027460,1,1,0
35468141621@N01,2192,25,1363401950,1363401950,1,1,0
35468141621@N01,2193,4,1374474230,1374480150,4,1,5920
35468141621@N01,2194,1,1379316451,1379317486,2,1,1035
35468159247@N01,2195,11,1209440110,1209440110,1,2,0
35468159247@N01,2195,21,1209430926,1209430926,1,2,0
35468159247@N01,2196,6,1209537240,1209537597,5,5,357
35468159247@N01,2196,16,1209531808,1209531934,2,5,126
35468159247@N01,2196,21,1209538761,1209538761,1,5,0
35468159247@N01,2196,24,1209529179,1209530778,3,5,1599
35468159247@N01,2196,30,1209532847,1209532847,1,5,0
35468159247@N01,2197,11,1209619197,1209622375,8,1,3178
35468159247@N01,2198,21,1209710338,1209710338,1,3,0
35468159247@N01,2198,22,1209710869,1209710869,1,3,0
35468159247@N01,2198,23,1209706736,1209706736,1,3,0
35468159247@N01,2199,7,1209967794,1209967794,1,2,0
35468159247@N01,2199,15,1209956155,1209958685,12,2,2530
35477558@N04,2200,16,1276767130,1276772002,2,1,4872
35477558@N04,2201,7,1277034206,1277034206,1,1,0
35511581@N00,2202,23,1230960233,1230960233,1,1,0
35511581@N00,2203,22,1319538380,1319538380,1,1,0
35511581@N00,2204,1,1323763463,1323767439,2,1,3976
35529616@N03,2205,16,1341452316,1341452316,1,1,0
35590362@N02,2206,16,1311162522,1311162522,1,1,0
35764233@N00,2207,1,1167382344,1167382499,2,5,155
35764233@N00,2207,13,1167365712,1167369578,5,5,3866
35764233@N00,2207,21,1167374905,1167374905,1,5,0
35764233@N00,2207,22,1167393704,1167393786,3,5,82
35764233@N00,2207,23,1167352616,1167354115,2,5,1499
35764233@N00,2208,23,1167460045,1167460278,2,1,233
35764233@N00,2209,16,1170144062,1170144062,1,3,0
35764233@N00,2209,21,1170139266,1170139266,1,3,0
35764233@N00,2209,22,1170146420,1170146430,2,3,10
35764233@N00,2210,4,1236394809,1236409232,5,2,14423
35764233@N00,2210,23,1236387088,1236387088,1,2,0
35842105@N00,2211,28,1373295420,1373295420,1,1,0
35842105@N00,2212,28,1373385111,1373385111,1,1,0
35842105@N00,2213,18,1374505543,1374505543,1,1,0
35981213@N00,2214,4,1253175051,1253190188,92,1,15137
35981213@N00,2215,3,1373882334,1373882334,1,1,0
35988570@N05,2216,28,1301037830,1301037830,1,1,0
35988570@N05,2217,11,1306790108,1306790108,1,1,0
36061217@N04,2218,13,1150853334,1150866499,19,1,13165
36061217@N04,2219,13,1150957567,1150957567,1,2,0
36061217@N04,2219,21,1150945163,1150947973,3,2,2810
36085412@N06,2220,30,946645279,946645279,1,1,0
36085412@N06,2221,30,1361765316,1361775138,7,1,9822
36085412@N06,2222,29,1361919725,1361927483,21,1,7758
36085412@N06,2223,29,1362005039,1362006582,6,1,1543
36085412@N06,2224,16,1362362180,1362365600,11,1,3420
36085412@N06,2225,30,1362643279,1362646440,17,1,3161
36085412@N06,2226,3,1364157116,1364160680,24,1,3564
36085412@N06,2227,29,1364359022,1364364072,24,1,5050
36085412@N06,2228,29,1364429118,1364433411,13,1,4293
36101699447@N01,2229,1,1350030896,1350030896,1,1,0
36101699447@N01,2230,7,1355387727,1355388379,2,1,652
36101699447@N01,2231,30,1355475400,1355475400,1,1,0
36101699447@N01,2232,23,1356156095,1356156095,1,1,0
36101699447@N01,2233,22,1366963999,1366963999,1,1,0
36101699447@N01,2234,2,1370078754,1370078754,1,1,0
36101699447@N01,2235,21,1373116576,1373116576,1,2,0
36101699447@N01,2235,22,1373103438,1373103627,2,2,189
36101699447@N01,2236,2,1382792875,1382792875,1,1,0
36101699447@N01,2237,30,1390012867,1390012867,1,1,0
36101699447@N01,2238,7,1394699363,1394699363,1,1,0
36101699447@N01,2239,30,1394881889,1394881889,1,1,0
36101699447@N01,2240,8,1398503562,1398503562,1,1,0
36122778@N00,2241,16,1285300320,1285300320,1,1,0
36127084@N00,2242,22,1237294596,1237294596,1,1,0
36127084@N00,2243,22,1237351267,1237367192,15,1,15925
36127084@N00,2244,22,1237620946,1237621057,3,1,111
36127084@N00,2245,22,1237701334,1237716518,3,1,15184
36176156@N00,2246,22,1370976219,1370976219,1,1,0
36252130@N00,2247,27,1217637844,1217637844,1,1,0
36252130@N00,2248,19,1220678488,1220678488,1,2,0
36252130@N00,2248,24,1220663304,1220663304,1,2,0
36252130@N00,2249,23,1222070269,1222073253,3,1,2984
36252130@N00,2250,4,1253168362,1253175833,7,1,7471
36327042@N03,2251,7,1329713787,1329713787,1,2,0
36327042@N03,2251,16,1329714825,1329714825,1,2,0
36357702@N08,2252,4,1225145865,1225145865,1,7,0
36357702@N08,2252,7,1225143722,1225144192,2,7,470
36357702@N08,2252,8,1225146386,1225148498,7,7,2112
36357702@N08,2252,16,1225145996,1225145996,1,7,0
36357702@N08,2252,22,1225150397,1225150606,4,7,209
36357702@N08,2252,28,1225150028,1225150085,2,7,57
36357702@N08,2252,30,1225144486,1225144853,2,7,367
36357702@N08,2253,16,1277819911,1277819911,1,2,0
36357702@N08,2253,24,1277822392,1277822392,1,2,0
36357702@N08,2254,7,1277889653,1277889816,3,1,163
36404721@N00,2255,16,1374092824,1374093073,2,2,249
36404721@N00,2255,24,1374096728,1374096849,2,2,121
36404721@N00,2256,30,1374245477,1374245477,1,1,0
36521964195@N01,2257,29,1191133499,1191134645,3,1,1146
36521964195@N01,2258,25,1285433305,1285433305,1,1,0
36521964195@N01,2259,23,1290925429,1290925429,1,1,0
36521964195@N01,2260,3,1294309720,1294309720,1,1,0
36521964195@N01,2261,7,1295186390,1295186390,1,1,0
36521964195@N01,2262,22,1295455838,1295455879,3,1,41
36521964195@N01,2263,22,1300863004,1300863004,1,2,0
36521964195@N01,2263,28,1300858536,1300863504,5,2,4968
36521964195@N01,2264,4,1305785523,1305785523,1,1,0
36521964195@N01,2265,12,1306537768,1306555923,14,1,18155
36521964195@N01,2266,27,1306627645,1306630176,2,1,2531
36521964195@N01,2267,11,1307088138,1307088138,1,1,0
36521964195@N01,2268,16,1308730379,1308730379,1,1,0
36521964195@N01,2269,23,1327134807,1327137849,2,1,3042
36521964195@N01,2270,25,1339063106,1339063540,10,2,434
36521964195@N01,2270,29,1339066249,1339066398,6,2,149
36521964195@N01,2271,21,1339838646,1339847165,2,1,8519
36521981180@N01,2272,6,1294119818,1294119818,1,1,0
36521981547@N01,2273,22,1262414660,1262414660,1,1,0
36521981547@N01,2274,7,1276923932,1276923932,1,2,0
36521981547@N01,2274,15,1276940520,1276946728,3,2,6208
36553196@N08,2275,6,1311340700,1311340942,2,4,242
36553196@N08,2275,16,1311307232,1311310295,2,4,3063
36553196@N08,2275,22,1311325965,1311325965,1,4,0
36553196@N08,2275,30,1311307997,1311307997,1,4,0
36605992@N02,2276,16,1277376540,1277376540,1,1,0
36764845@N07,2277,12,1303728354,1303728354,1,1,0
36780837@N04,2278,16,1276072125,1276072125,1,1,0
36919509@N03,2279,16,1310359106,1310361702,2,1,2596
36919509@N03,2280,23,1331715494,1331715494,1,1,0
37007874@N00,2281,8,1328665241,1328665241,1,1,0
37007874@N00,2282,6,1328780963,1328780963,1,2,0
37007874@N00,2282,25,1328778411,1328778554,2,2,143
37027740@N00,2283,23,1243066513,1243084042,11,1,17529
37153080@N00,2284,22,1179055317,1179055317,1,1,0
37153080@N00,2285,30,1227919278,1227936503,9,1,17225
37153080@N00,2286,3,1232424345,1232430011,8,1,5666
37153080@N00,2287,6,1297995535,1297995974,2,1,439
37256969@N08,2288,16,1145270468,1145271631,2,1,1163
37256969@N08,2289,16,1338576024,1338576408,2,1,384
37256969@N08,2290,4,1338881087,1338881087,1,2,0
37256969@N08,2290,6,1338887954,1338887954,1,2,0
37256969@N08,2291,16,1338963194,1338968415,16,1,5221
37256969@N08,2292,4,1339428824,1339437237,4,2,8413
37256969@N08,2292,22,1339414046,1339414046,1,2,0
37282294@N06,2293,24,1220592661,1220607135,6,1,14474
37282294@N06,2294,24,1220660928,1220686993,14,1,26065
37282294@N06,2295,24,1220749148,1220749249,3,1,101
37282294@N06,2296,24,1244954356,1244957463,4,1,3107
37282294@N06,2297,21,1246004180,1246017805,7,1,13625
37282294@N06,2298,22,1246076233,1246078133,11,2,1900
37282294@N06,2298,28,1246078810,1246078983,2,2,173
37282294@N06,2299,21,1246944949,1246946312,2,1,1363
37282294@N06,2300,22,1247370320,1247370320,1,1,0
37282294@N06,2301,22,1248149505,1248150483,2,1,978
37282294@N06,2302,7,1248985448,1248985448,1,1,0
37282294@N06,2303,21,1251258457,1251258457,1,1,0
37282294@N06,2304,24,1252725113,1252726301,6,2,1188
37282294@N06,2304,27,1252728672,1252728941,6,2,269
37282294@N06,2305,21,1252824443,1252838154,8,1,13711
37282294@N06,2306,11,1253250021,1253252603,3,1,2582
37282294@N06,2307,11,1253339504,1253345223,3,1,5719
37282294@N06,2308,22,1254566476,1254568583,3,1,2107
37282294@N06,2309,22,1261046286,1261046286,1,1,0
37282294@N06,2310,30,1277538168,1277538622,2,1,454
37282294@N06,2311,21,1280043667,1280054454,13,1,10787
37282294@N06,2312,11,1284087452,1284099015,20,1,11563
37282294@N06,2313,11,1284179867,1284189752,14,2,9885
37282294@N06,2313,27,1284191242,1284191429,3,2,187
37282294@N06,2314,11,1284255992,1284275442,27,1,19450
37282294@N06,2315,11,1284344600,1284365252,8,1,20652
37282294@N06,2316,11,1284440730,1284445611,4,1,4881
37282294@N06,2317,11,1284525275,1284532022,12,1,6747
37282294@N06,2318,11,1284699570,1284703172,3,1,3602
37282294@N06,2319,11,1284783369,1284783474,2,1,105
37282294@N06,2320,21,1296267684,1296277074,10,1,9390
37282294@N06,2321,21,1297488413,1297490627,5,1,2214
37368868@N05,2322,30,1333634806,1333634806,1,1,0
37415609@N06,2323,12,1347174352,1347174352,1,1,0
37449305@N07,2324,7,1234415211,1234415248,2,1,37
37449305@N07,2325,28,1371508221,1371508221,1,1,0
37449305@N07,2326,28,1371614703,1371615159,2,1,456
37504944@N06,2327,7,1244460594,1244460607,2,1,13
37504944@N06,2328,13,1244612194,1244612213,3,1,19
37504944@N06,2329,8,1251528305,1251528407,2,2,102
37504944@N06,2329,30,1251529133,1251529139,2,2,6
37517876@N07,2330,4,1237706668,1237706668,1,1,0
37517876@N07,2331,11,1240719968,1240723407,12,3,3439
37517876@N07,2331,23,1240732174,1240732174,1,3,0
37517876@N07,2331,27,1240729037,1240729037,1,3,0
37517876@N07,2332,24,1242633127,1242633763,4,1,636
37517876@N07,2333,7,1243586286,1243586287,2,1,1
37517876@N07,2334,1,1244207501,1244207501,1,4,0
37517876@N07,2334,6,1244193712,1244193712,1,4,0
37517876@N07,2334,7,1244204947,1244206584,3,4,1637
37517876@N07,2334,21,1244188917,1244192400,7,4,3483
37517876@N07,2335,21,1244275901,1244286064,9,1,10163
37517876@N07,2336,24,1244796660,1244799211,19,1,2551
37517876@N07,2337,6,1245978379,1245979645,15,1,1266
37517876@N07,2338,1,1246348409,1246348698,3,3,289
37517876@N07,2338,7,1246349160,1246349376,4,3,216
37517876@N07,2338,30,1246348955,1246353830,9,3,4875
37517876@N07,2339,16,1246588068,1246588068,1,1,0
37517876@N07,2340,21,1247897845,1247903568,16,4,5723
37517876@N07,2340,22,1247894677,1247894737,2,4,60
37517876@N07,2340,24,1247888757,1247890025,5,4,1268
37517876@N07,2340,28,1247893500,1247893500,1,4,0
37517876@N07,2341,24,1247976292,1247979521,34,1,3229
37546787@N05,2342,16,1252078966,1252078966,1,1,0
37574483@N07,2343,11,1307937141,1307937141,1,1,0
37574483@N07,2344,29,1308305791,1308305791,1,1,0
37574483@N07,2345,4,1309576515,1309581543,2,2,5028
37574483@N07,2345,16,1309577034,1309577042,2,2,8
37574483@N07,2346,29,1310374490,1310386259,5,1,11769
37649829@N03,2347,16,1285380698,1285382444,2,1,1746
37663331@N00,2348,27,1132291530,1132291530,1,1,0
37663331@N00,2349,21,1132798209,1132798209,1,3,0
37663331@N00,2349,23,1132793966,1132795056,2,3,1090
37663331@N00,2349,28,1132794696,1132794696,1,3,0
37663331@N00,2350,22,1132966787,1132967472,3,2,685
37663331@N00,2350,25,1132969216,1132969216,1,2,0
37663331@N00,2351,13,1133660699,1133663236,4,1,2537
37663331@N00,2352,4,1137833954,1137837036,3,1,3082
37663331@N00,2353,11,1142211600,1142211600,1,2,0
37663331@N00,2353,27,1142211600,1142211600,1,2,0
37663331@N00,2354,27,1142993979,1142993981,3,1,2
37663331@N00,2355,11,1144895200,1144895200,1,2,0
37663331@N00,2355,27,1144895388,1144895709,7,2,321
37663331@N00,2356,3,1146016246,1146016246,2,1,0
37663331@N00,2357,11,1160880056,1160893167,12,1,13111
37663331@N00,2358,11,1161480818,1161483445,7,1,2627
37663331@N00,2359,11,1162690105,1162697761,8,1,7656
37663331@N00,2360,11,1164502356,1164503102,4,1,746
37663331@N00,2361,11,1165109684,1165110311,2,1,627
37663331@N00,2362,11,1176174705,1176174723,2,2,18
37663331@N00,2362,27,1176174211,1176175503,4,2,1292
37663331@N00,2363,11,1180665163,1180666107,13,1,944
37663331@N00,2364,11,1181615743,1181616663,11,2,920
37663331@N00,2364,27,1181616886,1181616886,1,2,0
37663331@N00,2365,18,1183259050,1183263818,6,1,4768
37663331@N00,2366,24,1183348509,1183349015,3,1,506
37663331@N00,2367,11,1184464840,1184465485,6,2,645
37663331@N00,2367,27,1184458899,1184458899,1,2,0
37663331@N00,2368,27,1229650481,1229650583,5,1,102
37663331@N00,2369,24,1278204817,1278205152,5,1,335
37663331@N00,2370,7,1367979357,1367979357,1,1,0
37663331@N00,2371,22,1381902976,1381903331,9,1,355
37741243@N04,2372,7,1369388776,1369390798,15,1,2022
37756295@N06,2373,4,1338616484,1338616484,1,1,0
37804979@N00,2374,6,1346319177,1346319230,2,2,53
37804979@N00,2374,16,1346318886,1346318886,1,2,0
37804979@N00,2375,6,1346383044,1346392019,10,1,8975
37804979@N00,2376,4,1346453165,1346453165,1,1,0
37804979@N00,2377,16,1346660679,1346670270,6,4,9591
37804979@N00,2377,21,1346640411,1346643548,4,4,3137
37804979@N00,2377,22,1346647143,1346647291,2,4,148
37804979@N00,2377,28,1346644946,1346646419,20,4,1473
37804979@N00,2378,11,1346724533,1346740708,44,1,16175
37904342@N04,2379,1,1363692302,1363692302,1,1,0
37909157@N00,2380,25,1250583662,1250583790,3,1,128
37909157@N00,2381,25,1257654947,1257654947,1,1,0
37912579@N08,2382,16,1280618565,1280618565,1,1,0
37935394@N00,2383,10,1267663727,1267663727,1,1,0
37935394@N00,2384,21,1277010220,1277010220,1,1,0
37935394@N00,2385,29,1290483424,1290483424,1,1,0
37935394@N00,2386,25,1291692420,1291692420,1,1,0
37935394@N00,2387,25,1294448003,1294448003,1,1,0
37935394@N00,2388,29,1295932039,1295932039,1,1,0
37935394@N00,2389,25,1297651670,1297651670,1,1,0
37935394@N00,2390,25,1298189392,1298189530,2,1,138
37935394@N00,2391,3,1299028557,1299028576,2,2,19
37935394@N00,2391,21,1299028920,1299028920,1,2,0
37935394@N00,2392,25,1299817147,1299817147,1,1,0
37935394@N00,2393,25,1311842673,1311842828,3,1,155
37935394@N00,2394,25,1317966365,1317966722,3,1,357
37935394@N00,2395,25,1327103593,1327103593,1,1,0
37945735@N00,2396,28,1252824625,1252824625,1,1,0
37996592517@N01,2397,22,1282800934,1282800934,1,1,0
37996592517@N01,2398,7,1282985030,1282985030,1,1,0
37996598059@N01,2399,7,1214192849,1214192849,1,1,0
37996598059@N01,2400,25,1247400347,1247400347,1,1,0
37996606796@N01,2401,8,1160360092,1160360092,1,3,0
37996606796@N01,2401,16,1160362475,1160362788,8,3,313
37996606796@N01,2401,24,1160358815,1160358868,3,3,53
37996612193@N01,2402,4,1273108465,1273116631,7,1,8166
37996646802@N01,2403,21,1314439175,1314439175,1,2,0
37996646802@N01,2403,23,1314439210,1314439210,1,2,0
37996646802@N01,2404,30,1344486082,1344486082,1,1,0
37996646802@N01,2405,1,1353662474,1353670698,6,2,8224
37996646802@N01,2405,30,1353672014,1353672162,3,2,148
38030421@N08,2406,4,1275055588,1275068997,5,1,13409
38102495@N00,2407,13,1156718947,1156722009,8,1,3062
38280232@N02,2408,30,1276159440,1276159440,1,1,0
38435269@N07,2409,9,1260499116,1260501706,2,1,2590
38435269@N07,2410,21,1287513893,1287514228,7,1,335
38435269@N07,2411,21,1341949672,1341949672,1,1,0
38489797@N00,2412,21,1290145104,1290145104,1,2,0
38489797@N00,2412,23,1290147999,1290147999,1,2,0
38501936@N05,2413,6,1246264667,1246265981,7,1,1314
38791487@N03,2414,12,1178255770,1178255770,1,1,0
38791487@N03,2415,12,1263724061,1263726994,7,1,2933
38791487@N03,2416,12,1285301104,1285315736,15,1,14632
38791487@N03,2417,12,1304490513,1304490513,1,1,0
38883104@N00,2418,20,1285467208,1285468792,36,1,1584
38883104@N00,2419,11,1286531896,1286531899,2,1,3
38883104@N00,2420,20,1315873261,1315873261,1,1,0
38883104@N00,2421,25,1319785062,1319785062,1,1,0
38883104@N00,2422,28,1356590150,1356590158,5,1,8
38883104@N00,2423,11,1356671362,1356671384,5,1,22
38963918@N07,2424,2,1314711065,1314711065,1,1,0
39017338@N08,2425,24,1259133991,1259134015,3,1,24
39017338@N08,2426,22,1293076733,1293076736,2,1,3
39017338@N08,2427,22,1293524744,1293524744,1,1,0
39017338@N08,2428,23,1304172471,1304172471,1,1,0
39017338@N08,2429,28,1325205022,1325205022,1,1,0
39017338@N08,2430,23,1348977337,1348977412,2,1,75
39038071@N00,2431,6,1114153421,1114153421,1,3,0
39038071@N00,2431,22,1114152074,1114153014,2,3,940
39038071@N00,2431,25,1114152074,1114152074,1,3,0
39038071@N00,2432,22,1117509237,1117509237,1,1,0
39038071@N00,2433,11,1125321091,1125321091,1,1,0
39038071@N00,2434,13,1225433900,1225433900,1,1,0
39038071@N00,2435,25,1239407403,1239407403,1,1,0
39057810@N00,2436,29,1191981556,1191981556,1,1,0
39342947@N00,2437,15,1183332389,1183332393,2,1,4
39357749@N00,2438,16,1165239241,1165239241,1,1,0
39357749@N00,2439,16,1165549825,1165549825,1,1,0
39357749@N00,2440,7,1169292140,1169292140,1,3,0
39357749@N00,2440,16,1169294321,1169294321,1,3,0
39357749@N00,2440,30,1169292267,1169292267,1,3,0
39357749@N00,2441,24,1171096234,1171096234,1,1,0
39357749@N00,2442,23,1173620059,1173620059,1,2,0
39357749@N00,2442,25,1173618231,1173618231,1,2,0
39357749@N00,2443,4,1176300430,1176300430,1,1,0
39357749@N00,2444,23,1176388351,1176388351,1,1,0
39357749@N00,2445,28,1177147973,1177148202,2,1,229
39357749@N00,2446,7,1177248254,1177248254,1,1,0
39357749@N00,2447,7,1178474471,1178474471,1,2,0
39357749@N00,2447,16,1178470887,1178471709,2,2,822
39357749@N00,2448,30,1179480456,1179480456,1,1,0
39357749@N00,2449,30,1231665782,1231665782,1,1,0
39357749@N00,2450,23,1237623027,1237623027,1,2,0
39357749@N00,2450,28,1237613036,1237613036,1,2,0
39357749@N00,2451,30,1238240238,1238240356,2,1,118
39357749@N00,2452,22,1238809385,1238809385,1,1,0
39357749@N00,2453,30,1238905600,1238920371,2,1,14771
39357749@N00,2454,25,1240045296,1240052027,3,1,6731
39357749@N00,2455,7,1244369023,1244369023,2,1,0
39371199@N04,2456,19,1375692781,1375692781,1,1,0
39371199@N04,2457,19,1375765063,1375765063,1,1,0
39371199@N04,2458,19,1376812415,1376812415,1,1,0
39371199@N04,2459,19,1377754377,1377754377,1,1,0
39460517@N03,2460,7,1251533211,1251533211,1,1,0
39460517@N03,2461,2,1251699277,1251699343,2,3,66
39460517@N03,2461,14,1251699709,1251699709,1,3,0
39460517@N03,2461,17,1251704700,1251718866,39,3,14166
39460517@N03,2462,11,1251872509,1251875351,32,2,2842
39460517@N03,2462,27,1251875588,1251875588,1,2,0
39460517@N03,2463,29,1252048396,1252049239,15,1,843
39460517@N03,2464,24,1252307359,1252315109,27,1,7750
39460517@N03,2465,21,1252568181,1252585986,89,1,17805
39460517@N03,2466,21,1252741498,1252746010,27,4,4512
39460517@N03,2466,22,1252738056,1252740538,31,4,2482
39460517@N03,2466,23,1252740839,1252741397,8,4,558
39460517@N03,2466,28,1252740619,1252740683,3,4,64
39460517@N03,2467,21,1253097322,1253101302,52,1,3980
39460517@N03,2468,21,1253352521,1253368480,99,1,15959
39460517@N03,2469,21,1253933058,1253939024,15,1,5966
39460517@N03,2470,30,1254174020,1254180924,87,1,6904
39460517@N03,2471,21,1254376882,1254397490,83,3,20608
39460517@N03,2471,22,1254361647,1254368378,83,3,6731
39460517@N03,2471,28,1254365526,1254365689,5,3,163
39460517@N03,2472,21,1254563147,1254565684,26,4,2537
39460517@N03,2472,22,1254567847,1254568144,4,4,297
39460517@N03,2472,23,1254565848,1254566521,6,4,673
39460517@N03,2472,28,1254568521,1254568765,4,4,244
39460517@N03,2473,21,1254788036,1254794261,37,1,6225
39460517@N03,2474,22,1254981392,1254996637,65,1,15245
39460517@N03,2475,21,1255137276,1255145548,109,1,8272
39460517@N03,2476,21,1255394984,1255402372,131,1,7388
39460517@N03,2477,27,1255614747,1255614747,1,1,0
39460517@N03,2478,21,1255745296,1255745296,1,1,0
39460517@N03,2479,23,1257913330,1257922994,38,2,9664
39460517@N03,2479,29,1257894571,1257902978,69,2,8407
39460517@N03,2480,21,1258187819,1258192401,39,1,4582
39460517@N03,2481,23,1258612495,1258616485,62,1,3990
39460517@N03,2482,22,1259395483,1259399937,81,1,4454
39460517@N03,2483,27,1259830217,1259835744,14,1,5527
39460517@N03,2484,22,1259999785,1260006040,102,1,6255
39460517@N03,2485,22,1260605147,1260608630,64,2,3483
39460517@N03,2485,28,1260587489,1260587489,1,2,0
39460517@N03,2486,30,1261193048,1261193048,1,1,0
39460517@N03,2487,25,1261381852,1261381852,1,1,0
39460517@N03,2488,27,1263010500,1263010500,1,1,0
39460517@N03,2489,22,1264838740,1264845218,48,1,6478
39460517@N03,2490,2,1267849372,1267857633,17,1,8261
39460517@N03,2491,21,1269664679,1269685791,46,1,21112
39460517@N03,2492,11,1270268449,1270271523,23,1,3074
39460517@N03,2493,21,1274346972,1274352198,30,1,5226
39460517@N03,2494,17,1283164965,1283176765,9,1,11800
39501469@N07,2495,22,1284810170,1284812763,27,1,2593
39587684@N00,2496,7,1188187714,1188187714,1,3,0
39587684@N00,2496,8,1188187637,1188187637,1,3,0
39587684@N00,2496,30,1188187632,1188187632,1,3,0
39587684@N00,2497,1,1220688084,1220688084,1,3,0
39587684@N00,2497,7,1220688164,1220688166,2,3,2
39587684@N00,2497,25,1220681085,1220681969,10,3,884
39587684@N00,2498,12,1223696212,1223696498,5,1,286
39587684@N00,2499,22,1279332269,1279332269,1,3,0
39587684@N00,2499,23,1279329293,1279329624,2,3,331
39587684@N00,2499,28,1279329810,1279332205,18,3,2395
39587684@N00,2500,21,1363483501,1363487323,133,1,3822
39604225@N00,2501,25,1319342398,1319342425,2,1,27
39604225@N00,2502,10,1321005730,1321005730,1,1,0
39606062@N00,2503,4,1371717379,1371717379,1,1,0
39691940@N00,2504,22,1247566354,1247569046,3,1,2692
40040706561@N01,2505,11,1395996758,1395996758,1,1,0
40046855@N00,2506,3,872517600,872517600,1,1,0
40127829@N00,2507,7,1291250882,1291250882,1,1,0
40230716@N03,2508,23,1295159667,1295159667,1,1,0
40230716@N03,2509,19,1305264232,1305264232,1,1,0
40230716@N03,2510,8,1343784165,1343784311,2,1,146
40230716@N03,2511,25,1374757640,1374763065,3,1,5425
40374161@N04,2512,1,1322642938,1322642938,1,1,0
40437944@N00,2513,7,1344672803,1344672803,1,1,0
40437944@N00,2514,20,1345109914,1345110050,2,1,136
40437944@N00,2515,14,1345349893,1345349893,1,1,0
40437944@N00,2516,24,1345872940,1345876172,3,1,3232
40437944@N00,2517,8,1345954138,1345954138,1,1,0
40437944@N00,2518,21,1347094680,1347094680,1,1,0
40437944@N00,2519,21,1348971166,1348971166,1,1,0
40437944@N00,2520,25,1349434826,1349434826,1,1,0
40437944@N00,2521,25,1352463051,1352463051,1,1,0
40437944@N00,2522,23,1353574905,1353574905,1,1,0
40437944@N00,2523,1,1355306383,1355306383,1,1,0
40437944@N00,2524,3,1358665964,1358665964,1,1,0
40437944@N00,2525,1,1361967463,1361967463,1,1,0
40437944@N00,2526,1,1365323204,1365323204,1,1,0
40437944@N00,2527,24,1368617322,1368617322,1,1,0
40437944@N00,2528,25,1369564577,1369564577,1,1,0
40437944@N00,2529,9,1371257923,1371257923,1,1,0
40437944@N00,2530,4,1374571651,1374571651,1,1,0
40437944@N00,2531,25,1383911381,1383911381,1,1,0
40437944@N00,2532,8,1384852783,1384852783,1,1,0
40437944@N00,2533,7,1386410181,1386410263,2,1,82
40437944@N00,2534,1,1388314494,1388314494,1,1,0
40437944@N00,2535,28,1395136571,1395136571,1,1,0
40446087@N04,2536,30,1312848600,1312848600,1,1,0
40451262@N00,2537,6,1372810205,1372812733,2,2,2528
40451262@N00,2537,22,1372824812,1372824832,2,2,20
40456324@N00,2538,6,1282427292,1282427292,1,1,0
40505616@N00,2539,16,1181375899,1181378757,6,1,2858
40563877@N00,2540,24,1306235267,1306235267,1,1,0
40563877@N00,2541,4,1313820614,1313820614,1,1,0
40563877@N00,2542,4,1343271153,1343271153,1,2,0
40563877@N00,2542,23,1343271079,1343271079,1,2,0
40563877@N00,2543,30,1350945986,1350945986,1,1,0
40563877@N00,2544,30,1369452893,1369452893,1,1,0
40563877@N00,2545,24,1371797925,1371797925,1,1,0
40563877@N00,2546,3,1372576698,1372576698,1,1,0
40563877@N00,2547,7,1374904752,1374904752,1,1,0
40563877@N00,2548,3,1395478690,1395478690,1,1,0
40643628@N00,2549,21,1272113351,1272113351,1,1,0
40643628@N00,2550,25,1369897210,1369897210,1,1,0
40643628@N00,2551,28,1388975906,1388975906,1,1,0
40682713@N05,2552,28,1315273964,1315273964,1,1,0
40689227@N00,2553,8,1152963082,1152963112,2,1,30
40689227@N00,2554,8,1153393914,1153404280,10,1,10366
40732568091@N01,2555,3,1238661178,1238661178,1,1,0
40752164@N00,2556,25,1278314518,1278314518,1,1,0
40752164@N00,2557,25,1301111343,1301111343,1,1,0
40752609@N00,2558,16,1166946732,1166946732,1,1,0
40752609@N00,2559,21,1167579058,1167579058,1,1,0
40752609@N00,2560,28,1167655272,1167655272,1,1,0
40752609@N00,2561,16,1167893154,1167893154,1,1,0
41038719@N00,2562,6,1294893465,1294893465,1,1,0
41038719@N00,2563,6,1294982412,1294982412,1,1,0
41038719@N00,2564,11,1296287412,1296287412,1,1,0
41038719@N00,2565,6,1296455802,1296455852,2,1,50
41095345@N02,2566,16,1344345895,1344346130,3,1,235
41101678@N00,2567,24,1372834536,1372834536,1,1,0
41101678@N00,2568,4,1372927387,1372935295,2,2,7908
41101678@N00,2568,16,1372923853,1372923853,1,2,0
41348910@N05,2569,16,1367454157,1367454157,1,1,0
41365291@N06,2570,30,1138712400,1138712400,1,1,0
41412977@N00,2571,30,1296556499,1296556499,1,1,0
41412977@N00,2572,22,1298609271,1298609271,1,1,0
41412977@N00,2573,6,1301722019,1301722019,1,1,0
41412977@N00,2574,25,1317604645,1317604645,1,1,0
41412977@N00,2575,6,1343172350,1343172350,1,1,0
41413423@N00,2576,26,1366860679,1366860679,1,1,0
41413423@N00,2577,6,1375418945,1375418945,1,1,0
41506934@N03,2578,14,1125216422,1125218400,3,1,1978
41506934@N03,2579,11,1210233264,1210233264,1,1,0
41506934@N03,2580,21,1223135070,1223135070,1,1,0
41506934@N03,2581,23,1225783433,1225783433,1,1,0
41506934@N03,2582,16,1226812868,1226817146,6,2,4278
41506934@N03,2582,30,1226821861,1226821861,1,2,0
41506934@N03,2583,16,1282973202,1283001412,7,1,28210
41506934@N03,2584,21,1338107420,1338107420,1,1,0
41506934@N03,2585,16,1355050545,1355050545,1,1,0
41555937@N00,2586,8,1385769401,1385774527,4,2,5126
41555937@N00,2586,16,1385773925,1385773925,1,2,0
41634302@N08,2587,16,1303473433,1303477162,2,1,3729
41634302@N08,2588,16,1308548904,1308551562,3,1,2658
41634302@N08,2589,16,1368667478,1368667478,1,1,0
41721440@N00,2590,1,1208451785,1208451785,1,1,0
41721440@N00,2591,12,1289786651,1289795089,14,1,8438
41721440@N00,2592,21,1289971680,1289971680,1,3,0
41721440@N00,2592,23,1289968588,1289968610,3,3,22
41721440@N00,2592,28,1289969281,1289972789,5,3,3508
41721440@N00,2593,12,1298428006,1298428006,1,1,0
41721440@N00,2594,12,1307083283,1307083561,6,1,278
41721440@N00,2595,12,1308733474,1308741038,8,1,7564
41745522@N08,2596,11,1327895026,1327895031,12,1,5
41757196@N00,2597,11,1308409337,1308410403,8,1,1066
41757196@N00,2598,11,1309485000,1309485283,2,1,283
41757196@N00,2599,22,1309851695,1309851695,1,1,0
41813589@N00,2600,27,1191645380,1191645380,1,1,0
41814550@N00,2601,30,1344571858,1344590987,8,1,19129
41894165897@N01,2602,4,1170340126,1170365328,14,1,25202
41894165897@N01,2603,4,1170397920,1170408051,12,1,10131
41894165897@N01,2604,7,1305523059,1305523059,1,3,0
41894165897@N01,2604,11,1305515286,1305515286,1,3,0
41894165897@N01,2604,29,1305516438,1305516515,3,3,77
41894165897@N01,2605,16,1359696849,1359696849,1,1,0
41894177347@N01,2606,25,1280193972,1280195006,2,1,1034
41894177347@N01,2607,9,1356671140,1356671140,1,1,0
41931500@N00,2608,6,1096946001,1096946706,9,1,705
41931500@N00,2609,25,1114422349,1114423211,33,1,862
41957314@N03,2610,13,1252202745,1252202745,1,1,0
41969093@N00,2611,25,1237078793,1237083277,5,2,4484
41969093@N00,2611,29,1237089894,1237090105,3,2,211
41969093@N00,2612,21,1237162344,1237162344,1,2,0
41969093@N00,2612,28,1237164077,1237164966,3,2,889
41969093@N00,2613,25,1238020386,1238020386,1,1,0
42152564@N04,2614,21,1246666577,1246666701,6,1,124
42152564@N04,2615,18,1347036981,1347036981,1,1,0
42152564@N04,2616,23,1349106406,1349106406,1,1,0
42183741@N05,2617,7,1289350879,1289351475,2,1,596
42197860@N05,2618,4,1397967027,1397967027,1,1,0
42228781@N00,2619,16,1138671959,1138684604,63,1,12645
42228781@N00,2620,16,1146011464,1146032914,14,1,21450
42228781@N00,2621,8,1151020650,1151056484,22,1,35834
42228781@N00,2622,8,1151101511,1151129101,56,1,27590
42228781@N00,2623,22,1159657954,1159661912,39,1,3958
42228781@N00,2624,8,1176301775,1176301775,1,1,0
42228781@N00,2625,8,1181896305,1181896869,6,1,564
42228781@N00,2626,8,1181947996,1181975992,69,1,27996
42228781@N00,2627,15,1341113097,1341116580,5,1,3483
42261726@N00,2628,6,1365752452,1365752457,3,1,5
42526340@N00,2629,21,1281774984,1281774984,1,1,0
42526340@N00,2630,6,1285461093,1285461093,1,2,0
42526340@N00,2630,29,1285469234,1285469234,1,2,0
42526340@N00,2631,11,1309400780,1309400780,1,1,0
42526340@N00,2632,30,1327131717,1327131717,1,1,0
42526340@N00,2633,21,1339064795,1339064795,1,1,0
42536354@N00,2634,30,1239176381,1239176381,1,1,0
42536354@N00,2635,25,1244880217,1244896233,25,1,16016
42536354@N00,2636,27,1247454716,1247454716,1,1,0
42536354@N00,2637,11,1253604439,1253604439,1,1,0
42536354@N00,2638,11,1253690168,1253690168,1,1,0
42536354@N00,2639,21,1264212737,1264230173,21,1,17436
42536354@N00,2640,25,1271477228,1271477228,1,1,0
42536354@N00,2641,27,1271816038,1271816038,1,1,0
42536354@N00,2642,17,1280541347,1280541347,1,1,0
42536354@N00,2643,27,1285306876,1285306876,1,1,0
42536354@N00,2644,23,1289034309,1289034309,1,1,0
42536354@N00,2645,11,1305790030,1305790030,1,1,0
42536354@N00,2646,25,1307853035,1307853035,1,1,0
42536354@N00,2647,28,1307953727,1307953727,1,1,0
42536354@N00,2648,11,1309140171,1309140171,1,1,0
42536354@N00,2649,27,1309403837,1309403837,1,1,0
42536354@N00,2650,11,1313729983,1313729983,1,2,0
42536354@N00,2650,25,1313732468,1313732468,1,2,0
42536354@N00,2651,8,1314452450,1314452450,1,1,0
42536354@N00,2652,7,1314948423,1314950029,2,1,1606
42536354@N00,2653,25,1324096900,1324096900,1,1,0
42536354@N00,2654,11,1325392666,1325392714,2,1,48
42536354@N00,2655,25,1328681583,1328681583,1,1,0
42536354@N00,2656,25,1330060821,1330060830,2,1,9
42536354@N00,2657,25,1330524829,1330524829,1,1,0
42536354@N00,2658,25,1331693601,1331703739,4,1,10138
42536354@N00,2659,25,1332134731,1332134731,1,1,0
42536354@N00,2660,11,1332683223,1332683223,1,1,0
42536354@N00,2661,25,1332712357,1332712357,1,1,0
42536354@N00,2662,3,1351475336,1351475336,1,1,0
42536354@N00,2663,23,1357627619,1357627619,1,1,0
42536354@N00,2664,25,1357961171,1357966583,4,1,5412
42536354@N00,2665,28,1363922430,1363922430,1,1,0
42536354@N00,2666,6,1367568009,1367568009,1,3,0
42536354@N00,2666,21,1367565058,1367566206,5,3,1148
42536354@N00,2666,25,1367568777,1367568777,1,3,0
42536354@N00,2667,22,1370055794,1370056485,17,1,691
42536354@N00,2668,25,1374995941,1374996316,5,1,375
42536354@N00,2669,22,1383702042,1383705947,19,2,3905
42536354@N00,2669,28,1383705353,1383705353,1,2,0
42536354@N00,2670,23,1384505956,1384515581,3,1,9625
42536354@N00,2671,25,1385090078,1385090107,2,1,29
42536354@N00,2672,8,1385780066,1385784895,16,1,4829
42536354@N00,2673,28,1386540943,1386540943,1,1,0
42536354@N00,2674,25,1388035926,1388035926,1,1,0
42536354@N00,2675,7,1396082470,1396082470,1,1,0
42536354@N00,2676,7,1396179850,1396179850,1,1,0
42764252@N05,2677,24,1281130651,1281130651,1,1,0
42776905@N00,2678,29,1238133315,1238133572,7,1,257
42776905@N00,2679,22,1238210006,1238210145,5,2,139
42776905@N00,2679,28,1238209916,1238209984,3,2,68
42776905@N00,2680,21,1241155253,1241155303,3,2,50
42776905@N00,2680,23,1241154865,1241155065,4,2,200
42776905@N00,2681,21,1267354314,1267357021,5,1,2707
42875348@N00,2682,30,1196400575,1196400575,1,1,0
42875348@N00,2683,21,1242461118,1242462935,3,2,1817
42875348@N00,2683,28,1242463760,1242463760,1,2,0
42875348@N00,2684,24,1247294190,1247311439,2,1,17249
42907325@N00,2685,7,1177377527,1177377527,1,1,0
42907325@N00,2686,4,1182564774,1182570057,3,3,5283
42907325@N00,2686,16,1182563874,1182563874,1,3,0
42907325@N00,2686,28,1182557643,1182557643,1,3,0
42907325@N00,2687,24,1185082692,1185083459,2,1,767
42907325@N00,2688,4,1185440089,1185444806,2,1,4717
42907325@N00,2689,25,1185596666,1185596666,1,2,0
42907325@N00,2689,28,1185589170,1185589170,1,2,0
42907325@N00,2690,2,1185677365,1185684622,4,1,7257
42907325@N00,2691,11,1189223803,1189225552,5,1,1749
42994522@N03,2692,23,1252138186,1252138186,1,1,0
43021516@N06,2693,14,1261535557,1261535557,1,2,0
43021516@N06,2693,23,1261535553,1261535553,1,2,0
43067849@N00,2694,11,1180941309,1180946481,7,1,5172
43095782@N00,2695,7,1238820167,1238820167,1,1,0
43095782@N00,2696,29,1240457423,1240457423,1,1,0
43095782@N00,2697,7,1240621651,1240621651,1,1,0
43124406@N00,2698,11,1181161477,1181162635,3,1,1158
43124406@N00,2699,11,1182563212,1182563212,1,1,0
43139087@N00,2700,16,1100978788,1100979286,5,1,498
43139087@N00,2701,3,1112587936,1112587936,1,1,0
43139087@N00,2702,11,1129883780,1129884320,5,1,540
43139087@N00,2703,7,1136252168,1136252168,1,3,0
43139087@N00,2703,24,1136248201,1136250440,13,3,2239
43139087@N00,2703,30,1136252064,1136252064,1,3,0
43139087@N00,2704,24,1136367136,1136367136,1,1,0
43139087@N00,2705,7,1138674268,1138675996,11,5,1728
43139087@N00,2705,21,1138669512,1138670172,6,5,660
43139087@N00,2705,22,1138673228,1138673832,3,5,604
43139087@N00,2705,23,1138672092,1138672216,3,5,124
43139087@N00,2705,28,1138672508,1138672880,3,5,372
43139087@N00,2706,26,1140941176,1140949940,14,1,8764
43139087@N00,2707,11,1141110612,1141110732,2,1,120
43139087@N00,2708,22,1142228548,1142228768,6,1,220
43139087@N00,2709,26,1144728328,1144728780,16,1,452
43139087@N00,2710,26,1147218984,1147219392,3,1,408
43139087@N00,2711,11,1149820824,1149820824,1,1,0
43139087@N00,2712,22,1150354279,1150354279,1,1,0
43139087@N00,2713,9,1154061372,1154061574,11,1,202
43139087@N00,2714,11,1159624415,1159624415,1,1,0
43139087@N00,2715,28,1160722675,1160725180,10,1,2505
43139087@N00,2716,7,1160822012,1160831137,26,1,9125
43139087@N00,2717,1,1163146036,1163155310,25,1,9274
43139087@N00,2718,22,1170150797,1170151328,11,2,531
43139087@N00,2718,28,1170150527,1170150527,1,2,0
43139087@N00,2719,7,1171876517,1171876928,4,1,411
43139087@N00,2720,11,1173157971,1173158020,4,1,49
43139087@N00,2721,7,1175604097,1175604286,7,1,189
43139087@N00,2722,7,1178608459,1178608706,8,2,247
43139087@N00,2722,21,1178606276,1178606276,1,2,0
43139087@N00,2723,6,1178861763,1178865131,5,2,3368
43139087@N00,2723,22,1178855876,1178856566,24,2,690
43139087@N00,2724,25,1185591024,1185595868,43,1,4844
43139087@N00,2725,4,1199407975,1199408528,6,1,553
43139087@N00,2726,24,1214905330,1214905387,2,1,57
43139087@N00,2727,30,1218855771,1218855771,1,1,0
43139087@N00,2728,21,1219045108,1219045434,6,1,326
43139087@N00,2729,13,1246163881,1246163881,1,1,0
43139087@N00,2730,10,1275377034,1275377082,4,1,48
43139087@N00,2731,10,1276311113,1276313119,32,1,2006
43139087@N00,2732,24,1278211873,1278211873,1,1,0
43139087@N00,2733,22,1279592778,1279594895,14,1,2117
43139087@N00,2734,27,1279625032,1279625032,1,1,0
43139087@N00,2735,11,1280725350,1280725350,1,1,0
43139087@N00,2736,30,1281147555,1281156195,2,1,8640
43139087@N00,2737,24,1285114138,1285114166,2,1,28
43139087@N00,2738,11,1287214879,1287214903,2,1,24
43139087@N00,2739,22,1298948306,1298949447,4,1,1141
43139087@N00,2740,10,1302317656,1302319104,7,1,1448
43139087@N00,2741,25,1312085097,1312085183,2,1,86
43139087@N00,2742,28,1312357986,1312357986,1,1,0
43139087@N00,2743,11,1315302407,1315302407,1,1,0
43139087@N00,2744,21,1328430776,1328430776,1,1,0
43139087@N00,2745,29,1333087133,1333087133,1,1,0
43139087@N00,2746,11,1335735334,1335735334,1,1,0
43139087@N00,2747,11,1340362327,1340363828,4,1,1501
43139087@N00,2748,29,1342582781,1342582781,1,1,0
43139087@N00,2749,25,1348473147,1348473147,1,1,0
43139087@N00,2750,11,1351308304,1351308304,1,1,0
43139087@N00,2751,6,1351584541,1351584541,1,1,0
43139087@N00,2752,21,1352880356,1352880356,1,1,0
43139087@N00,2753,22,1353115568,1353115568,1,1,0
43139087@N00,2754,11,1355623768,1355623790,2,1,22
43139087@N00,2755,21,1355983955,1355983955,1,2,0
43139087@N00,2755,29,1355980011,1355980011,1,2,0
43139087@N00,2756,28,1358143130,1358143130,1,1,0
43139087@N00,2757,22,1359081529,1359081529,1,2,0
43139087@N00,2757,28,1359087859,1359087859,1,2,0
43139087@N00,2758,3,1359243540,1359243540,1,2,0
43139087@N00,2758,6,1359257373,1359262648,4,2,5275
43139087@N00,2759,3,1360740774,1360740774,1,1,0
43139087@N00,2760,21,1361502853,1361502853,1,1,0
43139087@N00,2761,27,1361667222,1361667222,1,1,0
43139087@N00,2762,6,1362274749,1362279249,7,1,4500
43139087@N00,2763,22,1362895764,1362895764,1,1,0
43139087@N00,2764,1,1363336701,1363336701,1,1,0
43139087@N00,2765,23,1363935330,1363935330,1,1,0
43139087@N00,2766,21,1364885081,1364885081,1,1,0
43139087@N00,2767,16,1366273409,1366273409,1,1,0
43139087@N00,2768,8,1367635894,1367635894,1,2,0
43139087@N00,2768,16,1367635929,1367635929,1,2,0
43139087@N00,2769,11,1367731410,1367731410,1,1,0
43139087@N00,2770,22,1368435540,1368435540,1,1,0
43139087@N00,2771,4,1369554452,1369555062,2,1,610
43139087@N00,2772,6,1370060149,1370060149,1,1,0
43139087@N00,2773,27,1370343094,1370343094,1,1,0
43139087@N00,2774,21,1371288122,1371288122,1,1,0
43139087@N00,2775,10,1372143892,1372143892,1,1,0
43139087@N00,2776,1,1375003602,1375009646,5,1,6044
43139087@N00,2777,8,1376188533,1376189277,2,1,744
43139087@N00,2778,4,1376382615,1376382615,1,1,0
43139087@N00,2779,14,1376990541,1376990541,1,2,0
43139087@N00,2779,17,1376990558,1376990558,1,2,0
43139087@N00,2780,6,1377679042,1377679660,4,1,618
43139087@N00,2781,27,1378168985,1378168985,1,1,0
43139087@N00,2782,6,1380100582,1380100582,1,1,0
43139087@N00,2783,6,1382079305,1382079305,1,1,0
43139087@N00,2784,10,1383111786,1383111786,1,1,0
43139087@N00,2785,21,1386147205,1386147205,1,1,0
43139087@N00,2786,29,1388645584,1388645584,1,1,0
43139087@N00,2787,10,1389396716,1389396904,2,1,188
43139087@N00,2788,21,1393884242,1393884354,2,1,112
43139087@N00,2789,29,1394065611,1394065611,1,1,0
43168431@N00,2790,11,1245575292,1245576730,3,1,1438
43266097@N03,2791,16,1372735681,1372735681,1,2,0
43266097@N03,2791,24,1372742521,1372747016,4,2,4495
43289453@N03,2792,2,580658408,580658408,1,1,0
43334562@N00,2793,30,1212056968,1212057142,2,1,174
43334562@N00,2794,19,1212197031,1212201369,3,1,4338
43334562@N00,2795,7,1212279150,1212279759,3,3,609
43334562@N00,2795,21,1212283700,1212288263,4,3,4563
43334562@N00,2795,23,1212287511,1212287511,1,3,0
43354049@N00,2796,1,1271781408,1271781408,1,2,0
43354049@N00,2796,24,1271779590,1271780099,4,2,509
43354049@N00,2797,24,1279755348,1279755634,4,1,286
43370110@N02,2798,11,1205139235,1205140005,12,1,770
43370110@N02,2799,11,1334294176,1334299491,29,1,5315
43435040@N02,2800,16,1282884836,1282884836,1,1,0
43661283@N00,2801,8,1364542508,1364542626,6,2,118
43661283@N00,2801,16,1364544000,1364544000,1,2,0
43661283@N00,2802,25,1374470921,1374470927,2,1,6
43919105@N02,2803,22,1300197204,1300197204,1,3,0
43919105@N02,2803,23,1300197221,1300197221,1,3,0
43919105@N02,2803,28,1300197197,1300197197,1,3,0
43919105@N02,2804,28,1300512130,1300512130,1,1,0
43919105@N02,2805,28,1306924742,1306924742,1,1,0
43919105@N02,2806,28,1323422925,1323422925,1,1,0
43919105@N02,2807,23,1323591370,1323591370,1,1,0
43924654@N00,2808,3,1327470977,1327470977,1,1,0
43994703@N03,2809,23,1336828413,1336828413,1,1,0
44037809@N06,2810,30,1352684064,1352684064,1,1,0
44045475@N00,2811,1,1298966457,1298966457,1,1,0
44082489@N00,2812,16,1397587023,1397587023,1,1,0
44082489@N00,2813,8,1397637017,1397637017,1,2,0
44082489@N00,2813,16,1397635715,1397635722,2,2,7
44082489@N00,2814,8,1397669098,1397669098,1,1,0
44124306710@N01,2815,11,1274983272,1274983272,1,1,0
44124306710@N01,2816,9,1275381151,1275381151,1,1,0
44124363348@N01,2817,21,1044671668,1044671668,1,1,0
44124363348@N01,2818,27,1055446091,1055446091,1,1,0
44124363348@N01,2819,11,1055649320,1055649320,1,1,0
44124363348@N01,2820,11,1104199132,1104210664,2,1,11532
44124363348@N01,2821,23,1125574135,1125574135,1,2,0
44124363348@N01,2821,30,1125573957,1125573957,1,2,0
44124363348@N01,2822,21,1135245916,1135245916,1,2,0
44124363348@N01,2822,23,1135245907,1135245907,1,2,0
44124363348@N01,2823,11,1144832707,1144832707,1,1,0
44124363348@N01,2824,23,1154744988,1154744988,1,1,0
44124363348@N01,2825,23,1174648372,1174648378,2,1,6
44124363348@N01,2826,6,1178945357,1178945357,1,1,0
44124363348@N01,2827,8,1211591028,1211591590,2,2,562
44124363348@N01,2827,23,1211599096,1211618975,2,2,19879
44124366920@N01,2828,27,1152273210,1152273565,5,1,355
44124366920@N01,2829,22,1165120085,1165120085,1,1,0
44124367252@N01,2830,23,1104033437,1104033536,6,1,99
44124367252@N01,2831,21,1129275135,1129275135,1,1,0
44124367252@N01,2832,27,1180151690,1180154657,57,1,2967
44124367252@N01,2833,4,1195972637,1195972637,1,1,0
44124367252@N01,2834,23,1207297690,1207297690,1,1,0
44124367252@N01,2835,2,1268519615,1268519615,1,1,0
44124367252@N01,2836,2,1268556006,1268556006,1,1,0
44124367252@N01,2837,21,1308388709,1308408064,19,1,19355
44124367252@N01,2838,4,1353659797,1353671100,3,3,11303
44124367252@N01,2838,6,1353645772,1353645814,2,3,42
44124367252@N01,2838,16,1353653508,1353653508,1,3,0
44124367252@N01,2839,6,1370675587,1370675587,1,1,0
44124367522@N01,2840,23,1292927223,1292945282,4,1,18059
44124367522@N01,2841,7,1302334701,1302334701,1,1,0
44124367522@N01,2842,30,1302691319,1302705691,2,1,14372
44124367522@N01,2843,7,1304148251,1304148251,1,1,0
44124367522@N01,2844,28,1310610356,1310624731,2,1,14375
44124367522@N01,2845,7,1310787602,1310787658,2,1,56
44124367522@N01,2846,7,1316701367,1316701367,1,1,0
44124367522@N01,2847,23,1321528274,1321528392,2,1,118
44124367522@N01,2848,21,1324269388,1324269388,1,1,0
44124367522@N01,2849,7,1324612801,1324612801,1,1,0
44124367522@N01,2850,6,1325316106,1325316106,1,2,0
44124367522@N01,2850,28,1325317457,1325317457,1,2,0
44124367522@N01,2851,6,1326617541,1326617541,1,1,0
44124367522@N01,2852,23,1333511847,1333511847,1,1,0
44124367522@N01,2853,21,1341369892,1341369933,2,1,41
44124367522@N01,2854,23,1342074032,1342074032,1,1,0
44124367522@N01,2855,17,1345737858,1345738176,3,1,318
44124367522@N01,2856,23,1347101728,1347101732,3,1,4
44124367522@N01,2857,21,1348934534,1348934534,1,1,0
44124367522@N01,2858,3,1353571228,1353571228,1,1,0
44124372363@N01,2859,23,219891307,219891307,1,1,0
44124372363@N01,2860,6,1378532265,1378536583,3,1,4318
44124372363@N01,2861,6,1378690764,1378690764,1,2,0
44124372363@N01,2861,22,1378692583,1378692583,1,2,0
44124375256@N01,2862,27,1188522835,1188522845,2,1,10
44124375256@N01,2863,27,1188596850,1188596850,1,1,0
44124375256@N01,2864,27,1192862607,1192866253,2,1,3646
44124375256@N01,2865,27,1194084126,1194084126,1,1,0
44124375256@N01,2866,27,1225749011,1225749011,1,1,0
44124375256@N01,2867,22,1229936596,1229936596,1,1,0
44124375256@N01,2868,22,1232879689,1232879689,1,1,0
44124375256@N01,2869,23,1302272360,1302272360,1,1,0
44124375256@N01,2870,1,1324986003,1324986003,1,1,0
44124375256@N01,2871,27,1381489243,1381489243,1,1,0
44124376393@N01,2872,1,1302319663,1302319663,1,1,0
44124383009@N01,2873,25,1164162376,1164162376,1,1,0
44124400268@N01,2874,30,1230671566,1230671566,1,1,0
44124400268@N01,2875,7,1380934064,1380934064,1,2,0
44124400268@N01,2875,21,1380931620,1380931620,1,2,0
44124400268@N01,2876,2,1383439498,1383439498,1,1,0
44124400268@N01,2877,8,1390087119,1390087119,1,1,0
44124400268@N01,2878,24,1393031839,1393031839,1,1,0
44124400268@N01,2879,24,1396761023,1396761023,1,1,0
44124427374@N01,2880,4,1085728975,1085743029,2,1,14054
44124441621@N01,2881,22,1128136280,1128136280,1,1,0
44124441621@N01,2882,16,1146620456,1146621816,5,2,1360
44124441621@N01,2882,22,1146650398,1146650478,2,2,80
44124441621@N01,2883,22,1311419077,1311419228,2,1,151
44124441621@N01,2884,29,1311479889,1311479889,1,2,0
44124441621@N01,2884,30,1311497028,1311497028,1,2,0
44124441621@N01,2885,16,1311591795,1311594506,7,1,2711
44124441621@N01,2886,30,1311631696,1311631696,1,1,0
44124441621@N01,2887,4,1311925355,1311939207,9,2,13852
44124441621@N01,2887,30,1311941421,1311941421,1,2,0
44124441621@N01,2888,22,1315313367,1315313367,1,1,0
44124441621@N01,2889,16,1317205340,1317205340,1,1,0
44124447497@N01,2890,27,966074800,966074800,1,1,0
44124450371@N01,2891,16,1113191564,1113191564,1,1,0
44129804@N03,2892,25,1285393257,1285393257,1,1,0
44129804@N03,2893,23,1293195427,1293200330,2,1,4903
44317189@N00,2894,27,1153039132,1153039132,1,1,0
44317189@N00,2895,27,1179021744,1179022252,7,1,508
44359705@N07,2896,4,1328400015,1328400038,2,4,23
44359705@N07,2896,16,1328398669,1328400242,3,4,1573
44359705@N07,2896,21,1328418503,1328418503,1,4,0
44359705@N07,2896,30,1328400164,1328400164,1,4,0
44438317@N03,2897,21,1261531383,1261533360,8,1,1977
44510773@N08,2898,4,1366327594,1366330098,4,1,2504
44528224@N05,2899,21,1257410051,1257410051,1,1,0
44576730@N06,2900,7,1332464147,1332464156,2,2,9
44576730@N06,2900,22,1332438325,1332438325,1,2,0
44576730@N06,2901,22,1332498315,1332498315,1,1,0
44576730@N06,2902,27,1332660939,1332660939,1,2,0
44576730@N06,2902,28,1332664109,1332664205,2,2,96
44654079@N05,2903,22,1325599342,1325599342,1,1,0
44654079@N05,2904,16,1345768299,1345792680,8,1,24381
44654079@N05,2905,16,1345862289,1345884034,7,1,21745
44654079@N05,2906,16,1345943876,1345962484,14,1,18608
44654079@N05,2907,22,1350705081,1350711123,11,1,6042
44654079@N05,2908,6,1358917087,1358918023,7,3,936
44654079@N05,2908,22,1358918497,1358918861,2,3,364
44654079@N05,2908,28,1358919461,1358919709,2,3,248
44663519@N02,2909,6,1289612156,1289612156,1,1,0
44702616@N04,2910,30,1330311148,1330311148,1,1,0
44702616@N04,2911,30,1332976672,1332976672,1,1,0
44702616@N04,2912,30,1333099101,1333099101,1,1,0
44702616@N04,2913,30,1333526550,1333526550,1,1,0
44702616@N04,2914,30,1333606204,1333606204,1,1,0
44864232@N00,2915,6,1377745677,1377745677,1,1,0
44925192@N00,2916,4,1367376078,1367376081,2,5,3
44925192@N00,2916,7,1367373983,1367373983,1,5,0
44925192@N00,2916,16,1367374648,1367381742,44,5,7094
44925192@N00,2916,21,1367373177,1367373177,2,5,0
44925192@N00,2916,30,1367374068,1367374068,1,5,0
44944819@N00,2917,21,1151139981,1151139981,1,1,0
45136299@N00,2918,16,1301268873,1301268873,1,1,0
45136299@N00,2919,2,1303548007,1303548007,1,1,0
45136299@N00,2920,25,1306671036,1306671036,1,1,0
45218955@N06,2921,23,1278228642,1278228642,1,1,0
45256273@N00,2922,27,1296024891,1296024891,1,1,0
45268975@N00,2923,8,1281157085,1281157085,1,1,0
45268975@N00,2924,1,1281242344,1281242344,1,1,0
45335695@N04,2925,21,1300356365,1300356365,1,1,0
45426479@N00,2926,23,1237259347,1237259347,1,1,0
45426479@N00,2927,7,1245469345,1245469345,1,1,0
45426479@N00,2928,22,1259733323,1259733323,1,1,0
45448689@N04,2929,3,1359170676,1359173286,4,1,2610
45448689@N04,2930,22,1382211586,1382214349,2,1,2763
45583066@N03,2931,26,1262503951,1262503951,1,1,0
45583066@N03,2932,16,1264987030,1264987030,1,1,0
45583066@N03,2933,22,1277347506,1277347506,1,1,0
45583066@N03,2934,29,1277550283,1277550283,1,1,0
45583066@N03,2935,28,1282525712,1282525712,1,1,0
45667699@N00,2936,8,1211598668,1211598668,1,2,0
45667699@N00,2936,22,1211590060,1211592001,6,2,1941
45667699@N00,2937,22,1275114845,1275114956,3,2,111
45667699@N00,2937,30,1275108534,1275111897,9,2,3363
45742513@N00,2938,15,1179725379,1179726905,16,1,1526
45742513@N00,2939,28,1286033330,1286034127,17,1,797
45742513@N00,2940,7,1328374455,1328374455,1,1,0
45742513@N00,2941,1,1331023405,1331023405,1,1,0
45742513@N00,2942,25,1333641173,1333641173,1,1,0
45742513@N00,2943,11,1334911016,1334913349,2,1,2333
45742513@N00,2944,6,1336043495,1336044263,2,1,768
45742513@N00,2945,27,1336635365,1336635365,1,1,0
45742513@N00,2946,25,1336751933,1336753149,3,1,1216
45742513@N00,2947,25,1337962315,1337962349,2,1,34
45742513@N00,2948,25,1343489141,1343489141,1,1,0
45742513@N00,2949,14,1346500288,1346500381,4,1,93
45742513@N00,2950,23,1347089901,1347089901,1,1,0
45742513@N00,2951,25,1347626619,1347626752,3,1,133
45742513@N00,2952,25,1347721593,1347730670,5,1,9077
45742513@N00,2953,4,1348975461,1348988297,4,1,12836
45742513@N00,2954,25,1350652518,1350655905,2,1,3387
45742513@N00,2955,25,1354365747,1354378478,40,1,12731
45742513@N00,2956,27,1354489471,1354489471,1,1,0
45742513@N00,2957,25,1359205294,1359214813,28,1,9519
45742513@N00,2958,25,1362145700,1362153522,51,1,7822
45742513@N00,2959,25,1362232443,1362232443,1,1,0
45742513@N00,2960,1,1362817216,1362830407,25,1,13191
45742513@N00,2961,1,1367828951,1367832160,2,1,3209
45742513@N00,2962,25,1368284079,1368285401,3,1,1322
45742513@N00,2963,8,1369403057,1369403057,1,1,0
45742513@N00,2964,25,1370091199,1370101247,7,1,10048
45742513@N00,2965,25,1371149519,1371158070,34,1,8551
45742513@N00,2966,24,1377328545,1377328545,1,1,0
45742513@N00,2967,25,1379680303,1379686842,47,1,6539
45802067@N03,2968,30,1349921002,1349921002,1,1,0
45972156@N04,2969,6,1335581282,1335603318,14,1,22036
46026252@N00,2970,16,1188464424,1188464424,1,1,0
46026252@N00,2971,11,1188550178,1188550673,2,2,495
46026252@N00,2971,22,1188545771,1188545771,1,2,0
46124393@N06,2972,27,1306941538,1306941538,1,1,0
46236149@N06,2973,16,1311591968,1311591968,1,1,0
46339941@N00,2974,11,1161854559,1161854559,1,1,0
46414217@N00,2975,7,1390167176,1390176240,2,1,9064
46525417@N06,2976,8,1338171996,1338171996,1,1,0
46588702@N00,2977,6,1293513034,1293513034,1,2,0
46588702@N00,2977,11,1293514224,1293514224,1,2,0
46588702@N00,2978,22,1293601521,1293601528,2,1,7
46588702@N00,2979,30,1293658198,1293658198,1,1,0
46629423@N00,2980,2,1301107097,1301107097,1,1,0
46639194@N05,2981,4,1369453724,1369453724,1,1,0
46708114@N07,2982,21,1306611945,1306673430,106,1,61485
46708114@N07,2983,11,1306892985,1306894863,15,1,1878
46708114@N07,2984,11,1306961851,1307001341,30,1,39490
46708114@N07,2985,11,1307066838,1307085059,14,1,18221
46708114@N07,2986,11,1307151945,1307152093,3,2,148
46708114@N07,2986,16,1307151501,1307192122,7,2,40621
46708114@N07,2987,11,1307406588,1307406732,11,1,144
46708114@N07,2988,11,1309320483,1309320483,1,1,0
46708114@N07,2989,11,1312330706,1312330706,1,1,0
46708114@N07,2990,21,1315646413,1315646413,1,1,0
46708114@N07,2991,11,1315815818,1315815818,1,1,0
46708114@N07,2992,11,1315916049,1315916049,1,2,0
46708114@N07,2992,23,1315884828,1315907734,2,2,22906
46708114@N07,2993,27,1321216603,1321221444,18,1,4841
46708114@N07,2994,27,1328195322,1328198461,10,1,3139
46708114@N07,2995,27,1332756607,1332756607,1,1,0
46708114@N07,2996,27,1337050014,1337055537,43,1,5523
46708114@N07,2997,7,1383988513,1383995460,68,1,6947
46769540@N00,2998,21,1150360921,1150360921,1,1,0
46769540@N00,2999,19,1151140258,1151140258,1,1,0
46769540@N00,3000,19,1151221336,1151221745,5,2,409
46769540@N00,3000,24,1151225553,1151229288,7,2,3735
46769540@N00,3001,22,1153124496,1153124496,1,1,0
46769540@N00,3002,22,1155112037,1155112037,1,1,0
46769540@N00,3003,11,1155375223,1155375259,2,2,36
46769540@N00,3003,24,1155351252,1155351252,1,2,0
46769540@N00,3004,7,1176522303,1176522303,1,1,0
46769540@N00,3005,28,1179145283,1179145283,1,1,0
46769540@N00,3006,11,1180166466,1180166477,2,1,11
46769540@N00,3007,13,1195277517,1195277882,3,2,365
46769540@N00,3007,27,1195283932,1195283932,1,2,0
46769540@N00,3008,6,1197779448,1197779633,3,3,185
46769540@N00,3008,22,1197777215,1197777215,1,3,0
46769540@N00,3008,28,1197776510,1197776938,2,3,428
46769540@N00,3009,22,1198730942,1198733987,3,1,3045
46769540@N00,3010,28,1206709200,1206709200,1,1,0
46769540@N00,3011,22,1212223515,1212226616,320,1,3101
46769540@N00,3012,22,1215485199,1215489964,15,2,4765
46769540@N00,3012,23,1215492103,1215494062,9,2,1959
46769540@N00,3013,21,1308448176,1308453551,2,1,5375
46769540@N00,3014,25,1312076876,1312076876,1,1,0
46769540@N00,3015,20,1313143443,1313143443,1,1,0
46769540@N00,3016,22,1317477255,1317477255,1,2,0
46769540@N00,3016,28,1317476924,1317476924,1,2,0
46989857@N00,3017,11,1152260706,1152265632,21,1,4926
46989857@N00,3018,25,1160030218,1160030218,1,1,0
46989857@N00,3019,21,1170120287,1170129242,24,1,8955
46989857@N00,3020,28,1206385509,1206392777,30,1,7268
47072881@N06,3021,11,1309691592,1309691876,2,1,284
47072881@N06,3022,6,1309846886,1309847333,3,1,447
47201412@N02,3023,29,-1704189600,-1704189600,1,1,0
47247182@N00,3024,7,1185750192,1185750209,2,1,17
47275680@N00,3025,25,1211684854,1211701739,83,1,16885
47275680@N00,3026,25,1213428983,1213430228,2,1,1245
47275680@N00,3027,11,1319439761,1319439761,1,1,0
47282998@N00,3028,21,1231654428,1231654428,1,1,0
47282998@N00,3029,21,1231720306,1231720306,1,1,0
47282998@N00,3030,21,1232259173,1232259173,1,1,0
47466679@N06,3031,28,1324188773,1324188773,1,1,0
47466679@N06,3032,27,1330144353,1330144353,1,1,0
47466679@N06,3033,30,1333068155,1333068155,1,1,0
47466679@N06,3034,29,1337931639,1337931639,1,1,0
47466679@N06,3035,21,1363753176,1363753176,1,1,0
47501960@N00,3036,11,1356146798,1356146798,1,2,0
47501960@N00,3036,27,1356148475,1356148475,1,2,0
47501960@N00,3037,3,1356247100,1356254157,7,3,7057
47501960@N00,3037,23,1356219192,1356219374,2,3,182
47501960@N00,3037,28,1356225309,1356225658,2,3,349
47501960@N00,3038,3,1356318726,1356329390,2,2,10664
47501960@N00,3038,21,1356322373,1356322373,1,2,0
47501960@N00,3039,21,1356413696,1356413747,2,2,51
47501960@N00,3039,22,1356410708,1356410708,1,2,0
47501960@N00,3040,21,1356508863,1356521823,4,3,12960
47501960@N00,3040,23,1356473763,1356473763,1,3,0
47501960@N00,3040,27,1356482530,1356484278,11,3,1748
47501960@N00,3041,6,1356650756,1356657010,5,1,6254
47501960@N00,3042,22,1382585726,1382585726,1,1,0
47501960@N00,3043,22,1382657144,1382657144,1,1,0
47554402@N00,3044,30,1295495388,1295495388,1,1,0
47554402@N00,3045,21,1295584047,1295584047,1,3,0
47554402@N00,3045,23,1295581522,1295583262,2,3,1740
47554402@N00,3045,28,1295585319,1295585326,2,3,7
47554402@N00,3046,13,1295667718,1295673150,6,2,5432
47554402@N00,3046,25,1295659231,1295659231,1,2,0
47554402@N00,3047,23,1337400238,1337417477,4,1,17239
47554402@N00,3048,13,1337479014,1337485218,3,1,6204
47554402@N00,3049,11,1337575020,1337581813,2,1,6793
47614548@N00,3050,21,1244710235,1244710235,1,1,0
47614548@N00,3051,15,1245549314,1245549314,1,2,0
47614548@N00,3051,24,1245546513,1245547077,3,2,564
47616704@N00,3052,4,1248792811,1248793772,2,7,961
47616704@N00,3052,6,1248794152,1248794152,1,7,0
47616704@N00,3052,7,1248793894,1248793894,1,7,0
47616704@N00,3052,16,1248792939,1248793847,7,7,908
47616704@N00,3052,22,1248781825,1248781825,1,7,0
47616704@N00,3052,24,1248793814,1248793814,1,7,0
47616704@N00,3052,30,1248794354,1248794354,1,7,0
47616704@N00,3053,11,1248844516,1248862733,15,2,18217
47616704@N00,3053,21,1248881431,1248881431,1,2,0
47616704@N00,3054,19,1249366592,1249366592,1,2,0
47616704@N00,3054,30,1249373253,1249373253,1,2,0
47638736@N00,3055,21,1170743677,1170743677,1,1,0
47638736@N00,3056,30,1171605379,1171605379,1,1,0
47638736@N00,3057,30,1172092971,1172092971,1,1,0
47643206@N00,3058,21,1153166840,1153169774,2,1,2934
47643206@N00,3059,23,1153390796,1153390796,1,1,0
47643206@N00,3060,22,1159862840,1159862840,1,1,0
47643206@N00,3061,21,1183021080,1183021080,1,1,0
47643206@N00,3062,21,1183453241,1183453675,2,1,434
47643206@N00,3063,21,1183969190,1183969190,1,1,0
47643206@N00,3064,21,1213086857,1213086857,1,1,0
47643206@N00,3065,28,1222066452,1222066452,1,1,0
47643206@N00,3066,22,1223135749,1223135749,1,1,0
47643206@N00,3067,25,1232969541,1232969541,1,1,0
47643206@N00,3068,16,1234770289,1234770289,1,1,0
47643206@N00,3069,17,1251802082,1251805980,2,1,3898
47662183@N04,3070,11,1267325869,1267325869,1,1,0
47672266@N00,3071,23,1176542839,1176549100,2,1,6261
47672266@N00,3072,23,1177150528,1177154746,6,1,4218
47672266@N00,3073,23,1181731165,1181737141,2,1,5976
47672266@N00,3074,21,1186542693,1186542693,1,1,0
47672266@N00,3075,23,1191064760,1191067699,4,1,2939
47672266@N00,3076,23,1193485001,1193485001,1,1,0
47672266@N00,3077,23,1196506605,1196510227,3,1,3622
47672266@N00,3078,23,1212147279,1212147279,1,1,0
47868018@N00,3079,4,1244359757,1244359995,29,2,238
47868018@N00,3079,16,1244359784,1244359799,2,2,15
47868018@N00,3080,4,1244949088,1244949137,4,1,49
47868018@N00,3081,4,1248577604,1248577604,1,1,0
47868018@N00,3082,27,1249285585,1249285625,5,1,40
47868018@N00,3083,1,1257502177,1257502177,1,1,0
47868018@N00,3084,1,1258783233,1258783244,2,1,11
47868018@N00,3085,4,1275788146,1275797001,2,1,8855
47868018@N00,3086,7,1333862493,1333862493,1,1,0
47868018@N00,3087,7,1345716127,1345716127,1,1,0
48012497@N02,3088,8,1370212824,1370212824,1,1,0
48085290@N00,3089,21,1134272391,1134272391,1,1,0
48085290@N00,3090,7,1142049588,1142049588,1,3,0
48085290@N00,3090,16,1142047384,1142047671,4,3,287
48085290@N00,3090,30,1142041290,1142041312,2,3,22
48085290@N00,3091,25,1148181603,1148182884,3,1,1281
48085290@N00,3092,24,1178408102,1178413300,5,1,5198
48085290@N00,3093,7,1180744933,1180744975,2,2,42
48085290@N00,3093,11,1180751378,1180752986,2,2,1608
48085290@N00,3094,24,1184588751,1184588751,1,1,0
48085290@N00,3095,25,1184921028,1184921028,1,1,0
48085290@N00,3096,24,1184994352,1185008065,12,1,13713
48085290@N00,3097,2,1187412221,1187414292,7,1,2071
48085290@N00,3098,30,1192844996,1192845106,2,1,110
48085290@N00,3099,22,1199109054,1199109978,3,1,924
48085290@N00,3100,7,1203041788,1203041884,2,1,96
48096488@N03,3101,7,-2082880800,-2082880800,1,2,0
48096488@N03,3101,30,-2082880800,-2082880800,1,2,0
48096488@N03,3102,7,-2073376800,-2073376800,1,2,0
48096488@N03,3102,30,-2073376800,-2073376800,3,2,0
48096488@N03,3103,7,-2073204000,-2073204000,1,2,0
48096488@N03,3103,30,-2073204000,-2073204000,1,2,0
48096488@N03,3104,30,-1990864800,-1990864800,1,1,0
48096488@N03,3105,15,-1956650400,-1956650400,1,1,0
48096488@N03,3106,2,-1801476000,-1801476000,3,1,0
48096488@N03,3107,28,-1474970400,-1474970400,1,1,0
48096488@N03,3108,27,-1341396000,-1341396000,1,1,0
48096488@N03,3109,27,-1283853600,-1283853600,1,1,0
48096488@N03,3110,2,-1265018400,-1265018400,1,1,0
48096488@N03,3111,22,-1135332000,-1135332000,1,1,0
48096488@N03,3112,7,-1125828000,-1125828000,1,1,0
48096488@N03,3113,6,-1116410400,-1116410400,1,1,0
48096488@N03,3114,6,-1105610400,-1105610400,1,1,0
48096488@N03,3115,6,-1099994400,-1099994400,1,1,0
48096488@N03,3116,6,-917517600,-917517600,1,1,0
48096488@N03,3117,3,-791632800,-791632800,2,1,0
48096488@N03,3118,3,-762861600,-762861600,1,1,0
48096488@N03,3119,3,-633866400,-633866400,1,1,0
48096488@N03,3120,3,-476100000,-476100000,7,1,0
48096488@N03,3121,3,-464695200,-464695200,1,1,0
48096488@N03,3122,22,-136807200,-136807200,1,1,0
48096488@N03,3123,3,-94730400,-94730400,1,1,0
48096488@N03,3124,3,-2714400,-2714400,1,1,0
48096488@N03,3125,21,28821600,28821600,3,2,0
48096488@N03,3125,23,28821600,28821600,2,2,0
48096488@N03,3126,23,60354000,60354000,1,1,0
48096488@N03,3127,13,189262800,189262800,1,1,0
48096488@N03,3128,21,281278800,281278800,8,2,0
48096488@N03,3128,23,281278800,281278800,2,2,0
48253376@N00,3129,22,1375597337,1375597337,1,1,0
48355243@N00,3130,3,1244698519,1244698650,2,2,131
48355243@N00,3130,23,1244708121,1244708121,1,2,0
48355243@N00,3131,21,1244786240,1244793310,3,2,7070
48355243@N00,3131,23,1244789241,1244789671,4,2,430
48453097@N00,3132,16,1208332516,1208332586,2,1,70
48453097@N00,3133,21,1217575392,1217575567,4,3,175
48453097@N00,3133,25,1217571801,1217571801,1,3,0
48453097@N00,3133,28,1217563483,1217563483,1,3,0
48453097@N00,3134,16,1217735348,1217743154,25,1,7806
48600088197@N01,3135,3,1278419214,1278419214,1,1,0
48600101146@N01,3136,21,1103794421,1103794421,1,1,0
48600103384@N01,3137,8,1349922075,1349926474,8,2,4399
48600103384@N01,3137,16,1349916858,1349919966,6,2,3108
48600103384@N01,3138,23,1350081205,1350081205,1,2,0
48600103384@N01,3138,28,1350081686,1350083832,3,2,2146
48645178@N07,3139,23,1361758465,1361758465,1,1,0
48678427@N06,3140,30,1308443243,1308443243,1,1,0
48678427@N06,3141,22,1377840712,1377840712,1,1,0
48678427@N06,3142,22,1378013324,1378013324,1,1,0
48678427@N06,3143,22,1378114092,1378114103,2,1,11
48678427@N06,3144,22,1378240461,1378240461,1,1,0
48678427@N06,3145,25,1379123940,1379123940,1,1,0
48678427@N06,3146,22,1381054067,1381058667,7,1,4600
48678427@N06,3147,6,1381545200,1381549291,20,1,4091
48678427@N06,3148,22,1382754102,1382754102,1,1,0
48678427@N06,3149,6,1383210042,1383210489,2,5,447
48678427@N06,3149,21,1383213796,1383214046,2,5,250
48678427@N06,3149,22,1383211999,1383212038,2,5,39
48678427@N06,3149,28,1383212365,1383212883,3,5,518
48678427@N06,3149,29,1383208212,1383208212,1,5,0
48678427@N06,3150,21,1393030208,1393030208,1,1,0
48704273@N00,3151,4,1369387474,1369387474,1,1,0
48784629@N00,3152,4,1148282976,1148283048,4,2,72
48784629@N00,3152,16,1148289589,1148289589,1,2,0
48784629@N00,3153,4,1157447311,1157451023,3,1,3712
48784629@N00,3154,7,1170900496,1170900496,1,2,0
48784629@N00,3154,30,1170900146,1170900198,3,2,52
48784629@N00,3155,4,1203727844,1203727866,3,3,22
48784629@N00,3155,8,1203726721,1203731288,11,3,4567
48784629@N00,3155,16,1203739251,1203739404,7,3,153
48784629@N00,3156,1,1212665051,1212671263,12,1,6212
48784629@N00,3157,21,1217068716,1217070577,12,2,1861
48784629@N00,3157,23,1217070642,1217078551,45,2,7909
48784629@N00,3158,21,1217689045,1217689633,2,1,588
48784629@N00,3159,21,1217748965,1217748965,1,1,0
48784629@N00,3160,16,1218702863,1218702863,1,1,0
48784629@N00,3161,1,1225876417,1225880581,5,1,4164
48784629@N00,3162,1,1226184735,1226184981,10,1,246
48784629@N00,3163,1,1226480747,1226486794,32,1,6047
48784629@N00,3164,21,1239704842,1239704842,1,1,0
48784629@N00,3165,4,1240305343,1240310526,18,1,5183
48784629@N00,3166,21,1241439107,1241439107,1,1,0
48784629@N00,3167,1,1256711278,1256724286,61,1,13008
48784629@N00,3168,1,1257319717,1257331000,79,1,11283
48784629@N00,3169,1,1258854155,1258862372,35,1,8217
48784629@N00,3170,1,1259048956,1259058158,53,1,9202
48784629@N00,3171,1,1259459792,1259468718,84,1,8926
48784629@N00,3172,1,1259653081,1259661507,85,1,8426
48784629@N00,3173,1,1260518066,1260525188,57,1,7122
48784629@N00,3174,1,1262502643,1262511261,113,1,8618
48784629@N00,3175,1,1263691894,1263699576,49,1,7682
48784629@N00,3176,1,1265186287,1265192296,83,1,6009
48784629@N00,3177,1,1265789623,1265796554,74,1,6931
48784629@N00,3178,8,1266032059,1266037614,24,1,5555
48784629@N00,3179,1,1266392219,1266403934,117,1,11715
48784629@N00,3180,1,1267170967,1267180934,99,1,9967
48784629@N00,3181,1,1267776642,1267783881,43,1,7239
48784629@N00,3182,1,1270019399,1270027210,112,1,7811
48784629@N00,3183,1,1270626697,1270635848,99,1,9151
48784629@N00,3184,2,1282360381,1282363113,98,1,2732
48784629@N00,3185,1,1286997327,1286997327,1,1,0
48784629@N00,3186,1,1290149851,1290162806,74,1,12955
48784629@N00,3187,1,1291969117,1291977206,62,1,8089
48784629@N00,3188,1,1292396331,1292407181,62,1,10850
48784629@N00,3189,1,1292722134,1292733452,75,1,11318
48784629@N00,3190,1,1294536663,1294548119,62,1,11456
48784629@N00,3191,1,1294582306,1294582306,1,1,0
48784629@N00,3192,1,1294819578,1294828192,51,1,8614
48784629@N00,3193,1,1296201259,1296211390,89,1,10131
48784629@N00,3194,21,1297483259,1297483259,1,1,0
48784629@N00,3195,1,1297559226,1297589967,118,1,30741
48784629@N00,3196,1,1297842516,1297851836,103,1,9320
48784629@N00,3197,16,1298265067,1298274085,10,1,9018
48784629@N00,3198,1,1298789842,1298798103,86,1,8261
48784629@N00,3199,1,1298965512,1298974522,122,1,9010
48784629@N00,3200,23,1302858496,1302864962,34,1,6466
48784629@N00,3201,21,1303980335,1303980335,1,1,0
48784629@N00,3202,1,1307871516,1307871516,1,1,0
48784629@N00,3203,1,1311989866,1311989866,1,1,0
48784629@N00,3204,4,1312204367,1312204367,1,1,0
48784629@N00,3205,21,1316830967,1316830967,1,1,0
48784629@N00,3206,8,1319345862,1319345862,1,1,0
48784629@N00,3207,1,1322215423,1322307773,107,1,92350
48784629@N00,3208,24,1324370540,1324370540,1,1,0
48784629@N00,3209,1,1325057883,1325062405,35,1,4522
48784629@N00,3210,1,1325172784,1325172784,1,1,0
48784629@N00,3211,1,1325839069,1325843868,20,1,4799
48784629@N00,3212,1,1326064684,1326064713,4,2,29
48784629@N00,3212,24,1326066272,1326066272,1,2,0
48784629@N00,3213,1,1326096629,1326105386,35,1,8757
48784629@N00,3214,1,1327050555,1327054246,48,1,3691
48784629@N00,3215,1,1328693116,1328695989,37,1,2873
48784629@N00,3216,1,1328861150,1328869936,38,1,8786
48784629@N00,3217,1,1328940404,1328940404,1,1,0
48784629@N00,3218,1,1330935343,1330942959,42,1,7616
48784629@N00,3219,2,1334385251,1334391104,16,1,5853
48784629@N00,3220,1,1335433718,1335439105,53,1,5387
48784629@N00,3221,19,1337586755,1337586755,1,1,0
48784629@N00,3222,2,1338017358,1338020974,52,1,3616
48784629@N00,3223,4,1339553043,1339561724,28,1,8681
48784629@N00,3224,3,1339980919,1339980919,1,1,0
48784629@N00,3225,3,1340055538,1340055538,1,1,0
48784629@N00,3226,13,1343556520,1343556520,1,1,0
48784629@N00,3227,4,1346405338,1346405338,1,1,0
48784629@N00,3228,4,1346470166,1346470166,1,1,0
48784629@N00,3229,4,1346642833,1346642833,1,1,0
48784629@N00,3230,4,1346750575,1346758716,3,1,8141
48784629@N00,3231,4,1347613990,1347625890,3,1,11900
48784629@N00,3232,2,1347683483,1347683483,1,1,0
48784629@N00,3233,4,1348738150,1348738150,1,1,0
48784629@N00,3234,4,1349256603,1349256603,1,1,0
48784629@N00,3235,30,1349458693,1349458693,1,1,0
48784629@N00,3236,2,1349493045,1349493045,1,1,0
48784629@N00,3237,1,1349683819,1349683819,1,1,0
48784629@N00,3238,27,1349748976,1349748976,1,1,0
48784629@N00,3239,1,1350893371,1350893371,1,1,0
48784629@N00,3240,27,1351059622,1351059622,1,1,0
48784629@N00,3241,1,1354264169,1354264169,1,1,0
48784629@N00,3242,4,1355635402,1355640983,3,1,5581
48784629@N00,3243,1,1355904275,1355904275,1,2,0
48784629@N00,3243,27,1355879819,1355879819,1,2,0
48784629@N00,3244,1,1357286538,1357286538,1,1,0
48784629@N00,3245,1,1357892309,1357892309,1,1,0
48784629@N00,3246,1,1358044240,1358055231,2,1,10991
48784629@N00,3247,27,1358289841,1358303399,2,1,13558
48784629@N00,3248,1,1358646958,1358651115,2,1,4157
48784629@N00,3249,1,1359359423,1359364440,2,1,5017
48784629@N00,3250,1,1359705146,1359705146,1,1,0
48784629@N00,3251,1,1360138499,1360150772,2,1,12273
48784629@N00,3252,1,1360657613,1360663791,2,1,6178
48784629@N00,3253,1,1363485456,1363493237,2,1,7781
48784629@N00,3254,1,1363939982,1363939982,1,1,0
48784629@N00,3255,1,1364373292,1364380674,2,1,7382
48784629@N00,3256,4,1364885382,1364906159,3,1,20777
48784629@N00,3257,4,1365148252,1365148252,1,1,0
48784629@N00,3258,4,1365214423,1365214423,1,1,0
48784629@N00,3259,1,1365734181,1365763566,3,1,29385
48784629@N00,3260,1,1365845923,1365845923,1,1,0
48784629@N00,3261,1,1365918433,1365918433,1,1,0
48784629@N00,3262,1,1366193755,1366199834,2,1,6079
48784629@N00,3263,4,1366540444,1366540444,1,1,0
48784629@N00,3264,4,1367309557,1367309557,1,1,0
48784629@N00,3265,4,1367485579,1367485579,1,1,0
48784629@N00,3266,1,1368013026,1368013026,1,1,0
48784629@N00,3267,4,1368522838,1368532939,2,1,10101
48784629@N00,3268,4,1368607883,1368607883,1,1,0
48784629@N00,3269,4,1369021766,1369021766,1,1,0
48784629@N00,3270,2,1370079230,1370079230,1,1,0
48784629@N00,3271,2,1370155051,1370155051,1,1,0
48784629@N00,3272,4,1371459991,1371459991,1,1,0
48784629@N00,3273,4,1371546818,1371546818,1,1,0
48784629@N00,3274,4,1371632984,1371639220,2,1,6236
48784629@N00,3275,4,1371874403,1371874403,1,1,0
48784629@N00,3276,4,1371954061,1371954061,1,1,0
48784629@N00,3277,4,1372647895,1372647895,1,1,0
48784629@N00,3278,4,1373167400,1373167400,1,1,0
48784629@N00,3279,1,1373573282,1373573282,1,1,0
48784629@N00,3280,4,1374054498,1374068924,26,1,14426
48784629@N00,3281,4,1374225175,1374228506,2,1,3331
48784629@N00,3282,4,1374370825,1374382560,2,1,11735
48784629@N00,3283,4,1374484165,1374484165,1,1,0
48784629@N00,3284,3,1375953775,1375953775,1,1,0
48784629@N00,3285,4,1376186698,1376186698,1,1,0
48784629@N00,3286,4,1376476813,1376483397,2,1,6584
48784629@N00,3287,4,1377400326,1377400326,1,1,0
48784629@N00,3288,4,1377593877,1377603372,2,1,9495
48784629@N00,3289,4,1377854912,1377854912,1,2,0
48784629@N00,3289,24,1377863684,1377863684,1,2,0
48784629@N00,3290,4,1378804204,1378804204,1,1,0
48784629@N00,3291,4,1378938137,1378938137,1,1,0
48784629@N00,3292,4,1378978326,1378978326,1,1,0
48784629@N00,3293,23,1379925303,1379925303,1,1,0
48784629@N00,3294,1,1380360785,1380360785,1,2,0
48784629@N00,3294,4,1380340007,1380341565,2,2,1558
48784629@N00,3295,4,1380424929,1380424929,1,1,0
48784629@N00,3296,22,1380983157,1380983157,1,1,0
48784629@N00,3297,1,1381478476,1381478476,1,1,0
48784629@N00,3298,1,1381515755,1381515755,1,2,0
48784629@N00,3298,23,1381540342,1381540342,1,2,0
48784629@N00,3299,8,1382009422,1382009422,1,1,0
48784629@N00,3300,8,1382067456,1382067456,1,1,0
48784629@N00,3301,1,1382341524,1382351848,3,1,10324
48784629@N00,3302,1,1382408589,1382408589,1,1,0
48784629@N00,3303,1,1382519216,1382519216,1,1,0
48784629@N00,3304,1,1383095079,1383123614,3,1,28535
48784629@N00,3305,1,1383638529,1383638529,1,1,0
48784629@N00,3306,4,1385876112,1385876112,1,1,0
48784629@N00,3307,1,1386068207,1386068207,1,1,0
48784629@N00,3308,11,1386328730,1386328730,1,1,0
48784629@N00,3309,1,1386922360,1386922360,1,1,0
48784629@N00,3310,1,1387269011,1387269011,1,1,0
48784629@N00,3311,1,1387354010,1387354010,1,1,0
48784629@N00,3312,23,1387566718,1387579278,3,1,12560
48784629@N00,3313,1,1387701524,1387718939,35,1,17415
48784629@N00,3314,1,1387770460,1387801652,31,1,31192
48784629@N00,3315,1,1388218067,1388218067,1,1,0
48784629@N00,3316,1,1389431309,1389431309,1,1,0
48784629@N00,3317,1,1390378882,1390378882,1,1,0
48784629@N00,3318,1,1390445091,1390445091,1,1,0
48784629@N00,3319,1,1390813491,1390813491,1,1,0
48784629@N00,3320,1,1390984374,1390984374,1,1,0
48784629@N00,3321,8,1391125378,1391125378,1,1,0
48784629@N00,3322,24,1391389083,1391389083,1,1,0
48784629@N00,3323,24,1391501890,1391501890,1,1,0
48784629@N00,3324,1,1391642568,1391642568,1,1,0
48784629@N00,3325,6,1391681991,1391682539,2,1,548
48784629@N00,3326,6,1391731122,1391731122,1,1,0
48784629@N00,3327,1,1392071897,1392071897,1,1,0
48784629@N00,3328,1,1392204514,1392204514,1,1,0
48784629@N00,3329,1,1392544050,1392544050,1,1,0
48784629@N00,3330,24,1392879330,1392879330,1,1,0
48784629@N00,3331,1,1392969679,1392976991,3,1,7312
48784629@N00,3332,1,1393488987,1393491642,2,1,2655
48784629@N00,3333,1,1394617510,1394617510,1,1,0
48784629@N00,3334,1,1395388371,1395400009,2,1,11638
48784629@N00,3335,4,1395881443,1395881443,1,1,0
48784629@N00,3336,1,1396002516,1396002516,1,1,0
48784629@N00,3337,4,1396599763,1396599763,1,1,0
48784629@N00,3338,1,1397035909,1397035909,1,1,0
48784629@N00,3339,1,1397821589,1397821589,1,1,0
48784629@N00,3340,1,1398160630,1398160630,1,1,0
48784629@N00,3341,1,1398201038,1398201038,1,1,0
48784629@N00,3342,4,1398332654,1398332654,1,1,0
48784629@N00,3343,1,1398384548,1398384548,1,1,0
48805529@N00,3344,11,1078625808,1078626080,2,1,272
48805529@N00,3345,28,1142433558,1142433558,1,1,0
48805529@N00,3346,11,1181353433,1181355542,2,1,2109
48862435@N00,3347,1,1329211502,1329211502,1,1,0
48889054224@N01,3348,16,1371323314,1371323489,2,1,175
48889073020@N01,3349,14,1093005974,1093005974,1,1,0
48889073020@N01,3350,17,1156930869,1156941666,35,1,10797
48889073020@N01,3351,23,1228536899,1228540786,21,1,3887
48889116964@N01,3352,28,1085138588,1085139083,3,1,495
48889116964@N01,3353,4,1285449613,1285449613,1,2,0
48889116964@N01,3353,22,1285468514,1285468564,2,2,50
48929148@N00,3354,24,1310119424,1310130166,4,1,10742
48929148@N00,3355,24,1310265806,1310287345,4,1,21539
48929148@N00,3356,22,1347679813,1347687103,4,1,7290
48986833@N00,3357,22,1174210118,1174210118,1,1,0
48986833@N00,3358,22,1174248644,1174248644,1,1,0
48986833@N00,3359,22,1174354057,1174354094,2,1,37
48986833@N00,3360,22,1174398185,1174409766,3,1,11581
49033510@N00,3361,11,1159613481,1159613481,1,1,0
49033510@N00,3362,27,1165989130,1165989173,2,1,43
49075539@N06,3363,11,1273472998,1273473564,5,1,566
49075539@N06,3364,7,1284700934,1284703291,7,1,2357
49075539@N06,3365,25,1284948166,1284953017,15,1,4851
49075539@N06,3366,23,1296598429,1296598429,1,1,0
49109678@N04,3367,16,1358225965,1358225965,1,1,0
49291517@N00,3368,21,1317703008,1317703008,1,1,0
49291907@N00,3369,22,1265522898,1265522898,1,1,0
49291907@N00,3370,24,1277844087,1277844623,4,1,536
49351889@N03,3371,11,1271610737,1271610737,1,1,0
49380681@N03,3372,24,1393894098,1393894098,1,1,0
49501395@N00,3373,25,1130755114,1130755114,1,1,0
49501395@N00,3374,25,1134381768,1134381768,1,1,0
49501395@N00,3375,26,1229409505,1229409505,1,1,0
49502979331@N01,3376,21,1350100189,1350100189,1,2,0
49502979331@N01,3376,28,1350104009,1350104009,1,2,0
49502994427@N01,3377,10,1158385558,1158385558,1,2,0
49502994427@N01,3377,29,1158376323,1158376334,2,2,11
49502994427@N01,3378,6,1246003031,1246010799,11,1,7768
49502994427@N01,3379,27,1246956994,1246957093,2,1,99
49502994427@N01,3380,6,1247805648,1247805648,1,1,0
49502994427@N01,3381,6,1249890283,1249890283,1,1,0
49502994427@N01,3382,6,1251881568,1251883734,2,1,2166
49502994427@N01,3383,6,1259305627,1259305627,1,1,0
49502994427@N01,3384,25,1261802676,1261802676,1,1,0
49502994427@N01,3385,27,1261883347,1261883446,2,1,99
49502994427@N01,3386,29,1272150886,1272150886,1,1,0
49502994427@N01,3387,29,1272446792,1272446792,1,1,0
49502994427@N01,3388,6,1274344898,1274344898,1,1,0
49502994427@N01,3389,29,1275178915,1275178915,1,1,0
49502994427@N01,3390,6,1278133098,1278139251,6,1,6153
49502994427@N01,3391,6,1284547522,1284547522,1,1,0
49502994427@N01,3392,6,1284792785,1284792785,1,1,0
49502994427@N01,3393,11,1303092685,1303092685,1,1,0
49502994427@N01,3394,27,1304144961,1304144961,1,1,0
49502994427@N01,3395,2,1306556920,1306556920,1,1,0
49502994427@N01,3396,6,1311154027,1311154027,1,2,0
49502994427@N01,3396,25,1311161158,1311161158,1,2,0
49502994427@N01,3397,6,1312964130,1312964130,1,1,0
49502994427@N01,3398,22,1314351845,1314352850,8,1,1005
49502994427@N01,3399,6,1370061490,1370061490,1,1,0
49503002894@N01,3400,1,1369883549,1369883549,1,2,0
49503002894@N01,3400,22,1369883261,1369896096,2,2,12835
49503002894@N01,3401,3,1369999444,1369999444,1,3,0
49503002894@N01,3401,8,1369962804,1369991606,3,3,28802
49503002894@N01,3401,22,1369957749,1369996230,6,3,38481
49503002894@N01,3402,8,1370030903,1370057493,3,3,26590
49503002894@N01,3402,19,1370073197,1370073197,1,3,0
49503002894@N01,3402,22,1370074247,1370074247,1,3,0
49503002894@N01,3403,8,1370121677,1370147602,7,3,25925
49503002894@N01,3403,16,1370139487,1370139487,1,3,0
49503002894@N01,3403,22,1370170761,1370170761,1,3,0
49503002894@N01,3404,22,1370206876,1370206876,1,1,0
49503002894@N01,3405,21,1379371755,1379371755,1,1,0
49503002894@N01,3406,4,1379487521,1379490745,2,2,3224
49503002894@N01,3406,22,1379439735,1379474284,3,2,34549
49503002894@N01,3407,3,1379557359,1379557359,1,1,0
49503002894@N01,3408,22,1381894657,1381894741,2,1,84
49503002894@N01,3409,22,1382943216,1382943216,1,1,0
49503088378@N01,3410,30,1308888867,1308888867,1,1,0
49503088378@N01,3411,16,1370424533,1370424533,1,1,0
49503159256@N01,3412,11,1267842866,1267843095,2,1,229
49503207397@N01,3413,11,1160419616,1160420988,2,1,1372
49503207397@N01,3414,11,1160524612,1160532311,4,1,7699
49503207397@N01,3415,16,1160593050,1160598768,7,1,5718
49503207397@N01,3416,28,1160658888,1160658888,1,2,0
49503207397@N01,3416,30,1160671391,1160671391,1,2,0
49576181@N00,3417,16,1171784691,1171784691,1,1,0
49576181@N00,3418,27,1231286628,1231286628,1,1,0
49576181@N00,3419,30,1254629419,1254629419,1,1,0
49576181@N00,3420,28,1289554919,1289565458,15,1,10539
49576181@N00,3421,27,1301030505,1301044832,2,1,14327
49576181@N00,3422,4,1339512955,1339515751,2,1,2796
49576181@N00,3423,28,1340439568,1340439568,1,1,0
49576181@N00,3424,6,1377167756,1377167756,1,1,0
49576181@N00,3425,2,1377337456,1377337456,1,1,0
49576181@N00,3426,21,1383816339,1383816339,1,1,0
49576181@N00,3427,22,1387923990,1387923990,1,1,0
49582157@N00,3428,8,1122096284,1122096377,3,2,93
49582157@N00,3428,30,1122088721,1122097759,6,2,9038
49582157@N00,3429,8,1263714070,1263714304,3,2,234
49582157@N00,3429,30,1263712230,1263716889,7,2,4659
49594238@N05,3430,10,1271939006,1271939006,1,1,0
49594238@N05,3431,13,1273680121,1273680121,1,1,0
49594238@N05,3432,16,1273987963,1273987974,2,1,11
49645639@N00,3433,25,1216790920,1216790920,1,1,0
49685418@N05,3434,13,1385690669,1385691357,8,1,688
49689051@N00,3435,23,1253353500,1253375182,4,1,21682
49877040@N03,3436,7,1281764808,1281764808,1,1,0
49877040@N03,3437,7,1281968107,1281968319,6,2,212
49877040@N03,3437,21,1281970231,1281970235,2,2,4
49877040@N03,3438,4,1282027754,1282027754,1,3,0
49877040@N03,3438,16,1282013090,1282033186,22,3,20096
49877040@N03,3438,25,1282049203,1282049635,5,3,432
49877040@N03,3439,11,1282126737,1282127681,7,2,944
49877040@N03,3439,29,1282124875,1282126107,6,2,1232
49889874@N05,3440,28,1274934592,1274934592,1,1,0
49889874@N05,3441,27,1275181146,1275181146,1,1,0
49889874@N05,3442,29,1284852299,1284856934,8,1,4635
49889874@N05,3443,27,1295682813,1295690386,2,1,7573
49889874@N05,3444,2,1304737747,1304737873,2,1,126
49889874@N05,3445,27,1308382944,1308382944,1,1,0
49889874@N05,3446,22,1314739765,1314739765,1,1,0
49889874@N05,3447,22,1314945244,1314945323,2,1,79
49889874@N05,3448,27,1332915382,1332915382,1,1,0
49889874@N05,3449,28,1334906158,1334906158,1,1,0
49894734@N00,3450,25,1217888347,1217888347,1,1,0
49894734@N00,3451,22,1217975907,1217975907,1,1,0
49894734@N00,3452,21,1218447411,1218447411,1,1,0
49894734@N00,3453,23,1218674821,1218674821,1,1,0
49894734@N00,3454,21,1229758564,1229758707,2,3,143
49894734@N00,3454,22,1229765169,1229767806,8,3,2637
49894734@N00,3454,23,1229762200,1229762589,2,3,389
49894734@N00,3455,30,1237095063,1237095063,1,1,0
49969498@N02,3456,26,1396416962,1396421659,8,1,4697
50034279@N00,3457,6,1245564345,1245564866,3,1,521
50034279@N00,3458,8,1277004441,1277004441,1,1,0
50034279@N00,3459,21,1308391200,1308398443,54,1,7243
50034279@N00,3460,21,1308672535,1308672535,1,1,0
50034279@N00,3461,21,1371124800,1371124806,7,1,6
50034279@N00,3462,25,1371297600,1371297621,22,1,21
50107790@N00,3463,16,1151658976,1151658976,1,1,0
50168539@N03,3464,29,1289663191,1289663191,1,1,0
50197929@N00,3465,21,1339846841,1339846841,1,1,0
50207065@N00,3466,12,1277438660,1277438704,5,1,44
50378660@N00,3467,4,1376201168,1376201168,1,1,0
50519990@N00,3468,4,1305098209,1305098209,1,1,0
50542255@N00,3469,7,1188199750,1188199750,1,3,0
50542255@N00,3469,16,1188192474,1188192474,1,3,0
50542255@N00,3469,28,1188207584,1188207584,1,3,0
50542255@N00,3470,8,1188977734,1188977734,1,1,0
50542255@N00,3471,30,1190199315,1190199315,1,1,0
50567308@N00,3472,6,1308807612,1308807612,1,1,0
50579340@N00,3473,22,1388467650,1388467650,1,1,0
50642338@N00,3474,22,1120811019,1120811019,1,1,0
50642338@N00,3475,30,1138369209,1138369209,1,1,0
50642338@N00,3476,9,1139357006,1139357006,1,1,0
50642338@N00,3477,30,1143809368,1143809368,1,1,0
50642338@N00,3478,21,1151731808,1151732007,4,1,199
50642338@N00,3479,23,1151808942,1151808942,1,2,0
50642338@N00,3479,28,1151809663,1151815818,23,2,6155
50642338@N00,3480,25,1153013489,1153013489,1,1,0
50642338@N00,3481,11,1175995139,1175997964,2,3,2825
50642338@N00,3481,27,1175993825,1175998342,5,3,4517
50642338@N00,3481,30,1176011375,1176011375,1,3,0
50642338@N00,3482,11,1195215507,1195217023,26,1,1516
50642338@N00,3483,11,1195720884,1195725456,4,1,4572
50861256@N00,3484,11,1257579575,1257581415,5,1,1840
50861256@N00,3485,21,1274342754,1274342754,1,1,0
50861256@N00,3486,30,1294962989,1294962989,1,1,0
50861256@N00,3487,3,1296102361,1296102467,3,1,106
50861256@N00,3488,8,1298087421,1298087421,1,1,0
50861256@N00,3489,26,1371386445,1371386445,1,1,0
50861256@N00,3490,21,1392001986,1392005470,7,2,3484
50861256@N00,3490,23,1391997793,1391997793,1,2,0
51035534212@N01,3491,25,1310022301,1310022301,1,1,0
51035534212@N01,3492,25,1353017889,1353017889,1,1,0
51035555243@N01,3493,21,1281045058,1281053060,61,4,8002
51035555243@N01,3493,22,1281053839,1281056439,69,4,2600
51035555243@N01,3493,23,1281043289,1281044960,21,4,1671
51035555243@N01,3493,30,1281035807,1281041629,56,4,5822
51035555243@N01,3494,21,1281093554,1281093554,1,1,0
51035555243@N01,3495,16,1281173626,1281173626,1,1,0
51035555243@N01,3496,30,1281234035,1281235440,17,1,1405
51035595117@N01,3497,23,1196160503,1196169325,140,1,8822
51035604559@N01,3498,4,1301712675,1301712675,1,1,0
51035608727@N01,3499,21,1180816031,1180816031,1,1,0
51035610516@N01,3500,22,1215853590,1215853897,8,2,307
51035610516@N01,3500,25,1215848619,1215849530,6,2,911
51035610516@N01,3501,4,1216031916,1216032812,22,5,896
51035610516@N01,3501,8,1216027955,1216031227,4,5,3272
51035610516@N01,3501,16,1216031264,1216037185,11,5,5921
51035610516@N01,3501,21,1216026292,1216026329,4,5,37
51035610516@N01,3501,30,1216027880,1216027906,3,5,26
51035610516@N01,3502,15,1216106799,1216106799,1,2,0
51035610516@N01,3502,19,1216107050,1216107967,3,2,917
51035627578@N01,3503,24,1215851632,1215851632,1,1,0
51035681908@N01,3504,4,1208655138,1208655167,3,6,29
51035681908@N01,3504,11,1208663193,1208664276,3,6,1083
51035681908@N01,3504,16,1208655547,1208655547,1,6,0
51035681908@N01,3504,21,1208646038,1208646038,1,6,0
51035681908@N01,3504,22,1208647464,1208647492,3,6,28
51035681908@N01,3504,25,1208658062,1208658334,3,6,272
51035681908@N01,3505,16,1208758858,1208760628,10,1,1770
51035702270@N01,3506,16,1171711330,1171711330,1,1,0
51035702270@N01,3507,28,1171962480,1171962480,1,1,0
51035702270@N01,3508,24,1183717354,1183717354,1,1,0
51035702270@N01,3509,17,1219921170,1219921170,1,1,0
51035702270@N01,3510,16,1234068597,1234068597,1,1,0
51035702270@N01,3511,28,1293166208,1293166208,1,1,0
51035729697@N01,3512,16,1212196555,1212201023,14,1,4468
51035729697@N01,3513,30,1212280030,1212280088,2,1,58
51035729697@N01,3514,6,1308182401,1308182817,7,3,416
51035729697@N01,3514,7,1308180486,1308180496,3,3,10
51035729697@N01,3514,30,1308181004,1308181278,4,3,274
51035767928@N01,3515,25,1246089617,1246089617,1,1,0
51050970@N07,3516,11,1277551096,1277551096,1,1,0
51050970@N07,3517,11,1278139989,1278140160,2,1,171
51050970@N07,3518,11,1278574707,1278575860,9,1,1153
51065677@N05,3519,22,1348628498,1348628498,1,1,0
51065677@N05,3520,30,1348723763,1348723763,1,1,0
51149594@N07,3521,16,1365292405,1365292405,1,1,0
51149594@N07,3522,22,1370235784,1370235784,1,1,0
51149594@N07,3523,3,1370382868,1370382868,1,1,0
51149594@N07,3524,22,1370477599,1370477599,1,1,0
51149594@N07,3525,10,1371181902,1371181902,1,1,0
51149594@N07,3526,3,1371385649,1371385649,1,1,0
51149594@N07,3527,22,1371547242,1371547979,3,2,737
51149594@N07,3527,23,1371547463,1371547463,1,2,0
51149594@N07,3528,4,1371797909,1371803850,3,1,5941
51149594@N07,3529,4,1372041013,1372041013,1,1,0
51149594@N07,3530,3,1372110419,1372110419,1,1,0
51149594@N07,3531,10,1372575864,1372576895,2,1,1031
51149594@N07,3532,21,1372936034,1372936034,1,1,0
51149594@N07,3533,10,1373002120,1373002120,1,1,0
51149594@N07,3534,25,1373522095,1373522377,2,1,282
51149594@N07,3535,25,1373631654,1373631654,1,1,0
51149594@N07,3536,21,1373660503,1373660503,1,1,0
51149594@N07,3537,3,1374229846,1374229846,1,1,0
51149594@N07,3538,3,1376465519,1376465519,1,1,0
51149594@N07,3539,10,1377207039,1377207039,1,2,0
51149594@N07,3539,21,1377224187,1377224187,1,2,0
51149594@N07,3540,24,1378649654,1378649654,1,1,0
51149594@N07,3541,21,1379414419,1379414419,1,1,0
51149594@N07,3542,9,1380284006,1380289013,3,1,5007
51149594@N07,3543,22,1380978137,1380978137,1,1,0
51149594@N07,3544,11,1383382018,1383419972,4,1,37954
51149594@N07,3545,3,1383878000,1383878000,1,1,0
51149594@N07,3546,3,1385073658,1385073658,1,1,0
51149594@N07,3547,3,1386841211,1386841423,2,1,212
51149594@N07,3548,3,1387965215,1387965215,1,1,0
51149594@N07,3549,3,1391900817,1391900817,1,1,0
51149594@N07,3550,3,1392437133,1392437133,1,1,0
51149594@N07,3551,25,1392952996,1392952996,1,1,0
51212909@N02,3552,6,1370516632,1370516632,1,1,0
51228219@N00,3553,4,1388725396,1388725396,1,1,0
51260381@N05,3554,16,1276936534,1276936534,1,1,0
51260381@N05,3555,22,1277187030,1277187030,1,2,0
51260381@N05,3555,28,1277183960,1277184080,3,2,120
51260381@N05,3556,7,1277533003,1277537371,6,3,4368
51260381@N05,3556,25,1277526969,1277526969,1,3,0
51260381@N05,3556,30,1277536628,1277536628,1,3,0
51272979@N00,3557,22,1352305989,1352305989,1,1,0
51272979@N00,3558,16,1352415357,1352415357,1,1,0
51272979@N00,3559,25,1353092067,1353092067,1,1,0
51465598@N02,3560,16,1309618733,1309631377,9,1,12644
51515183@N08,3561,23,1334581887,1334581887,1,1,0
51515183@N08,3562,1,1353754894,1353754894,1,1,0
51515183@N08,3563,27,1366265786,1366265786,1,1,0
51515183@N08,3564,1,1384945793,1384945793,1,1,0
51515183@N08,3565,1,1387717726,1387717726,1,1,0
51560606@N07,3566,22,1311943792,1311944952,35,1,1160
51593349@N06,3567,25,1268755920,1268755920,1,1,0
51668926@N00,3568,23,1184073614,1184073614,1,1,0
51668926@N00,3569,13,1274069926,1274069926,1,1,0
51668926@N00,3570,25,1274600853,1274600853,1,1,0
51668926@N00,3571,25,1274692967,1274692967,1,1,0
51668926@N00,3572,13,1288767954,1288767954,1,1,0
51668926@N00,3573,7,1307837857,1307842553,5,1,4696
51668926@N00,3574,23,1309752256,1309752256,1,1,0
51668926@N00,3575,15,1312429062,1312432235,3,1,3173
51668926@N00,3576,11,1317096440,1317096440,1,1,0
51668926@N00,3577,25,1322109006,1322109052,2,1,46
51668926@N00,3578,25,1338094027,1338098523,3,1,4496
51668926@N00,3579,2,1346231219,1346231219,1,2,0
51668926@N00,3579,17,1346233096,1346234553,2,2,1457
51668926@N00,3580,22,1356923680,1356923680,1,1,0
51758913@N05,3581,16,1248399729,1248399729,1,1,0
52078443@N06,3582,16,1282865676,1282898323,25,1,32647
52078443@N06,3583,16,1282955385,1282969078,26,1,13693
52078443@N06,3584,16,1292110661,1292115067,16,1,4406
52078443@N06,3585,16,1345696955,1345712902,2,1,15947
52078443@N06,3586,16,1345766295,1345789145,7,1,22850
52078443@N06,3587,16,1345851571,1345876362,26,1,24791
52215743@N00,3588,6,1376720273,1376721569,2,1,1296
52262601@N00,3589,12,1043318009,1043318009,1,1,0
52293377@N03,3590,16,1366901693,1366902177,2,1,484
52574241@N00,3591,6,1358399335,1358399335,1,1,0
52754961@N00,3592,11,1116712805,1116712805,1,1,0
52835300@N00,3593,6,1372995189,1372999051,5,1,3862
52937176@N05,3594,30,1280460082,1280460082,1,1,0
53025862@N00,3595,8,1255229573,1255229623,2,2,50
53025862@N00,3595,16,1255226547,1255229641,6,2,3094
53088812@N00,3596,7,1177172143,1177172254,4,1,111
53088812@N00,3597,28,1350552903,1350552903,1,2,0
53088812@N00,3597,30,1350571991,1350571991,1,2,0
53088812@N00,3598,6,1374389664,1374389664,1,1,0
53242241@N00,3599,24,1285816793,1285824888,35,1,8095
53242241@N00,3600,1,1302066297,1302067050,11,1,753
53319639@N00,3601,7,1108184102,1108184102,1,1,0
53319639@N00,3602,13,1219985503,1219986561,9,1,1058
53319639@N00,3603,11,1221179499,1221201215,19,1,21716
53319639@N00,3604,10,1261283537,1261283604,2,1,67
53346833@N00,3605,11,1121419108,1121419235,3,1,127
53346833@N00,3606,6,1185950986,1185950986,1,2,0
53346833@N00,3606,16,1185927097,1185927097,1,2,0
53346833@N00,3607,24,1205649283,1205650535,4,1,1252
53346833@N00,3608,11,1226274718,1226274718,1,1,0
53346833@N00,3609,24,1246758470,1246759484,5,1,1014
53346833@N00,3610,1,1248914680,1248914680,1,1,0
53346833@N00,3611,20,1255159595,1255159595,1,1,0
53346833@N00,3612,6,1255745632,1255745632,1,1,0
53346833@N00,3613,18,1268096740,1268096740,1,1,0
53400644@N05,3614,7,1285737314,1285737466,9,1,152
53400644@N05,3615,21,1286027180,1286027180,1,1,0
53456098@N06,3616,30,1354749205,1354749205,1,1,0
53493629@N00,3617,11,1186891139,1186891139,1,1,0
53503190@N07,3618,22,1372742340,1372742340,1,1,0
53503896@N00,3619,30,1319693660,1319693660,1,1,0
53593077@N02,3620,16,1346399786,1346399786,1,1,0
53593077@N02,3621,16,1383562825,1383562825,1,1,0
53627208@N00,3622,29,1173866468,1173866468,1,1,0
53726870@N00,3623,11,1319252667,1319253200,5,1,533
53776349@N00,3624,11,1181262376,1181262376,1,1,0
53874606@N00,3625,8,1369869739,1369869739,1,1,0
53874606@N00,3626,1,1369920020,1369921161,3,3,1141
53874606@N00,3626,8,1369903336,1369919551,6,3,16215
53874606@N00,3626,16,1369904181,1369918311,5,3,14130
53876642@N04,3627,13,1341125233,1341125233,1,1,0
53888074@N00,3628,25,1388141428,1388141450,2,1,22
53888074@N00,3629,7,1388195622,1388197764,4,1,2142
53909299@N00,3630,21,1339337998,1339337998,1,1,0
54038992@N02,3631,16,1294892482,1294892582,4,1,100
54038992@N02,3632,11,1300777637,1300777637,1,1,0
54058873@N00,3633,23,1175248933,1175261282,150,1,12349
54058873@N00,3634,8,1195701914,1195706644,3,1,4730
54058873@N00,3635,4,1195807322,1195818503,15,1,11181
54058873@N00,3636,3,1195910143,1195910143,1,6,0
54058873@N00,3636,8,1195903450,1195903462,2,6,12
54058873@N00,3636,21,1195897041,1195909735,4,6,12694
54058873@N00,3636,22,1195904460,1195908679,6,6,4219
54058873@N00,3636,23,1195909250,1195909353,2,6,103
54058873@N00,3636,28,1195908728,1195909124,6,6,396
54058873@N00,3637,4,1195971260,1195991376,26,1,20116
54058873@N00,3638,4,1225383877,1225384307,11,1,430
54058873@N00,3639,1,1243687577,1243687577,1,1,0
54058873@N00,3640,4,1245240960,1245240960,1,1,0
54058873@N00,3641,4,1249090139,1249106469,9,1,16330
54058873@N00,3642,4,1250240419,1250253634,5,1,13215
54058873@N00,3643,4,1262401521,1262406150,5,1,4629
54058873@N00,3644,4,1276410614,1276422897,3,2,12283
54058873@N00,3644,16,1276410573,1276422339,2,2,11766
54058921@N00,3645,3,1340349923,1340349923,1,1,0
54058921@N00,3646,6,1340400110,1340408229,2,1,8119
54147964@N05,3647,7,1348703315,1348703315,1,2,0
54147964@N05,3647,13,1348709254,1348709254,1,2,0
54147964@N05,3648,9,1348798345,1348798345,1,2,0
54147964@N05,3648,11,1348819159,1348819159,1,2,0
54147964@N05,3649,30,1349080701,1349080701,1,1,0
54208548@N00,3650,16,1142060030,1142060030,1,1,0
54322086@N00,3651,6,1232943677,1232951309,16,1,7632
54329815@N00,3652,23,1190777994,1190777994,1,1,0
54329815@N00,3653,23,1203469752,1203469752,1,1,0
54329815@N00,3654,22,1213945119,1213945119,1,1,0
54329815@N00,3655,25,1256552273,1256552273,1,1,0
54329815@N00,3656,21,1266451552,1266451552,1,1,0
54329815@N00,3657,25,1272702756,1272702756,1,1,0
54329815@N00,3658,6,1274257874,1274257874,1,1,0
54329815@N00,3659,6,1277883571,1277883571,1,1,0
54329815@N00,3660,25,1278565259,1278565259,1,1,0
54329815@N00,3661,29,1320657442,1320657442,1,1,0
54329815@N00,3662,23,1321414148,1321414148,1,1,0
54329815@N00,3663,6,1323590962,1323590962,1,1,0
54329815@N00,3664,6,1323675252,1323675252,1,1,0
54329815@N00,3665,25,1323939410,1323939410,1,1,0
54329815@N00,3666,6,1324069377,1324069377,1,1,0
54329815@N00,3667,25,1337318778,1337318778,1,1,0
54329815@N00,3668,21,1337483108,1337483108,1,1,0
54329815@N00,3669,6,1338210590,1338210590,1,1,0
54329815@N00,3670,6,1339211635,1339211635,1,1,0
54329815@N00,3671,6,1339375943,1339375943,1,1,0
54329815@N00,3672,6,1339990072,1339990072,1,1,0
54329815@N00,3673,30,1342938009,1342938009,1,1,0
54329815@N00,3674,6,1343873086,1343873086,1,2,0
54329815@N00,3674,21,1343889734,1343890447,2,2,713
54329815@N00,3675,21,1347419771,1347419771,1,1,0
54329815@N00,3676,6,1349995553,1349995553,1,1,0
54329815@N00,3677,3,1361701344,1361701344,1,1,0
54329815@N00,3678,3,1363431774,1363431774,1,1,0
54329815@N00,3679,6,1371691545,1371691545,1,1,0
54329815@N00,3680,6,1386581832,1386581832,1,1,0
54449565@N08,3681,2,1338711432,1338711432,1,1,0
54484406@N08,3682,28,1300260530,1300260911,2,1,381
54484406@N08,3683,22,1309825458,1309825458,1,1,0
54484406@N08,3684,12,1311671685,1311671685,1,1,0
54484406@N08,3685,28,1319622940,1319622940,1,1,0
54625768@N02,3686,7,1204951708,1204951708,1,2,0
54625768@N02,3686,30,1204951867,1204952125,2,2,258
54625768@N02,3687,16,1205027068,1205027068,1,1,0
54717162@N00,3688,13,1118189415,1118189500,3,1,85
54816622@N07,3689,14,1314356671,1314360160,2,1,3489
54874446@N00,3690,27,1191080119,1191080133,2,1,14
54874446@N00,3691,22,1192192908,1192194291,10,1,1383
54874446@N00,3692,16,1198309752,1198309752,1,1,0
55003729@N07,3693,21,1344949664,1344949664,1,1,0
55289779@N00,3694,30,1380785993,1380787492,18,1,1499
55289779@N00,3695,21,1385685562,1385686966,8,1,1404
55289779@N00,3696,21,1389765958,1389765969,2,2,11
55289779@N00,3696,23,1389754488,1389754624,4,2,136
55289779@N00,3697,7,1397008375,1397012357,77,1,3982
55289779@N00,3698,7,1397615589,1397615758,7,1,169
55289779@N00,3699,7,1397717200,1397717871,12,2,671
55289779@N00,3699,21,1397724809,1397724845,16,2,36
55289779@N00,3700,21,1397782569,1397782605,5,1,36
55289779@N00,3701,16,1398216053,1398216106,8,2,53
55289779@N00,3701,30,1398235480,1398235667,21,2,187
55372451@N00,3702,7,1167399892,1167401371,4,1,1479
55412350@N00,3703,2,1345282443,1345282443,1,1,0
55547987@N03,3704,6,1305091853,1305091853,1,1,0
55702966@N05,3705,16,1387781494,1387781494,1,1,0
55929357@N00,3706,22,1331780653,1331807636,2,1,26983
55929357@N00,3707,22,1331918936,1331919150,2,3,214
55929357@N00,3707,23,1331918780,1331918780,1,3,0
55929357@N00,3707,28,1331918703,1331918703,1,3,0
55929357@N00,3708,22,1331983352,1331983352,1,2,0
55929357@N00,3708,28,1331956060,1331983422,5,2,27362
55929357@N00,3709,23,1332020424,1332020424,1,1,0
56020405@N08,3710,11,1296281786,1296281786,1,1,0
56020405@N08,3711,22,1298601239,1298601239,1,1,0
56020405@N08,3712,21,1303620457,1303620998,2,2,541
56020405@N08,3712,23,1303617334,1303619592,4,2,2258
56020405@N08,3713,30,1322795640,1322795736,2,1,96
56020405@N08,3714,7,1327989683,1327989683,1,1,0
56020405@N08,3715,27,1330228217,1330228217,1,1,0
56020405@N08,3716,11,1333787760,1333787760,1,1,0
56020405@N08,3717,7,1339655084,1339655084,1,1,0
56020405@N08,3718,7,1339732429,1339732429,1,1,0
56020405@N08,3719,7,1355813601,1355813601,1,1,0
56020405@N08,3720,28,1355907524,1355907524,1,1,0
56020405@N08,3721,22,1371270334,1371270334,1,2,0
56020405@N08,3721,28,1371271587,1371271587,1,2,0
56261505@N00,3722,23,1289215065,1289215065,1,1,0
56261505@N00,3723,16,1323565714,1323578610,6,1,12896
56277684@N06,3724,7,1286039390,1286041813,10,1,2423
56277684@N06,3725,15,1367732652,1367732652,1,1,0
56344788@N00,3726,21,1361677727,1361677727,1,2,0
56344788@N00,3726,30,1361683868,1361683868,1,2,0
56381024@N00,3727,28,1356060846,1356060896,3,1,50
56489822@N08,3728,29,1291113938,1291113948,2,1,10
56525171@N00,3729,6,1306629762,1306629793,2,2,31
56525171@N00,3729,16,1306640376,1306640781,3,2,405
56619626@N05,3730,13,1243201792,1243208371,5,1,6579
56779003@N00,3731,7,1216165376,1216165484,4,1,108
56779003@N00,3732,22,1216360658,1216360658,1,1,0
56779003@N00,3733,7,1218319670,1218319697,2,1,27
56779003@N00,3734,7,1219411264,1219411342,2,1,78
56779003@N00,3735,8,1219445816,1219448791,29,1,2975
56779003@N00,3736,6,1228341617,1228341808,2,2,191
56779003@N00,3736,22,1228342701,1228342701,1,2,0
56946277@N00,3737,1,1305089821,1305090126,2,1,305
56949082@N00,3738,16,1251687338,1251687343,2,1,5
56949082@N00,3739,23,1258247668,1258253155,2,1,5487
56949082@N00,3740,6,1265252578,1265252636,5,1,58
56949082@N00,3741,6,1360994930,1360994930,1,1,0
56949082@N00,3742,6,1367724762,1367724762,1,1,0
57155801@N00,3743,24,1186740763,1186740763,1,1,0
57230884@N02,3744,6,1370576271,1370576271,1,1,0
57230884@N02,3745,6,1378870401,1378870542,2,1,141
57230884@N02,3746,7,1381905305,1381905305,1,1,0
57230884@N02,3747,22,1384306819,1384307069,2,1,250
57230884@N02,3748,6,1384509374,1384509374,1,1,0
57412095@N05,3749,30,1348919403,1348919403,1,1,0
57412095@N05,3750,22,1348995324,1348996327,2,2,1003
57412095@N05,3750,28,1348995471,1348996210,2,2,739
57449260@N00,3751,28,1301004378,1301004378,1,1,0
57449260@N00,3752,22,1302133225,1302133225,1,1,0
57449260@N00,3753,23,1356685784,1356685784,1,1,0
57449260@N00,3754,25,1363991611,1363991611,1,1,0
57449260@N00,3755,3,1367591553,1367591553,1,1,0
57449260@N00,3756,25,1369469829,1369469829,1,1,0
57449260@N00,3757,3,1372594235,1372594235,1,1,0
57449260@N00,3758,13,1375693859,1375693859,1,1,0
57449260@N00,3759,22,1380685180,1380685293,2,1,113
57449260@N00,3760,22,1381051266,1381051266,1,1,0
57449260@N00,3761,22,1385170049,1385170049,1,1,0
57449260@N00,3762,11,1385868339,1385868339,1,1,0
57449260@N00,3763,8,1394869047,1394869047,1,1,0
57499798@N00,3764,13,1335692816,1335692816,1,1,0
57499798@N00,3765,1,1340105537,1340105537,1,1,0
57499798@N00,3766,13,1352597864,1352597864,1,1,0
57519914@N00,3767,7,1323769490,1323769490,1,5,0
57519914@N00,3767,8,1323749724,1323749724,1,5,0
57519914@N00,3767,16,1323760471,1323760471,1,5,0
57519914@N00,3767,22,1323754402,1323754402,1,5,0
57519914@N00,3767,28,1323754930,1323754930,1,5,0
57519914@N00,3768,8,1323811784,1323811784,1,1,0
57519914@N00,3769,8,1323895443,1323895443,1,1,0
57635334@N00,3770,21,1304480850,1304480850,1,1,0
57681978@N00,3771,11,1207798886,1207798886,1,1,0
57704782@N00,3772,28,1135244792,1135244792,1,1,0
57704782@N00,3773,11,1138348613,1138351915,4,1,3302
57704782@N00,3774,11,1138785144,1138785144,1,1,0
57756296@N06,3775,22,1301741571,1301741571,1,1,0
57756296@N06,3776,7,1306626199,1306636261,38,1,10062
57756296@N06,3777,7,1307056776,1307057011,7,1,235
57756296@N06,3778,25,1309059778,1309059778,1,1,0
57756296@N06,3779,2,1309483887,1309501692,88,1,17805
57756296@N06,3780,2,1341099518,1341114242,154,1,14724
57756296@N06,3781,11,1341634739,1341658455,141,1,23716
57756296@N06,3782,11,1341722063,1341727613,59,1,5550
57756296@N06,3783,2,1372632151,1372646301,8,1,14150
57756296@N06,3784,6,1373683758,1373683758,1,1,0
57756296@N06,3785,6,1385674797,1385674797,1,1,0
57756296@N06,3786,7,1392528524,1392528524,1,1,0
57756296@N06,3787,30,1392582072,1392582072,1,1,0
57767818@N00,3788,23,1377375115,1377375115,1,1,0
57767818@N00,3789,30,1377415214,1377415214,1,1,0
57784634@N08,3790,1,1345241925,1345241925,1,2,0
57784634@N08,3790,7,1345241251,1345241251,1,2,0
57784634@N08,3791,7,1348894199,1348894199,1,1,0
57784634@N08,3792,30,1360379048,1360379048,1,1,0
57784634@N08,3793,21,1361100276,1361100276,1,1,0
57815411@N00,3794,23,1393052715,1393052715,1,1,0
57873901@N04,3795,25,1304152652,1304152652,1,1,0
57914633@N00,3796,11,1301562904,1301562941,2,1,37
57934408@N00,3797,30,1301025304,1301025304,1,1,0
57934408@N00,3798,7,1318906193,1318906193,1,1,0
57934408@N00,3799,24,1320546476,1320546476,1,1,0
57934408@N00,3800,21,1331434992,1331434992,1,1,0
57934408@N00,3801,11,1358297770,1358297770,1,1,0
57958712@N00,3802,29,1225859969,1225863351,11,1,3382
57958712@N00,3803,25,1243762345,1243764476,10,1,2131
57958712@N00,3804,21,1244378458,1244379085,4,1,627
57958712@N00,3805,8,1245148344,1245148344,1,1,0
57958712@N00,3806,22,1246016802,1246016802,1,2,0
57958712@N00,3806,25,1246033212,1246033212,1,2,0
57958712@N00,3807,23,1246275261,1246275261,1,1,0
57958712@N00,3808,22,1246760817,1246760817,1,1,0
57958712@N00,3809,27,1247818422,1247821977,5,1,3555
57958712@N00,3810,21,1248186274,1248186274,1,1,0
57958712@N00,3811,25,1250410064,1250412779,6,1,2715
57958712@N00,3812,27,1251533690,1251533744,2,1,54
57958712@N00,3813,21,1253363945,1253363945,1,1,0
57958712@N00,3814,6,1254485448,1254485448,1,1,0
57958712@N00,3815,6,1255743825,1255746922,3,2,3097
57958712@N00,3815,11,1255752929,1255752929,1,2,0
57958712@N00,3816,30,1264318810,1264318810,1,1,0
57958712@N00,3817,30,1266111494,1266112466,4,1,972
57958712@N00,3818,14,1283588197,1283588197,1,1,0
57958712@N00,3819,23,1360206371,1360215242,2,1,8871
57958712@N00,3820,30,1360478777,1360478808,2,1,31
57958712@N00,3821,16,1362878172,1362878172,1,1,0
57958712@N00,3822,6,1363407697,1363407697,1,1,0
57958712@N00,3823,21,1369825342,1369825342,1,1,0
57977817@N00,3824,24,1123316791,1123318570,3,1,1779
57977817@N00,3825,10,1145072482,1145072482,1,1,0
57984896@N00,3826,8,1299568086,1299568086,1,1,0
58246681@N03,3827,22,1343473094,1343473094,1,1,0
58246681@N03,3828,10,1345639507,1345639507,1,2,0
58246681@N03,3828,22,1345620418,1345620418,1,2,0
58246681@N03,3829,3,1365669552,1365669552,1,1,0
58246681@N03,3830,29,1369555189,1369555189,1,1,0
58246681@N03,3831,11,1371465412,1371465412,1,1,0
58246681@N03,3832,6,1380102665,1380102665,1,1,0
58395207@N00,3833,11,1280099846,1280099888,5,1,42
58421656@N08,3834,30,1311420317,1311420317,1,1,0
58447918@N00,3835,16,1284258293,1284258293,1,1,0
58502009@N00,3836,1,1170928380,1170935134,55,1,6754
58502009@N00,3837,24,1183025697,1183025865,3,1,168
58502009@N00,3838,24,1183117408,1183119195,19,1,1787
58564459@N05,3839,25,1346460451,1346460451,1,1,0
58575431@N00,3840,25,1153298559,1153298559,1,1,0
58575431@N00,3841,11,1172223871,1172223871,1,1,0
58664871@N08,3842,22,1331022855,1331022855,1,1,0
58664871@N08,3843,6,1331339612,1331345306,6,1,5694
58664871@N08,3844,6,1358555039,1358555039,1,2,0
58664871@N08,3844,25,1358557653,1358557653,1,2,0
58664871@N08,3845,27,1362783426,1362783426,1,1,0
58679257@N00,3846,25,1229417909,1229417909,1,1,0
58778465@N00,3847,3,1326961636,1326961636,1,1,0
58798813@N00,3848,27,1343269511,1343270000,2,1,489
58811693@N08,3849,23,1339293220,1339293220,1,1,0
58919362@N00,3850,6,1170998397,1170998397,1,1,0
58919362@N00,3851,22,1181371327,1181371327,1,3,0
58919362@N00,3851,24,1181356754,1181393301,8,3,36547
58919362@N00,3851,30,1181355479,1181355479,1,3,0
58919362@N00,3852,11,1184775736,1184775747,2,1,11
58919362@N00,3853,6,1185497272,1185499591,4,1,2319
58919362@N00,3854,7,1203148140,1203148140,1,2,0
58919362@N00,3854,23,1203147086,1203147086,1,2,0
58919362@N00,3855,21,1209808941,1209819659,2,2,10718
58919362@N00,3855,27,1209793783,1209794546,2,2,763
58919362@N00,3856,7,1211696017,1211698043,4,4,2026
58919362@N00,3856,21,1211698906,1211700127,2,4,1221
58919362@N00,3856,23,1211698462,1211698462,1,4,0
58919362@N00,3856,30,1211695508,1211695508,1,4,0
58985437@N00,3857,15,1058079788,1058079788,1,1,0
59276399@N07,3858,21,1382759456,1382759456,1,2,0
59276399@N07,3858,26,1382738950,1382738950,1,2,0
59276399@N07,3859,1,1383115228,1383115228,1,1,0
59287499@N00,3860,7,1124574719,1124576163,10,1,1444
59423102@N07,3861,25,1251727200,1251727200,1,1,0
59423102@N07,3862,25,1332829096,1332829096,2,1,0
59423102@N07,3863,25,1361557617,1361557625,2,1,8
59423102@N07,3864,25,1370826683,1370826683,1,1,0
59442036@N08,3865,8,1325336400,1325336400,2,1,0
59525924@N05,3866,11,1344152886,1344152886,1,1,0
59525924@N05,3867,21,1344772507,1344772573,4,1,66
59525924@N05,3868,16,1345637299,1345637340,2,2,41
59525924@N05,3868,22,1345637522,1345637522,1,2,0
59525924@N05,3869,6,1347535560,1347535560,1,1,0
59525924@N05,3870,13,1348477418,1348477428,2,1,10
59525924@N05,3871,6,1350297646,1350297646,1,1,0
59525924@N05,3872,10,1355698031,1355698384,9,1,353
59525924@N05,3873,29,1356600425,1356600425,1,1,0
59525924@N05,3874,22,1359459388,1359459388,1,2,0
59525924@N05,3874,29,1359459401,1359459401,1,2,0
59525924@N05,3875,23,1361360035,1361360035,1,1,0
59525924@N05,3876,25,1362471841,1362471841,1,2,0
59525924@N05,3876,28,1362472012,1362472012,1,2,0
59525924@N05,3877,25,1371002432,1371002489,2,1,57
59525924@N05,3878,1,1373618443,1373618443,1,1,0
59525924@N05,3879,30,1374121993,1374121993,1,1,0
59525924@N05,3880,7,1382484466,1382484466,1,1,0
59525924@N05,3881,1,1387193973,1387193973,1,3,0
59525924@N05,3881,4,1387193634,1387193634,1,3,0
59525924@N05,3881,10,1387193870,1387193870,1,3,0
59719397@N08,3882,28,1368604326,1368604326,1,1,0
59719397@N08,3883,28,1368653813,1368653813,1,1,0
59719397@N08,3884,21,1369099972,1369099972,1,1,0
59724445@N07,3885,20,1155391200,1155391204,5,1,4
59724445@N07,3886,20,1169816400,1169816411,9,1,11
59724445@N07,3887,20,1222783200,1222783207,6,1,7
59731892@N00,3888,6,1398550126,1398550126,1,1,0
59818683@N00,3889,4,1342874124,1342874124,1,1,0
59885283@N05,3890,24,1345173206,1345173206,1,1,0
59885283@N05,3891,16,1346107507,1346107507,1,1,0
59885283@N05,3892,24,1349386505,1349386505,1,1,0
59885283@N05,3893,16,1351296600,1351296600,1,1,0
59979277@N00,3894,10,1293322323,1293322323,1,1,0
59979277@N00,3895,28,1293512128,1293512128,1,1,0
59979277@N00,3896,8,1293675470,1293675470,1,1,0
60081686@N07,3897,2,1350706331,1350706331,1,1,0
60142746@N00,3898,16,1136930646,1136931155,3,3,509
60142746@N00,3898,23,1136929156,1136929374,3,3,218
60142746@N00,3898,30,1136930081,1136930143,2,3,62
60206297@N00,3899,21,1342161355,1342173150,4,1,11795
60261913@N00,3900,21,1353049677,1353049677,1,1,0
60261913@N00,3901,6,1353145345,1353145345,1,1,0
60290858@N03,3902,6,1308368490,1308368664,6,1,174
60309376@N00,3903,7,1160806211,1160806473,3,1,262
60309376@N00,3904,7,1162090486,1162090486,1,1,0
60309376@N00,3905,22,1180188656,1180191162,3,1,2506
60309376@N00,3906,24,1183229097,1183229136,2,1,39
60309376@N00,3907,24,1183906880,1183906880,1,1,0
60309376@N00,3908,24,1184520681,1184520681,1,1,0
60309376@N00,3909,22,1254571665,1254571665,1,1,0
60309376@N00,3910,22,1254614404,1254616067,4,1,1663
60309376@N00,3911,1,1268638750,1268638750,1,1,0
60309376@N00,3912,1,1303850846,1303850846,1,1,0
60309376@N00,3913,1,1310792827,1310792827,1,1,0
60309376@N00,3914,24,1311416089,1311428784,43,1,12695
60365624@N06,3915,17,1389747802,1389747802,1,1,0
60385541@N00,3916,1,1265252372,1265252372,1,1,0
60385541@N00,3917,30,1293636848,1293636848,1,1,0
60388490@N00,3918,10,1277945077,1277947696,4,1,2619
60388490@N00,3919,24,1278204302,1278205941,2,1,1639
60388490@N00,3920,22,1316502756,1316502756,1,2,0
60388490@N00,3920,28,1316502724,1316502724,1,2,0
60388490@N00,3921,11,1356139997,1356139997,1,1,0
60388490@N00,3922,10,1356567065,1356567065,1,1,0
60388490@N00,3923,10,1356926798,1356926798,1,1,0
60389800@N00,3924,25,1339649052,1339649052,1,1,0
60514173@N00,3925,22,1248994376,1248996564,133,1,2188
60514173@N00,3926,2,1315218047,1315218589,7,2,542
60514173@N00,3926,17,1315218626,1315220287,8,2,1661
60514173@N00,3927,2,1315249575,1315249575,1,1,0
60514173@N00,3928,3,1322970143,1322975420,10,1,5277
60514480@N00,3929,23,1346195833,1346195833,1,1,0
60514480@N00,3930,2,1347004764,1347010117,4,1,5353
60514480@N00,3931,30,1352843324,1352843324,1,1,0
60597745@N00,3932,4,1187254501,1187262654,110,3,8153
60597745@N00,3932,22,1187242118,1187243389,65,3,1271
60597745@N00,3932,28,1187243498,1187243639,8,3,141
60597745@N00,3933,7,1187315771,1187321392,223,2,5621
60597745@N00,3933,16,1187345176,1187348914,150,2,3738
60597745@N00,3934,9,1187481428,1187500502,20,1,19074
60597745@N00,3935,4,1187583557,1187583645,4,3,88
60597745@N00,3935,13,1187571528,1187581352,382,3,9824
60597745@N00,3935,16,1187587161,1187594551,257,3,7390
60659954@N04,3936,12,1372727668,1372742504,7,1,14836
60701587@N00,3937,23,1197337904,1197337904,1,1,0
60864794@N00,3938,21,1191135426,1191135426,1,1,0
60864794@N00,3939,13,1191237435,1191237435,1,1,0
60864794@N00,3940,9,1191393827,1191393827,1,1,0
60886372@N00,3941,1,1367839877,1367839877,1,2,0
60886372@N00,3941,7,1367841047,1367841047,1,2,0
60886372@N00,3942,7,1367873657,1367873657,1,1,0
60886372@N00,3943,7,1367922103,1367922103,1,1,0
60990146@N02,3944,6,1312985949,1312985949,1,1,0
60990146@N02,3945,28,1323876607,1323876607,1,1,0
60990146@N02,3946,23,1345450585,1345450585,1,1,0
60990146@N02,3947,22,1357022580,1357022580,1,2,0
60990146@N02,3947,28,1357039933,1357039933,1,2,0
60990146@N02,3948,23,1365243840,1365243840,1,1,0
61091178@N00,3949,21,1244675224,1244675224,1,1,0
61117412@N07,3950,25,1305530694,1305535001,2,1,4307
61239510@N00,3951,11,1235028113,1235028113,1,1,0
61239510@N00,3952,11,1245140793,1245140793,1,1,0
61239510@N00,3953,22,1254585699,1254586842,2,2,1143
61239510@N00,3953,30,1254591403,1254591481,2,2,78
61239510@N00,3954,27,1300855858,1300855858,1,1,0
61239510@N00,3955,11,1300927201,1300927201,1,1,0
61239510@N00,3956,11,1302665828,1302665828,1,1,0
61239510@N00,3957,27,1304496197,1304496197,1,1,0
61239510@N00,3958,11,1305605225,1305605225,1,1,0
61239510@N00,3959,27,1305797604,1305797604,1,1,0
61239510@N00,3960,8,1307244948,1307245110,3,3,162
61239510@N00,3960,24,1307245441,1307245529,3,3,88
61239510@N00,3960,30,1307252348,1307252348,1,3,0
61239510@N00,3961,27,1309243441,1309243441,1,1,0
61266278@N00,3962,11,1094088189,1094090925,12,1,2736
61338482@N06,3963,7,1307863711,1307863711,1,1,0
61338482@N06,3964,23,1307960368,1307960368,1,1,0
61338482@N06,3965,21,1309001103,1309001103,1,1,0
61338482@N06,3966,15,1309085612,1309085612,1,1,0
61377999@N03,3967,6,1188723527,1188723527,1,3,0
61377999@N03,3967,21,1188732136,1188732136,1,3,0
61377999@N03,3967,22,1188734027,1188734027,1,3,0
61377999@N03,3968,4,1188799117,1188799117,1,3,0
61377999@N03,3968,16,1188789414,1188796196,4,3,6782
61377999@N03,3968,22,1188783615,1188783807,2,3,192
61377999@N03,3969,7,1188864088,1188864088,1,3,0
61377999@N03,3969,11,1188869229,1188869229,1,3,0
61377999@N03,3969,25,1188878625,1188878625,1,3,0
61377999@N03,3970,30,1188950566,1188950566,1,1,0
61392797@N00,3971,30,1347068986,1347069108,2,1,122
61392797@N00,3972,30,1347266833,1347266877,4,1,44
61392797@N00,3973,6,1352500713,1352500713,1,1,0
61545942@N08,3974,22,1353144080,1353144607,6,1,527
61609579@N00,3975,21,1350716237,1350716237,1,4,0
61609579@N00,3975,22,1350712901,1350713418,5,4,517
61609579@N00,3975,23,1350714443,1350715689,10,4,1246
61609579@N00,3975,28,1350713817,1350714304,4,4,487
61622156@N00,3976,29,1392808565,1392808565,1,1,0
61767360@N00,3977,30,799617355,799617355,1,1,0
61798879@N00,3978,19,1282124306,1282124306,1,1,0
61825972@N08,3979,22,1332314555,1332314555,1,2,0
61825972@N08,3979,30,1332305304,1332305304,1,2,0
61825972@N08,3980,30,1332364369,1332364369,1,1,0
61825972@N08,3981,23,1332474964,1332474964,1,2,0
61825972@N08,3981,30,1332452980,1332462490,2,2,9510
61861930@N00,3982,22,1171048617,1171048654,2,1,37
61861930@N00,3983,7,1171127417,1171127638,3,1,221
61861930@N00,3984,7,1172579903,1172579903,1,2,0
61861930@N00,3984,30,1172579683,1172579727,2,2,44
61861930@N00,3985,14,1188557941,1188558962,6,1,1021
61861930@N00,3986,14,1190383030,1190383060,2,1,30
61861930@N00,3987,7,1212826046,1212826046,1,1,0
62072751@N06,3988,13,1361148194,1361152306,12,1,4112
62077150@N06,3989,22,-378727200,-378727200,1,1,0
62077150@N06,3990,22,-291981600,-291981600,1,1,0
62077150@N06,3991,16,94654800,94654800,1,2,0
62077150@N06,3991,22,94654800,94654800,1,2,0
62077150@N06,3992,2,649432800,649432800,1,1,0
62077150@N06,3993,16,1195877078,1195877461,2,1,383
62077150@N06,3994,28,1327538721,1327538735,2,1,14
62077150@N06,3995,6,1327623600,1327626891,3,1,3291
62077150@N06,3996,22,1379897898,1379897898,1,2,0
62077150@N06,3996,28,1379894850,1379894850,1,2,0
62077150@N06,3997,11,1379989631,1379989631,1,2,0
62077150@N06,3997,27,1379990195,1379990195,1,2,0
62153623@N05,3998,30,1369639252,1369639299,4,1,47
62153623@N05,3999,11,1370313776,1370313776,1,2,0
62153623@N05,3999,13,1370309815,1370311287,22,2,1472
62153623@N05,4000,11,1373792263,1373794104,6,2,1841
62153623@N05,4000,27,1373793488,1373793488,1,2,0
62215001@N00,4001,12,1394940197,1394948565,33,1,8368
62373848@N00,4002,6,1258942887,1258942887,1,1,0
62373848@N00,4003,4,1337358712,1337358712,1,1,0
62373848@N00,4004,4,1337394017,1337405744,5,3,11727
62373848@N00,4004,16,1337394713,1337405964,2,3,11251
62373848@N00,4004,28,1337390057,1337390057,1,3,0
62486370@N00,4005,2,1218857138,1218857490,3,3,352
62486370@N00,4005,14,1218864475,1218864475,1,3,0
62486370@N00,4005,17,1218858934,1218864716,6,3,5782
62486370@N00,4006,11,1242530536,1242546222,12,1,15686
62486370@N00,4007,22,1247717564,1247717564,1,1,0
62486370@N00,4008,22,1247875765,1247882424,2,1,6659
62586117@N05,4009,21,1368267669,1368268429,2,1,760
62959750@N00,4010,25,1161497104,1161497392,5,1,288
63125501@N00,4011,11,1180838937,1180845250,29,1,6313
63125501@N00,4012,27,1188962536,1188962634,2,1,98
63125501@N00,4013,27,1189167486,1189167598,2,1,112
63125501@N00,4014,27,1300844727,1300844727,1,1,0
63125501@N00,4015,7,1303103974,1303103996,3,2,22
63125501@N00,4015,21,1303090522,1303090522,1,2,0
63125501@N00,4016,2,1304500332,1304500332,1,1,0
63125501@N00,4017,27,1307346314,1307346314,1,1,0
63125501@N00,4018,11,1308731268,1308731268,1,1,0
63125501@N00,4019,27,1313379900,1313379900,1,1,0
63125501@N00,4020,22,1315452842,1315452882,2,1,40
63125501@N00,4021,22,1315971041,1315971065,2,1,24
63125501@N00,4022,22,1325219874,1325220048,2,1,174
63125501@N00,4023,11,1334894116,1334894116,1,2,0
63125501@N00,4023,27,1334894229,1334894464,6,2,235
63125501@N00,4024,27,1336102786,1336103996,2,1,1210
63125501@N00,4025,25,1336277828,1336278359,18,1,531
63125501@N00,4026,2,1336558005,1336560071,4,1,2066
63125501@N00,4027,11,1336709818,1336709943,5,1,125
63125501@N00,4028,21,1337327086,1337327232,3,2,146
63125501@N00,4028,27,1337313501,1337315292,5,2,1791
63125501@N00,4029,27,1343105237,1343105269,4,1,32
63125501@N00,4030,27,1343200097,1343200097,1,1,0
63125501@N00,4031,27,1343362336,1343362336,1,1,0
63125501@N00,4032,27,1343611245,1343611245,1,1,0
63125501@N00,4033,27,1343776942,1343801985,3,1,25043
63125501@N00,4034,27,1343963607,1343963630,3,1,23
63125501@N00,4035,27,1344403018,1344403018,1,1,0
63221093@N00,4036,21,1173439849,1173439849,1,1,0
63221093@N00,4037,7,1173751500,1173751500,1,1,0
63221093@N00,4038,23,1177665600,1177665600,1,1,0
63221093@N00,4039,21,1184134039,1184134039,1,1,0
63221093@N00,4040,21,1190889222,1190889222,1,1,0
63221093@N00,4041,29,1191062052,1191062052,1,1,0
63221093@N00,4042,23,1193820038,1193820038,1,1,0
63221093@N00,4043,22,1201342117,1201342117,1,1,0
63221093@N00,4044,24,1215233800,1215261649,2,1,27849
63314508@N00,4045,22,1217669871,1217669871,1,1,0
63314508@N00,4046,24,1217742563,1217742563,1,1,0
63327475@N02,4047,13,1306042977,1306043044,2,2,67
63327475@N02,4047,30,1306021616,1306021932,2,2,316
63327475@N02,4048,30,1306147403,1306147403,1,1,0
63390929@N07,4049,22,1337992570,1337995829,2,2,3259
63390929@N07,4049,28,1337991068,1337992559,7,2,1491
63390929@N07,4050,1,1360835275,1360837622,95,1,2347
63458311@N00,4051,1,1136034000,1136034000,1,2,0
63458311@N00,4051,16,1136034000,1136034000,1,2,0
63483222@N03,4052,16,1340614524,1340614876,2,1,352
63522147@N00,4053,6,1150328041,1150328041,1,1,0
63612557@N00,4054,8,1117004596,1117004596,1,2,0
63612557@N00,4054,30,1117004581,1117004586,2,2,5
63612557@N00,4055,25,1210400444,1210400444,1,1,0
63612557@N00,4056,7,1213681886,1213683427,12,2,1541
63612557@N00,4056,30,1213683589,1213683771,3,2,182
63612557@N00,4057,6,1234588706,1234596870,39,1,8164
63669108@N02,4058,11,1326427320,1326444909,3,1,17589
63677124@N07,4059,23,1330043813,1330043813,1,1,0
63677124@N07,4060,25,1330398485,1330398485,1,1,0
63677124@N07,4061,23,1330824305,1330824305,1,1,0
63677124@N07,4062,29,1331106414,1331106414,1,1,0
63677124@N07,4063,22,1331196263,1331196263,1,1,0
63677124@N07,4064,11,1331258784,1331258784,1,1,0
63677124@N07,4065,7,1331434362,1331460315,2,2,25953
63677124@N07,4065,22,1331437118,1331451318,3,2,14200
63677124@N07,4066,11,1331705548,1331705548,1,1,0
63677124@N07,4067,7,1333784114,1333792902,2,1,8788
63677124@N07,4068,30,1345450705,1345450705,1,1,0
63677124@N07,4069,30,1345793182,1345793182,1,1,0
63677124@N07,4070,30,1346142026,1346142026,1,1,0
63677124@N07,4071,30,1346202844,1346202844,1,1,0
63677124@N07,4072,30,1346549794,1346549794,1,1,0
63677124@N07,4073,23,1346585235,1346585235,1,1,0
63677124@N07,4074,23,1347071436,1347071436,1,1,0
63677124@N07,4075,12,1347163134,1347167316,3,1,4182
63677124@N07,4076,30,1347588878,1347588878,1,1,0
63677124@N07,4077,30,1347681874,1347681874,1,1,0
63677124@N07,4078,30,1348295155,1348295155,1,1,0
63677124@N07,4079,23,1348653925,1348653925,1,1,0
63677124@N07,4080,21,1348732558,1348732558,1,1,0
63677124@N07,4081,8,1348802082,1348802082,1,1,0
63677124@N07,4082,16,1349229452,1349229452,1,1,0
63677124@N07,4083,30,1349747022,1349763344,2,1,16322
63677124@N07,4084,30,1350886659,1350886659,1,1,0
63677124@N07,4085,23,1350981792,1350997876,2,1,16084
63677124@N07,4086,22,1351060411,1351060411,1,1,0
63677124@N07,4087,30,1351228787,1351228787,1,1,0
63677124@N07,4088,30,1351500078,1351500078,1,1,0
63677124@N07,4089,25,1352274940,1352274940,1,1,0
63677124@N07,4090,27,1352353284,1352353284,1,1,0
63677124@N07,4091,19,1352610809,1352610809,1,1,0
63677124@N07,4092,23,1353216982,1353216982,1,1,0
63677124@N07,4093,24,1356328462,1356328462,1,1,0
63677124@N07,4094,1,1359269259,1359269259,1,1,0
63677124@N07,4095,15,1359328245,1359328245,1,1,0
63677124@N07,4096,29,1359551266,1359551266,1,1,0
63677124@N07,4097,1,1361007181,1361007181,1,1,0
63677124@N07,4098,16,1361174170,1361174170,1,1,0
63677124@N07,4099,21,1361349203,1361349203,1,1,0
63677124@N07,4100,27,1364106874,1364106874,1,1,0
63677124@N07,4101,1,1364691452,1364691452,1,1,0
63677124@N07,4102,19,1366614500,1366614500,1,1,0
63677124@N07,4103,19,1366678904,1366678904,1,1,0
63677124@N07,4104,19,1367133539,1367133539,1,1,0
63677124@N07,4105,4,1372933866,1372933866,1,1,0
63677124@N07,4106,7,1373796664,1373796664,1,1,0
63677124@N07,4107,4,1377508240,1377508240,1,1,0
63677124@N07,4108,14,1377725613,1377725613,1,1,0
63677124@N07,4109,14,1377768152,1377768152,1,1,0
63677124@N07,4110,14,1377812705,1377812705,1,1,0
63677124@N07,4111,14,1377850604,1377850604,1,1,0
63677124@N07,4112,1,1380964270,1380967817,2,1,3547
63677124@N07,4113,22,1381031582,1381031582,1,1,0
63677124@N07,4114,26,1381393921,1381393921,1,1,0
63677124@N07,4115,8,1389683823,1389697920,3,1,14097
63706803@N00,4116,30,1303346884,1303348382,2,1,1498
63706803@N00,4117,7,1331201219,1331201219,1,1,0
63706803@N00,4118,28,1333781112,1333781112,1,1,0
63706803@N00,4119,30,1341623803,1341623803,1,1,0
63706803@N00,4120,7,1354781061,1354781061,1,1,0
63706803@N00,4121,21,1356051150,1356053024,7,1,1874
63706803@N00,4122,1,1356594673,1356594673,1,2,0
63706803@N00,4122,30,1356590440,1356590440,1,2,0
63706803@N00,4123,25,1357977010,1357987323,2,1,10313
63706803@N00,4124,21,1359008661,1359008661,1,1,0
63706803@N00,4125,6,1360229978,1360234232,2,1,4254
63706803@N00,4126,25,1361875295,1361875295,1,1,0
63706803@N00,4127,30,1366337771,1366337771,1,1,0
63706803@N00,4128,6,1367489776,1367494340,4,1,4564
63706803@N00,4129,26,1375757775,1375757775,1,1,0
63706803@N00,4130,22,1376038427,1376039160,2,2,733
63706803@N00,4130,28,1376029335,1376029335,1,2,0
63706803@N00,4131,22,1377914735,1377914735,1,1,0
63706803@N00,4132,22,1380964711,1380964711,1,3,0
63706803@N00,4132,23,1380964267,1380964267,1,3,0
63706803@N00,4132,29,1380966752,1380966752,1,3,0
63706803@N00,4133,1,1383019038,1383019038,1,1,0
63706803@N00,4134,30,1387078449,1387078449,1,1,0
63706803@N00,4135,7,1396083291,1396084949,2,1,1658
63706803@N00,4136,28,1397440843,1397442362,2,1,1519
63730733@N02,4137,16,1308482426,1308484618,2,1,2192
63730733@N02,4138,11,1313583770,1313584813,3,1,1043
63754555@N00,4139,16,1177199727,1177200313,6,2,586
63754555@N00,4139,24,1177203331,1177203356,2,2,25
63754555@N00,4140,11,1314666782,1314669098,2,1,2316
63754555@N00,4141,12,1314762290,1314762290,1,1,0
63754555@N00,4142,6,1344726862,1344731949,3,2,5087
63754555@N00,4142,21,1344732496,1344732496,1,2,0
63829688@N00,4143,29,1184395947,1184395947,1,1,0
63843310@N07,4144,24,1324857374,1324864308,2,1,6934
64005175@N00,4145,12,1015121385,1015121385,1,1,0
64005175@N00,4146,12,1115428111,1115432541,16,1,4430
64005175@N00,4147,12,1119497673,1119497783,3,1,110
64005175@N00,4148,9,1157250459,1157256422,7,1,5963
64005175@N00,4149,12,1157681925,1157681925,1,1,0
64005175@N00,4150,11,1165628148,1165632129,5,1,3981
64005175@N00,4151,9,1166150728,1166165010,7,1,14282
64005175@N00,4152,4,1176114769,1176121303,2,1,6534
64005175@N00,4153,2,1188462663,1188462683,2,2,20
64005175@N00,4153,17,1188469725,1188469725,1,2,0
64005175@N00,4154,21,1188639947,1188640711,2,1,764
64005175@N00,4155,12,1216444353,1216444353,1,1,0
64005175@N00,4156,15,1221881929,1221893852,7,1,11923
64005175@N00,4157,11,1224989701,1224989701,1,1,0
64005175@N00,4158,4,1246078963,1246082961,2,1,3998
64005175@N00,4159,23,1266911467,1266911467,1,1,0
64085688@N00,4160,30,1317439572,1317442867,6,1,3295
64085688@N00,4161,7,1317982345,1317982345,1,1,0
64085688@N00,4162,1,1321706110,1321706110,1,2,0
64085688@N00,4162,30,1321706103,1321706111,2,2,8
64184609@N00,4163,3,1353180611,1353180611,1,1,0
64189496@N00,4164,9,1160888863,1160888863,1,1,0
64189496@N00,4165,9,1182325074,1182325074,1,1,0
64189496@N00,4166,21,1188562018,1188562018,1,1,0
64368649@N00,4167,4,1344741999,1344741999,1,1,0
64368649@N00,4168,4,1344778730,1344778730,1,1,0
64395337@N00,4169,19,1315730421,1315730421,1,1,0
64395337@N00,4170,25,1316843698,1316843698,1,1,0
64483760@N03,4171,30,1373075943,1373075943,1,1,0
64509021@N06,4172,10,1320990485,1320991918,15,1,1433
64590692@N03,4173,25,1379834549,1379834549,1,1,0
64590692@N03,4174,16,1380981586,1380981586,1,2,0
64590692@N03,4174,22,1380980571,1380982245,2,2,1674
64721494@N00,4175,11,1216440100,1216451197,15,1,11097
64721494@N00,4176,11,1320806791,1320818349,22,1,11558
64785988@N04,4177,30,1356761464,1356761464,1,1,0
64785988@N04,4178,30,1356844634,1356844634,1,1,0
64785988@N04,4179,30,1356916360,1356916360,1,1,0
64834051@N00,4180,4,1159054144,1159061409,10,1,7265
64834051@N00,4181,4,1191102473,1191110571,16,2,8098
64834051@N00,4181,16,1191114326,1191114326,1,2,0
64834051@N00,4182,4,1213400162,1213408952,19,3,8790
64834051@N00,4182,8,1213410498,1213410575,7,3,77
64834051@N00,4182,16,1213410166,1213410174,2,3,8
64834051@N00,4183,4,1220527760,1220527760,1,1,0
64834051@N00,4184,23,1254451478,1254451478,1,1,0
64834051@N00,4185,7,1353207957,1353211624,4,1,3667
64933083@N00,4186,23,1340841716,1340841716,1,1,0
65077953@N08,4187,30,1370505686,1370518817,91,1,13131
65173084@N00,4188,3,1236924178,1236925230,19,1,1052
65320201@N03,4189,23,1300946904,1300946904,1,1,0
65320201@N03,4190,23,1301023308,1301023418,2,1,110
65320201@N03,4191,16,1301133240,1301136734,5,2,3494
65320201@N03,4191,30,1301132500,1301132500,1,2,0
65320201@N03,4192,30,1310813304,1310813304,1,1,0
65320201@N03,4193,30,1310847314,1310847314,1,1,0
65320201@N03,4194,7,1310987104,1310987104,1,2,0
65320201@N03,4194,30,1310988598,1310988598,1,2,0
65327964@N00,4195,16,1300993780,1301004028,6,2,10248
65327964@N00,4195,30,1301014599,1301014599,1,2,0
65327964@N00,4196,25,1301141790,1301141790,1,1,0
65423349@N00,4197,22,1203680807,1203680807,1,1,0
65438265@N00,4198,7,1071969880,1071969880,1,4,0
65438265@N00,4198,16,1071982218,1071983700,4,4,1482
65438265@N00,4198,22,1071976157,1071976157,1,4,0
65438265@N00,4198,30,1071979807,1071979807,1,4,0
65452532@N00,4199,22,1138354507,1138354507,1,1,0
65481599@N00,4200,22,1286016870,1286016908,5,1,38
65481599@N00,4201,24,1289983408,1289983408,1,1,0
65481599@N00,4202,21,1304724188,1304724188,1,2,0
65481599@N00,4202,25,1304735056,1304741329,11,2,6273
65481599@N00,4203,21,1305600093,1305600093,1,1,0
65481599@N00,4204,1,1307187746,1307187746,1,1,0
65481599@N00,4205,11,1312351960,1312351960,1,1,0
65481599@N00,4206,17,1314337847,1314337847,1,1,0
65481599@N00,4207,6,1329468036,1329468036,1,1,0
65481599@N00,4208,30,1333017430,1333017430,1,1,0
65481599@N00,4209,9,1335008678,1335008678,1,1,0
65481599@N00,4210,6,1335325756,1335325756,1,1,0
65481599@N00,4211,21,1340621288,1340621288,1,1,0
65481599@N00,4212,30,1346486564,1346486564,1,1,0
65481599@N00,4213,11,1348287401,1348287401,1,1,0
65481599@N00,4214,25,1360466500,1360468030,2,1,1530
65481599@N00,4215,1,1364023236,1364033041,2,1,9805
65481599@N00,4216,22,1364534039,1364534039,1,1,0
65481599@N00,4217,25,1365901984,1365916364,12,1,14380
65481599@N00,4218,25,1366526651,1366526651,1,1,0
65481599@N00,4219,9,1368942561,1368942561,1,1,0
65481599@N00,4220,7,1371824512,1371824512,1,1,0
65481599@N00,4221,7,1371950572,1371950852,2,2,280
65481599@N00,4221,25,1371953599,1371956635,3,2,3036
65481599@N00,4222,4,1375179685,1375187572,3,1,7887
65481599@N00,4223,25,1376722259,1376724260,3,1,2001
65481599@N00,4224,11,1380151005,1380158355,2,1,7350
65588072@N00,4225,7,1146187897,1146187897,1,1,0
65602984@N00,4226,23,1377520209,1377520209,1,1,0
65602984@N00,4227,11,1377597600,1377606975,4,1,9375
65602984@N00,4228,23,1377690425,1377690425,1,1,0
65602984@N00,4229,13,1377766452,1377773547,2,2,7095
65602984@N00,4229,16,1377781229,1377786370,2,2,5141
65602984@N00,4230,21,1378379990,1378381773,2,2,1783
65602984@N00,4230,23,1378387429,1378387429,1,2,0
65846543@N00,4231,9,1203905490,1203915294,68,1,9804
66018000@N07,4232,28,1344926831,1344926831,1,1,0
66071784@N08,4233,12,1307083283,1307083561,6,1,278
66071784@N08,4234,12,1308733474,1308741038,9,1,7564
66071784@N08,4235,12,1310053563,1310053563,1,1,0
66127949@N00,4236,28,1183959051,1183959051,1,1,0
66252312@N00,4237,2,1257734836,1257734836,1,1,0
66252312@N00,4238,29,1350867600,1350867600,1,1,0
66252312@N00,4239,28,1355113980,1355113980,1,1,0
66373750@N02,4240,21,1336284549,1336284549,1,1,0
66373750@N02,4241,6,1336791799,1336805763,3,1,13964
66373750@N02,4242,19,1342777321,1342777321,1,1,0
66373750@N02,4243,6,1348942529,1348942529,1,1,0
66373750@N02,4244,26,1349428766,1349428766,1,1,0
66373750@N02,4245,22,1358160124,1358160124,1,1,0
66373750@N02,4246,3,1365660670,1365660670,1,1,0
66373750@N02,4247,6,1367403615,1367403615,1,1,0
66526700@N00,4248,24,1371960697,1371971931,10,1,11234
66526700@N00,4249,14,1373581476,1373584884,9,1,3408
66526700@N00,4250,14,1373740899,1373740899,1,1,0
66526700@N00,4251,21,1377422983,1377424346,6,1,1363
66691654@N00,4252,16,1141006641,1141024762,7,1,18121
66728893@N00,4253,25,1169825389,1169825389,1,1,0
66759009@N00,4254,7,1297500559,1297500559,1,1,0
66762373@N04,4255,29,1009803600,1009803600,1,1,0
66762373@N04,4256,30,1073971563,1073971563,1,1,0
66762373@N04,4257,13,1081478494,1081478693,2,1,199
66762373@N04,4258,8,1113544739,1113545114,2,1,375
66762373@N04,4259,24,1310027309,1310027309,1,1,0
66762373@N04,4260,10,1334116011,1334119648,9,1,3637
66762373@N04,4261,12,1337566571,1337569151,11,1,2580
66762373@N04,4262,10,1362878832,1362883332,8,1,4500
66762373@N04,4263,13,1367638028,1367653947,9,1,15919
66762373@N04,4264,8,1368931494,1368931494,1,2,0
66762373@N04,4264,16,1368932851,1368933143,2,2,292
66762373@N04,4265,8,1397534895,1397547789,22,1,12894
66907518@N00,4266,1,1160378050,1160382554,4,1,4504
66911784@N06,4267,27,1314584283,1314585193,3,1,910
66911784@N06,4268,30,1321761491,1321761540,2,1,49
66911784@N06,4269,7,1340780993,1340781076,4,1,83
66919565@N00,4270,25,1133355600,1133355600,1,1,0
66922282@N00,4271,22,1092646926,1092646926,1,3,0
66922282@N00,4271,23,1092646926,1092646926,1,3,0
66922282@N00,4271,28,1092646926,1092646926,4,3,0
66996917@N00,4272,28,1345884889,1345884889,1,1,0
66996917@N00,4273,28,1351319094,1351319094,1,1,0
67008765@N00,4274,4,1209976621,1209976813,8,1,192
67122123@N00,4275,21,1239955532,1239955532,1,1,0
67194633@N00,4276,16,1273808028,1273809688,4,3,1660
67194633@N00,4276,22,1273796995,1273797562,4,3,567
67194633@N00,4276,29,1273805898,1273805898,1,3,0
67335469@N00,4277,6,1358068430,1358068430,1,1,0
67413744@N07,4278,21,1233376923,1233376923,1,1,0
67458569@N00,4279,13,1211609773,1211609773,1,1,0
67458569@N00,4280,22,1211696350,1211699933,18,1,3583
67476606@N00,4281,10,1287793928,1287793928,1,1,0
67476606@N00,4282,6,1289371416,1289371416,1,1,0
67506752@N05,4283,21,1358593587,1358593587,1,1,0
67694608@N00,4284,4,1213224792,1213229798,3,4,5006
67694608@N00,4284,16,1213223870,1213228566,12,4,4696
67694608@N00,4284,22,1213231719,1213232096,3,4,377
67694608@N00,4284,28,1213232447,1213232583,2,4,136
67694608@N00,4285,11,1213319070,1213319358,4,2,288
67694608@N00,4285,13,1213312183,1213317318,16,2,5135
67694608@N00,4286,19,1213412090,1213412090,1,1,0
67732458@N08,4287,30,1381904735,1381904735,1,1,0
67777553@N02,4288,30,1303535227,1303553165,2,1,17938
67777553@N02,4289,21,1355452558,1355452571,2,1,13
67777553@N02,4290,30,1367540465,1367541845,11,1,1380
67777553@N02,4291,3,1372567337,1372576960,11,1,9623
67794534@N00,4292,28,1154319219,1154319219,1,1,0
67801451@N00,4293,25,1288414660,1288414660,1,1,0
67801451@N00,4294,13,1304143846,1304143846,1,1,0
67801451@N00,4295,24,1319345357,1319345357,1,1,0
67805043@N06,4296,22,1285981176,1285981469,2,1,293
67805043@N06,4297,16,1286413838,1286415412,4,2,1574
67805043@N06,4297,24,1286415571,1286415571,1,2,0
67805043@N06,4298,16,1286503360,1286503360,1,1,0
67805043@N06,4299,6,1287264076,1287264076,1,2,0
67805043@N06,4299,29,1287271985,1287271985,1,2,0
67805043@N06,4300,21,1287462610,1287462610,1,1,0
67805043@N06,4301,7,1293258872,1293259259,3,1,387
67917860@N00,4302,23,1392012913,1392019081,3,2,6168
67917860@N00,4302,28,1392012978,1392018985,3,2,6007
67952341@N00,4303,8,1148778959,1148778959,1,1,0
67952341@N00,4304,30,1153016187,1153016287,2,1,100
67952341@N00,4305,8,1156595961,1156595982,3,1,21
67952341@N00,4306,4,1165037363,1165037363,1,1,0
67952341@N00,4307,8,1165630986,1165631771,2,1,785
67952341@N00,4308,4,1171681605,1171685570,5,3,3965
67952341@N00,4308,8,1171680369,1171680573,2,3,204
67952341@N00,4308,16,1171678946,1171678946,1,3,0
67952341@N00,4309,21,1186209505,1186209505,1,1,0
67952341@N00,4310,7,1187926016,1187926016,1,1,0
67961268@N00,4311,16,1313339176,1313341734,4,1,2558
68009656@N00,4312,7,1268041331,1268041331,1,2,0
68009656@N00,4312,21,1268039026,1268040155,4,2,1129
68009656@N00,4313,28,1268095738,1268095738,1,1,0
68009656@N00,4314,21,1300098782,1300099392,4,1,610
68151423@N00,4315,11,1231480106,1231480106,1,1,0
68151423@N00,4316,11,1231555022,1231557647,7,1,2625
68183366@N05,4317,16,1325975145,1325975145,1,1,0
68379435@N00,4318,8,1389151739,1389157714,38,1,5975
68688301@N00,4319,11,1210871818,1210871857,5,1,39
68688301@N00,4320,29,1210921000,1210921000,1,1,0
68688301@N00,4321,19,1210955212,1210955212,1,1,0
68704767@N00,4322,27,1348836686,1348836686,1,1,0
68777082@N00,4323,23,1357913520,1357913827,2,1,307
68803445@N00,4324,8,1386429794,1386429794,1,1,0
68803445@N00,4325,7,1386464233,1386464233,1,1,0
68803445@N00,4326,4,1386904035,1386904035,1,3,0
68803445@N00,4326,8,1386905325,1386905575,4,3,250
68803445@N00,4326,16,1386904958,1386908727,14,3,3769
68805959@N00,4327,26,1378251796,1378251796,1,1,0
68815984@N00,4328,7,1134105252,1134105252,1,1,0
68815984@N00,4329,7,1141364083,1141364083,1,1,0
68815984@N00,4330,3,1151107447,1151107771,2,1,324
68815984@N00,4331,7,1195136508,1195136508,1,1,0
68894626@N00,4332,21,1185869304,1185869304,1,1,0
68894626@N00,4333,1,1202125733,1202128157,2,1,2424
68894626@N00,4334,13,1229661466,1229668382,15,1,6916
68979377@N00,4335,25,1250991452,1250996569,2,1,5117
69180218@N06,4336,2,1366600580,1366600580,1,1,0
69216242@N00,4337,16,1204758431,1204761013,2,1,2582
69349066@N00,4338,4,1188621639,1188621871,4,1,232
69349066@N00,4339,16,1191069160,1191072664,4,1,3504
69349066@N00,4340,17,1219373479,1219378423,3,1,4944
69349066@N00,4341,22,1322818643,1322818657,2,1,14
69367147@N00,4342,21,1212046814,1212046850,2,1,36
69367147@N00,4343,23,1212562158,1212563702,2,1,1544
69488141@N00,4344,21,1252670829,1252670829,1,1,0
69525052@N06,4345,21,1344753164,1344755053,3,3,1889
69525052@N06,4345,22,1344751324,1344751324,1,3,0
69525052@N06,4345,30,1344773579,1344773579,1,3,0
69558246@N00,4346,21,1149398104,1149398104,1,1,0
69635173@N00,4347,10,1219880933,1219881006,17,1,73
69654165@N00,4348,2,1330693589,1330693589,1,1,0
69708810@N00,4349,25,1276913555,1276920967,16,1,7412
69739859@N06,4350,22,1045987104,1045987104,1,1,0
69754957@N00,4351,1,1271312199,1271312615,6,9,416
69754957@N00,4351,2,1271318133,1271318438,3,9,305
69754957@N00,4351,3,1271295834,1271295961,6,9,127
69754957@N00,4351,4,1271308177,1271311562,62,9,3385
69754957@N00,4351,7,1271297246,1271303310,111,9,6064
69754957@N00,4351,11,1271288393,1271288554,5,9,161
69754957@N00,4351,16,1271307677,1271311722,2,9,4045
69754957@N00,4351,23,1271291875,1271291885,2,9,10
69754957@N00,4351,30,1271297051,1271312813,5,9,15762
69754957@N00,4352,1,1271383805,1271383805,1,2,0
69754957@N00,4352,30,1271381487,1271384193,12,2,2706
69754957@N00,4353,21,1370174390,1370174448,2,1,58
69754957@N00,4354,3,1370230897,1370231166,6,4,269
69754957@N00,4354,21,1370229479,1370229563,4,4,84
69754957@N00,4354,29,1370220250,1370220250,1,4,0
69754957@N00,4354,30,1370232825,1370232825,1,4,0
69756126@N00,4355,21,1154986180,1154986180,1,1,0
69756126@N00,4356,7,1212570349,1212570349,1,1,0
69756126@N00,4357,7,1212648262,1212672484,12,2,24222
69756126@N00,4357,23,1212676264,1212676264,1,2,0
69756126@N00,4358,7,1212707037,1212707037,1,1,0
69843317@N00,4359,6,1230984720,1230991663,8,1,6943
69843317@N00,4360,6,1359157526,1359169154,2,2,11628
69843317@N00,4360,28,1359175504,1359175504,1,2,0
69874063@N00,4361,21,1170334800,1170334821,22,1,21
69874063@N00,4362,21,1170410142,1170410159,2,1,17
69874063@N00,4363,19,1252805257,1252805398,15,1,141
69874063@N00,4364,29,1299566149,1299566149,1,1,0
69874063@N00,4365,26,1344608712,1344608712,1,1,0
69938533@N00,4366,21,1374741711,1374741711,1,1,0
69938533@N00,4367,28,1378354357,1378354357,1,1,0
69938533@N00,4368,1,1385731496,1385731496,1,1,0
69938533@N00,4369,25,1387792393,1387792393,1,1,0
70017256@N00,4370,11,1202196397,1202196397,1,1,0
70194213@N00,4371,25,1275900551,1275900551,1,1,0
70213268@N00,4372,25,1157580043,1157580043,1,1,0
70289230@N00,4373,1,1170385920,1170385920,1,2,0
70289230@N00,4373,21,1170403187,1170403229,14,2,42
70289230@N00,4374,23,1191078423,1191078877,11,3,454
70289230@N00,4374,27,1191070610,1191074254,12,3,3644
70289230@N00,4374,29,1191076028,1191076045,2,3,17
70289230@N00,4375,11,1218951235,1218963911,12,1,12676
70289230@N00,4376,24,1221914329,1221914329,1,1,0
70289230@N00,4377,7,1247109098,1247109098,1,1,0
70302503@N00,4378,1,1302434285,1302434285,1,1,0
70302503@N00,4379,6,1347256860,1347256860,1,1,0
70302503@N00,4380,27,1348024734,1348024734,1,1,0
70302503@N00,4381,6,1348287347,1348287347,1,1,0
70302503@N00,4382,1,1364631666,1364631666,1,1,0
70302503@N00,4383,25,1365216609,1365216609,1,1,0
70302503@N00,4384,27,1365643219,1365643219,1,1,0
70302503@N00,4385,4,1367484347,1367484347,1,1,0
70302503@N00,4386,1,1368438507,1368438507,1,1,0
70302503@N00,4387,27,1369349527,1369349527,1,1,0
70302503@N00,4388,25,1371396029,1371396029,1,1,0
70302503@N00,4389,25,1379318090,1379318090,1,1,0
70307237@N00,4390,7,1373590652,1373599471,67,1,8819
70319561@N00,4391,16,1182327722,1182328331,2,1,609
70421659@N00,4392,21,1256178377,1256178377,1,1,0
70421659@N00,4393,25,1260193437,1260193437,1,1,0
70421659@N00,4394,25,1262953107,1262953107,1,1,0
70421659@N00,4395,6,1302326085,1302326085,1,1,0
70421659@N00,4396,24,1303124736,1303124736,1,1,0
70421659@N00,4397,25,1322686008,1322686008,1,1,0
70421659@N00,4398,6,1333951180,1333951180,1,1,0
70421659@N00,4399,20,1342078571,1342078571,1,1,0
70421659@N00,4400,7,1345361506,1345361506,1,1,0
70421659@N00,4401,25,1355194175,1355194175,1,1,0
70421659@N00,4402,3,1355468213,1355468213,1,1,0
70421659@N00,4403,25,1365311510,1365311510,1,1,0
70421659@N00,4404,6,1371604365,1371604365,1,1,0
70421659@N00,4405,22,1373873123,1373873123,1,1,0
70474359@N00,4406,4,1339829727,1339829727,1,1,0
70474359@N00,4407,4,1348902681,1348902681,1,1,0
70554294@N00,4408,16,1085461904,1085466205,8,5,4301
70554294@N00,4408,22,1085473652,1085473743,2,5,91
70554294@N00,4408,28,1085473504,1085473566,2,5,62
70554294@N00,4408,29,1085474216,1085474590,5,5,374
70554294@N00,4408,30,1085473268,1085473380,2,5,112
70597029@N00,4409,24,1210991518,1210992160,5,1,642
71101372@N00,4410,23,1385854736,1385854736,1,1,0
7119320@N05,4411,22,315493209,315493340,14,1,131
7119320@N05,4412,30,1243148758,1243148770,2,1,12
7119320@N05,4413,19,1343129967,1343130056,3,1,89
7119320@N05,4414,30,1368600632,1368600632,1,1,0
7119320@N05,4415,30,1371797193,1371797381,4,1,188
7119320@N05,4416,25,1386997281,1386999019,5,1,1738
71206023@N00,4417,24,1104214219,1104214219,1,1,0
71206023@N00,4418,21,1125795459,1125795592,2,1,133
71206023@N00,4419,6,1167184790,1167184790,1,1,0
71206023@N00,4420,8,1167276394,1167276707,3,3,313
71206023@N00,4420,16,1167276251,1167276251,1,3,0
71206023@N00,4420,24,1167273240,1167273288,2,3,48
71324153@N00,4421,11,1133152666,1133152666,1,1,0
71390469@N05,4422,6,1395215892,1395215892,1,1,0
71401076@N00,4423,26,1140938805,1140945695,8,1,6890
71401076@N00,4424,7,1151121684,1151121963,3,2,279
71401076@N00,4424,30,1151121996,1151121996,1,2,0
71401076@N00,4425,25,1154750988,1154750988,1,1,0
71401076@N00,4426,24,1155375231,1155375433,5,1,202
71401076@N00,4427,27,1172886120,1172886498,7,1,378
71401076@N00,4428,7,1223337104,1223337104,1,1,0
71401076@N00,4429,1,1224148083,1224148083,1,1,0
71401076@N00,4430,25,1231469923,1231469923,1,1,0
71401076@N00,4431,25,1293584598,1293584598,1,1,0
71401076@N00,4432,23,1301113295,1301113295,1,1,0
71401076@N00,4433,23,1321866120,1321866120,1,1,0
71401076@N00,4434,3,1324184406,1324186480,4,1,2074
71401076@N00,4435,11,1330398331,1330398331,1,1,0
71401076@N00,4436,7,1336216556,1336216556,1,1,0
71401076@N00,4437,6,1338085605,1338091926,2,1,6321
71401076@N00,4438,6,1341634534,1341634534,1,1,0
71401076@N00,4439,15,1343528353,1343538487,2,1,10134
71401076@N00,4440,3,1356148644,1356148644,1,2,0
71401076@N00,4440,6,1356140383,1356146773,2,2,6390
71401076@N00,4441,21,1357383268,1357383268,1,1,0
71401076@N00,4442,25,1357963112,1357964545,2,2,1433
71401076@N00,4442,27,1357984446,1357984446,1,2,0
71401076@N00,4443,15,1369542386,1369542386,1,1,0
71401076@N00,4444,11,1369606851,1369606851,1,2,0
71401076@N00,4444,27,1369607036,1369607036,1,2,0
71401076@N00,4445,6,1380340949,1380340949,1,1,0
71401076@N00,4446,25,1387598247,1387598247,1,1,0
71401076@N00,4447,22,1397014892,1397014892,1,2,0
71401076@N00,4447,23,1397042290,1397046168,2,2,3878
71423916@N00,4448,19,1282306822,1282306859,2,1,37
7147910@N05,4449,28,1365034373,1365034373,1,1,0
71482738@N00,4450,8,1116993828,1116993828,1,5,0
71482738@N00,4450,11,1116994865,1116994865,1,5,0
71482738@N00,4450,16,1116992164,1116992336,3,5,172
71482738@N00,4450,25,1117001352,1117002103,6,5,751
71482738@N00,4450,30,1116994106,1116994495,5,5,389
71482738@N00,4451,6,1117073625,1117085552,3,4,11927
71482738@N00,4451,21,1117072718,1117072718,1,4,0
71482738@N00,4451,22,1117081282,1117081672,3,4,390
71482738@N00,4451,28,1117081315,1117081985,3,4,670
71482738@N00,4452,30,1117250067,1117253156,11,1,3089
71486434@N00,4453,30,1080741600,1080741600,12,1,0
71486434@N00,4454,30,1155700277,1155700277,4,1,0
7159179@N03,4455,22,1353145223,1353147767,7,1,2544
7159179@N03,4456,16,1361061085,1361073686,27,1,12601
71609752@N00,4457,8,1353726620,1353726709,2,2,89
71609752@N00,4457,16,1353726390,1353726754,2,2,364
7163248@N04,4458,21,1218193333,1218193333,1,1,0
7163248@N04,4459,16,1218281322,1218283021,4,1,1699
7168480@N02,4460,3,1209688968,1209688968,1,1,0
7168480@N02,4461,11,1209909743,1209918946,20,1,9203
7173709@N07,4462,25,1357124470,1357131905,13,1,7435
7184658@N06,4463,16,1179800304,1179801475,8,1,1171
71882201@N00,4464,4,1376105404,1376105404,1,1,0
71949727@N00,4465,25,1353147587,1353147587,1,1,0
7197769@N04,4466,21,1372669064,1372669064,1,1,0
7197769@N04,4467,8,1391938638,1391938638,1,1,0
7202153@N03,4468,11,1346204815,1346213123,16,2,8308
7202153@N03,4468,23,1346194546,1346195448,3,2,902
7202153@N03,4469,23,1346381951,1346381951,1,2,0
7202153@N03,4469,29,1346377633,1346379319,3,2,1686
72139255@N00,4470,4,1302947145,1302947145,1,1,0
72139255@N00,4471,18,1304562952,1304562952,1,1,0
72187426@N00,4472,16,1216471855,1216471855,1,1,0
72187426@N00,4473,16,1216710928,1216710928,1,1,0
72236905@N00,4474,8,1179198430,1179198430,1,3,0
72236905@N00,4474,11,1179186456,1179186686,3,3,230
72236905@N00,4474,27,1179186114,1179186114,1,3,0
72268014@N00,4475,6,1347687862,1347687862,1,1,0
72268014@N00,4476,22,1348919470,1348919470,1,1,0
7262621@N06,4477,4,1185875350,1185875775,7,1,425
72693550@N00,4478,14,1345358758,1345363660,14,2,4902
72693550@N00,4478,17,1345357155,1345371042,15,2,13887
72696246@N00,4479,6,1153697575,1153697575,1,1,0
72778314@N00,4480,22,1152370544,1152370544,1,1,0
72778314@N00,4481,23,1152839946,1152839946,1,1,0
72778314@N00,4482,23,1153445033,1153445033,1,1,0
72778314@N00,4483,4,1155000732,1155000732,1,1,0
72778314@N00,4484,22,1155749769,1155751952,3,1,2183
72778314@N00,4485,6,1155978620,1155978620,1,1,0
72778314@N00,4486,25,1156106495,1156106495,1,1,0
72778314@N00,4487,25,1156628065,1156628065,1,1,0
72778314@N00,4488,6,1156920834,1156920834,1,1,0
72778314@N00,4489,6,1157005330,1157005330,1,1,0
72778314@N00,4490,25,1157367326,1157367326,1,1,0
72778314@N00,4491,22,1158745184,1158745184,1,1,0
72778314@N00,4492,30,1160577586,1160577586,1,1,0
72778314@N00,4493,4,1164376153,1164376153,1,6,0
72778314@N00,4493,21,1164376553,1164376553,1,6,0
72778314@N00,4493,22,1164372914,1164372914,1,6,0
72778314@N00,4493,23,1164371910,1164372508,2,6,598
72778314@N00,4493,25,1164373095,1164375583,2,6,2488
72778314@N00,4493,28,1164372078,1164372078,1,6,0
7280120@N07,4494,16,1308498319,1308498319,1,1,0
7281367@N03,4495,21,1307437465,1307438090,2,1,625
7283523@N02,4496,24,1229164233,1229164233,1,1,0
72923553@N00,4497,30,1326754523,1326754523,1,1,0
72923553@N00,4498,22,1327196980,1327196980,1,2,0
72923553@N00,4498,28,1327197058,1327197158,4,2,100
72923553@N00,4499,30,1352684553,1352684553,1,1,0
73001770@N00,4500,16,1275822900,1275824155,5,2,1255
73001770@N00,4500,21,1275814228,1275814334,2,2,106
73101728@N00,4501,11,1372826187,1372826205,8,1,18
73272114@N00,4502,16,1152172796,1152172796,1,1,0
73293249@N00,4503,16,1089036005,1089036071,22,1,66
73293249@N00,4504,16,1089122406,1089122478,19,1,72
73302443@N05,4505,30,1385621681,1385621681,1,1,0
73416633@N00,4506,6,1247205245,1247213703,2,3,8458
73416633@N00,4506,21,1247195579,1247195579,1,3,0
73416633@N00,4506,23,1247215440,1247215440,1,3,0
73452584@N08,4507,22,1371653945,1371653945,1,1,0
73452584@N08,4508,21,1371703369,1371703369,1,1,0
73452584@N08,4509,1,1372150015,1372150015,1,2,0
73452584@N08,4509,30,1372149374,1372149374,1,2,0
73452584@N08,4510,24,1375793510,1375793510,1,2,0
73452584@N08,4510,30,1375794200,1375794200,1,2,0
73453229@N00,4511,30,1041866863,1041867067,2,1,204
73453229@N00,4512,24,1045660700,1045660700,1,1,0
73453229@N00,4513,30,1109999420,1109999420,1,1,0
73453229@N00,4514,11,1209890103,1209890103,1,1,0
73453229@N00,4515,24,1212839439,1212839585,2,1,146
73453229@N00,4516,6,1226206326,1226209986,3,1,3660
73453229@N00,4517,6,1258788091,1258788389,2,2,298
73453229@N00,4517,21,1258789307,1258789307,1,2,0
73453229@N00,4518,6,1275103090,1275103112,2,1,22
7348884@N04,4519,1,1357155277,1357155277,1,1,0
7367375@N04,4520,11,1184981182,1184987470,39,1,6288
7367375@N04,4521,21,1206160316,1206160316,1,2,0
7367375@N04,4521,23,1206159521,1206159923,2,2,402
7367375@N04,4522,24,1212818302,1212821126,16,1,2824
7367375@N04,4523,17,1214915600,1214917546,48,1,1946
7383514@N07,4524,27,1383508273,1383508273,1,1,0
73843395@N00,4525,25,1298454771,1298454771,1,1,0
73843395@N00,4526,21,1305896088,1305896088,1,1,0
73843395@N00,4527,4,1310383335,1310383335,1,1,0
73843395@N00,4528,2,1318495970,1318497760,2,1,1790
73843395@N00,4529,25,1352610988,1352610988,1,1,0
73843395@N00,4530,21,1355889827,1355889827,1,1,0
73843395@N00,4531,21,1373975485,1373975485,1,1,0
73843395@N00,4532,4,1376560058,1376567686,3,1,7628
73904611@N03,4533,1,1351116620,1351116620,1,1,0
74068217@N00,4534,22,1203051715,1203051715,1,1,0
74199783@N00,4535,16,1120210557,1120210615,11,1,58
74199783@N00,4536,23,1149667074,1149667074,1,1,0
74207162@N00,4537,21,1299646570,1299646570,1,1,0
7437393@N05,4538,21,1315044177,1315044177,1,1,0
74453626@N00,4539,22,1380880024,1380880024,1,1,0
74547255@N00,4540,3,1267591284,1267591284,1,1,0
74547255@N00,4541,6,1271559839,1271559839,1,1,0
74547255@N00,4542,3,1278293704,1278293704,1,1,0
74547255@N00,4543,3,1282394711,1282394711,1,1,0
74547255@N00,4544,21,1286031890,1286032140,2,1,250
74547255@N00,4545,3,1289278360,1289278397,3,1,37
74547255@N00,4546,3,1294806421,1294806421,1,1,0
74547255@N00,4547,3,1298354953,1298354953,1,1,0
74547255@N00,4548,22,1304504110,1304504110,1,2,0
74547255@N00,4548,23,1304503800,1304504043,6,2,243
74547255@N00,4549,4,1310376683,1310388805,17,1,12122
74547255@N00,4550,21,1334370678,1334370678,1,1,0
74547255@N00,4551,21,1346668480,1346668480,1,1,0
74648938@N00,4552,27,1154436422,1154436422,1,1,0
74648938@N00,4553,22,1156909228,1156912004,17,1,2776
74648938@N00,4554,11,1189070094,1189075550,3,1,5456
74648938@N00,4555,22,1222561441,1222561448,2,2,7
74648938@N00,4555,28,1222550104,1222560626,14,2,10522
74648938@N00,4556,22,1223179824,1223190563,8,1,10739
74648938@N00,4557,22,1247450245,1247450245,1,1,0
74648938@N00,4558,28,1341447302,1341447302,1,1,0
74648938@N00,4559,27,1349149962,1349149962,1,1,0
74648938@N00,4560,6,1354170653,1354170681,2,1,28
7475921@N05,4561,7,1346180428,1346180428,1,2,0
7475921@N05,4561,16,1346189154,1346189154,1,2,0
75062596@N00,4562,16,705204016,705204016,1,1,0
75062596@N00,4563,28,1288263789,1288263789,1,1,0
75062596@N00,4564,7,1315312581,1315312581,1,1,0
75249262@N08,4565,8,1313387093,1313387378,6,1,285
75249262@N08,4566,28,1332384549,1332384614,6,1,65
75249262@N08,4567,25,1345942516,1345946484,2,1,3968
75249262@N08,4568,25,1346074205,1346074205,1,1,0
75395187@N00,4569,24,1287462868,1287462868,1,1,0
75396048@N00,4570,21,1200875108,1200875129,2,3,21
75396048@N00,4570,24,1200881075,1200881625,2,3,550
75396048@N00,4570,30,1200884143,1200884143,1,3,0
75396048@N00,4571,8,1201080902,1201080902,1,1,0
75396048@N00,4572,7,1245809686,1245809686,1,1,0
75396048@N00,4573,24,1245841870,1245841870,1,1,0
75450299@N07,4574,6,1325332800,1325332800,1,1,0
75450299@N07,4575,25,1328500136,1328500136,1,1,0
75450299@N07,4576,25,1331952294,1331952408,2,1,114
75450299@N07,4577,21,1332040975,1332040975,1,2,0
75450299@N07,4577,25,1332038835,1332038835,1,2,0
75450299@N07,4578,6,1336789636,1336789636,1,5,0
75450299@N07,4578,21,1336793824,1336793824,1,5,0
75450299@N07,4578,22,1336791250,1336791389,2,5,139
75450299@N07,4578,25,1336783845,1336784233,2,5,388
75450299@N07,4578,28,1336794143,1336794143,1,5,0
75450299@N07,4579,21,1339667712,1339667712,1,1,0
75450299@N07,4580,21,1343869814,1343873224,4,3,3410
75450299@N07,4580,22,1343868809,1343868850,2,3,41
75450299@N07,4580,28,1343869077,1343874462,2,3,5385
75450299@N07,4581,7,1344388972,1344388972,1,1,0
7549069@N03,4582,6,1372010180,1372010290,2,2,110
7549069@N03,4582,22,1372010339,1372010339,1,2,0
7550067@N02,4583,7,1221354827,1221354827,1,2,0
7550067@N02,4583,22,1221353494,1221353494,1,2,0
7550067@N02,4584,21,1223109253,1223109253,1,2,0
7550067@N02,4584,22,1223112681,1223112681,1,2,0
7550067@N02,4585,22,1254565676,1254565676,1,1,0
7550067@N02,4586,21,1258784220,1258784220,1,1,0
75511860@N00,4587,29,1225857834,1225863753,36,1,5919
75511860@N00,4588,21,1230952383,1230954421,34,1,2038
75511860@N00,4589,21,1238807256,1238811450,33,1,4194
75511860@N00,4590,25,1240627367,1240630401,7,1,3034
75511860@N00,4591,25,1251598424,1251621969,100,1,23545
75511860@N00,4592,29,1256353629,1256358245,36,1,4616
75511860@N00,4593,22,1264036412,1264037671,11,1,1259
75511860@N00,4594,22,1264165930,1264165930,1,1,0
75511860@N00,4595,21,1264210819,1264221470,100,1,10651
75511860@N00,4596,22,1267080578,1267084328,11,1,3750
75511860@N00,4597,22,1322808776,1322808776,1,1,0
75523874@N00,4598,2,1177141524,1177141524,1,1,0
75546495@N03,4599,20,1098595882,1098600740,6,1,4858
75546495@N03,4600,4,1253095663,1253102160,4,1,6497
75631839@N00,4601,22,1305163616,1305163616,1,1,0
75631839@N00,4602,28,1306809576,1306809576,1,1,0
75631839@N00,4603,11,1313464168,1313464168,1,1,0
75631839@N00,4604,30,1326353214,1326353214,1,1,0
75631839@N00,4605,8,1385197911,1385197911,1,1,0
7571130@N05,4606,2,1183280252,1183281733,2,1,1481
7571130@N05,4607,2,1183341966,1183357609,13,1,15643
75771631@N00,4608,16,1221715900,1221715900,1,1,0
75819250@N00,4609,25,1301725273,1301725273,1,1,0
75837785@N00,4610,7,1111872343,1111872343,1,1,0
75837785@N00,4611,11,1140916019,1140916019,1,1,0
75837785@N00,4612,4,1150716006,1150716006,2,1,0
7592262@N02,4613,16,1218952739,1218953719,2,1,980
75973921@N00,4614,28,1016320183,1016320183,1,1,0
75973921@N00,4615,13,1187323462,1187324989,13,1,1527
75973921@N00,4616,11,1196465538,1196465894,9,1,356
75973921@N00,4617,11,1200035358,1200036980,10,1,1622
75973921@N00,4618,21,1202549650,1202550236,2,2,586
75973921@N00,4618,23,1202549035,1202549035,1,2,0
75973921@N00,4619,21,1224299916,1224299973,3,1,57
75973921@N00,4620,21,1224389594,1224389594,1,1,0
75973921@N00,4621,13,1233355242,1233355242,1,1,0
75973921@N00,4622,28,1250237237,1250237237,1,2,0
75973921@N00,4622,30,1250237648,1250237667,2,2,19
75973921@N00,4623,11,1261194937,1261194937,1,1,0
75973921@N00,4624,11,1261361407,1261363106,7,1,1699
75973921@N00,4625,13,1295169274,1295169274,1,1,0
75973921@N00,4626,22,1298717760,1298717846,3,1,86
75981918@N00,4627,16,1180591347,1180591347,1,1,0
7616875@N04,4628,22,1062659662,1062659662,1,1,0
7616875@N04,4629,11,1121941245,1121945306,40,1,4061
7616875@N04,4630,11,1185961436,1185971097,175,1,9661
7616875@N04,4631,11,1216116584,1216126542,225,1,9958
7616875@N04,4632,11,1247390016,1247400719,316,1,10703
7616875@N04,4633,11,1247566041,1247574750,221,1,8709
7616875@N04,4634,22,1254579248,1254579463,5,1,215
7616875@N04,4635,11,1278927775,1278938198,412,1,10423
7616875@N04,4636,4,1281087149,1281087661,8,1,512
7616875@N04,4637,11,1310981012,1310990763,262,1,9751
76222606@N03,4638,1,1367660607,1367664109,15,1,3502
76323119@N00,4639,11,1143156643,1143156643,1,1,0
76323119@N00,4640,11,1196649320,1196649320,1,1,0
76323119@N00,4641,20,1325499823,1325499823,1,2,0
76323119@N00,4641,22,1325500091,1325500091,1,2,0
76323119@N00,4642,6,1353122095,1353122095,1,1,0
76323119@N00,4643,21,1361603305,1361603305,1,1,0
76323119@N00,4644,6,1362486467,1362486467,1,1,0
76323119@N00,4645,30,1367926744,1367926744,1,1,0
76323119@N00,4646,4,1368183924,1368183924,1,2,0
76323119@N00,4646,22,1368171277,1368171962,2,2,685
76323119@N00,4647,11,1368777616,1368777616,1,1,0
76323119@N00,4648,27,1370603854,1370603854,1,1,0
76323119@N00,4649,28,1370647872,1370647872,1,1,0
76323119@N00,4650,6,1375874533,1375874533,1,1,0
76323119@N00,4651,22,1375919188,1375919188,1,1,0
76323119@N00,4652,6,1375951841,1375951841,1,1,0
76323119@N00,4653,18,1376481567,1376484851,2,1,3284
76323119@N00,4654,14,1377857705,1377857705,1,1,0
76323119@N00,4655,6,1378376398,1378376398,1,1,0
76323119@N00,4656,16,1378976475,1378976475,1,1,0
76323119@N00,4657,27,1380063740,1380074914,6,1,11174
76323119@N00,4658,25,1380273037,1380273037,1,1,0
76323119@N00,4659,22,1380879355,1380891673,2,1,12318
76323119@N00,4660,22,1380977333,1380977333,1,1,0
76323119@N00,4661,22,1381040461,1381040461,1,1,0
76323119@N00,4662,22,1381237202,1381237522,3,1,320
76323119@N00,4663,22,1381286030,1381286242,2,1,212
76323119@N00,4664,6,1381390990,1381390990,1,1,0
76323119@N00,4665,6,1381521047,1381521047,1,2,0
76323119@N00,4665,22,1381520792,1381520792,1,2,0
76323119@N00,4666,22,1392194733,1392194733,1,1,0
76323119@N00,4667,21,1393197751,1393197751,1,1,0
76323119@N00,4668,21,1396400452,1396400657,3,1,205
76323119@N00,4669,25,1397029783,1397029783,1,1,0
76323119@N00,4670,6,1397631715,1397631736,2,1,21
76474448@N00,4671,16,1218024868,1218024958,5,1,90
76551426@N00,4672,1,1263282204,1263282414,3,1,210
76626106@N00,4673,6,1339227121,1339227121,1,1,0
76692842@N07,4674,22,1385803473,1385803473,1,1,0
76692842@N07,4675,24,1387172719,1387172719,1,1,0
76692842@N07,4676,21,1387519461,1387519461,1,2,0
76692842@N07,4676,23,1387520574,1387520574,1,2,0
76692842@N07,4677,22,1387779573,1387780066,2,1,493
76714146@N03,4678,7,1341619868,1341633565,8,1,13697
76714146@N03,4679,19,1342091747,1342091747,1,1,0
76714146@N03,4680,11,1343084601,1343090469,5,1,5868
76714146@N03,4681,21,1344229188,1344229188,1,2,0
76714146@N03,4681,29,1344227894,1344227894,1,2,0
76714146@N03,4682,3,1345975608,1345975608,1,2,0
76714146@N03,4682,16,1345961734,1345961734,1,2,0
76714146@N03,4683,13,1346105443,1346105529,2,1,86
76714146@N03,4684,30,1346214221,1346214221,1,1,0
7671591@N08,4685,1,1315823411,1315823411,1,1,0
76741766@N00,4686,15,1280906023,1280906023,1,1,0
76741766@N00,4687,6,1300508294,1300517197,5,1,8903
7680826@N04,4688,25,1179319824,1179319824,1,1,0
7680826@N04,4689,23,1199603133,1199603133,1,1,0
7680826@N04,4690,25,1206241200,1206241204,3,1,4
7680826@N04,4691,25,1207554443,1207554443,1,1,0
76931093@N00,4692,6,1327708273,1327708273,1,1,0
76945626@N00,4693,30,1168317296,1168319130,7,1,1834
77112637@N00,4694,27,1286013559,1286013778,2,1,219
77112637@N00,4695,22,1314005226,1314007142,2,1,1916
77112637@N00,4696,22,1314091833,1314094511,7,1,2678
77112637@N00,4697,22,1314179363,1314181000,4,1,1637
77112637@N00,4698,16,1314263736,1314267587,4,2,3851
77112637@N00,4698,22,1314275531,1314277065,2,2,1534
77112637@N00,4699,22,1314387878,1314387878,1,1,0
77112637@N00,4700,22,1314571272,1314571272,1,1,0
77112637@N00,4701,21,1317491743,1317491743,1,3,0
77112637@N00,4701,22,1317469013,1317469682,2,3,669
77112637@N00,4701,23,1317468450,1317468450,1,3,0
77112637@N00,4702,21,1318837200,1318837805,4,1,605
77112637@N00,4703,22,1319257431,1319261251,6,1,3820
77112637@N00,4704,28,1319863628,1319863924,2,1,296
77112637@N00,4705,7,1320465012,1320465012,1,1,0
77112637@N00,4706,22,1320740649,1320740649,1,1,0
77112637@N00,4707,29,1321080862,1321081006,2,1,144
77112637@N00,4708,22,1321680809,1321682517,8,1,1708
77112637@N00,4709,22,1322864447,1322864447,1,1,0
77112637@N00,4710,27,1330148904,1330148904,1,1,0
77112637@N00,4711,25,1330215706,1330215706,1,1,0
77112637@N00,4712,25,1336865656,1336865656,1,1,0
77112637@N00,4713,22,1338081199,1338084347,11,1,3148
77112637@N00,4714,22,1338157918,1338158039,2,1,121
77112637@N00,4715,7,1356931795,1356931795,1,1,0
77112637@N00,4716,1,1358760671,1358760671,1,1,0
77112637@N00,4717,3,1369452000,1369452000,1,1,0
7715680@N06,4718,30,1342768328,1342768328,1,1,0
7715680@N06,4719,21,1342804108,1342804108,1,1,0
7715680@N06,4720,21,1342842712,1342842712,1,1,0
7715680@N06,4721,21,1342899488,1342899488,1,1,0
7715680@N06,4722,7,1343024719,1343024719,1,2,0
7715680@N06,4722,22,1343008034,1343008034,1,2,0
77197860@N00,4723,29,1276745790,1276745790,1,1,0
7733020@N03,4724,24,1181210402,1181210404,2,1,2
7733020@N03,4725,1,1183114250,1183119495,8,1,5245
7733020@N03,4726,16,1227767635,1227767899,2,1,264
7733020@N03,4727,23,1227932243,1227932243,1,1,0
77356400@N00,4728,30,1308732808,1308732808,1,1,0
77356400@N00,4729,6,1313140687,1313143467,3,1,2780
77356400@N00,4730,2,1314956830,1314959716,2,1,2886
77356400@N00,4731,11,1317801755,1317801755,1,1,0
77410038@N04,4732,16,1343290272,1343290272,1,1,0
77410038@N04,4733,17,1343373494,1343373494,1,1,0
77483134@N00,4734,4,1127730753,1127730753,1,1,0
77483134@N00,4735,20,1130459998,1130460107,2,1,109
77483134@N00,4736,4,1178614698,1178618955,5,2,4257
77483134@N00,4736,16,1178615198,1178615198,1,2,0
77483134@N00,4737,18,1182047032,1182047032,1,1,0
77483134@N00,4738,24,1203831694,1203840125,4,2,8431
77483134@N00,4738,30,1203837989,1203837989,1,2,0
77483134@N00,4739,22,1235267531,1235267531,1,1,0
77483134@N00,4740,6,1237686491,1237686491,1,1,0
77547214@N00,4741,12,1215487337,1215487337,1,1,0
77656905@N00,4742,8,1389328667,1389328667,1,1,0
7768566@N07,4743,7,1300344372,1300344372,1,2,0
7768566@N07,4743,21,1300371934,1300371934,1,2,0
7768566@N07,4744,7,1301306440,1301306440,1,1,0
7768566@N07,4745,22,1302237192,1302241724,3,2,4532
7768566@N07,4745,28,1302238869,1302238869,1,2,0
7768566@N07,4746,30,1302277903,1302277903,1,1,0
7768566@N07,4747,21,1302317535,1302319648,8,1,2113
7768566@N07,4748,6,1302663395,1302663395,1,1,0
7768566@N07,4749,11,1302774790,1302774794,2,1,4
77689978@N00,4750,11,1183270789,1183300999,34,1,30210
77726415@N00,4751,24,1278038908,1278038908,1,2,0
77726415@N00,4751,25,1278061193,1278061193,1,2,0
77726415@N00,4752,25,1278225190,1278225190,1,1,0
7776449@N06,4753,22,1181513247,1181513247,1,1,0
7776449@N06,4754,7,1185602350,1185607568,27,1,5218
7776449@N06,4755,7,1185716695,1185716695,1,2,0
7776449@N06,4755,19,1185689947,1185689947,1,2,0
7776449@N06,4756,11,1186380361,1186386899,9,3,6538
7776449@N06,4756,22,1186372887,1186372887,1,3,0
7776449@N06,4756,29,1186378562,1186378888,2,3,326
7776449@N06,4757,7,1189592202,1189592202,1,1,0
7776449@N06,4758,6,1191073275,1191073275,1,5,0
7776449@N06,4758,21,1191065468,1191067486,7,5,2018
7776449@N06,4758,23,1191070319,1191072418,4,5,2099
7776449@N06,4758,25,1191077385,1191077385,1,5,0
7776449@N06,4758,27,1191088868,1191088994,2,5,126
7776449@N06,4759,16,1192829040,1192829197,4,1,157
7776449@N06,4760,22,1195897125,1195900454,14,1,3329
7776449@N06,4761,22,1196678237,1196678323,2,1,86
7776449@N06,4762,28,1197890510,1197890676,7,1,166
7776449@N06,4763,23,1199263778,1199266763,3,1,2985
7776449@N06,4764,22,1201245370,1201249778,26,1,4408
7776449@N06,4765,30,1201355284,1201355284,1,1,0
7776449@N06,4766,30,1201821942,1201821942,1,1,0
7776449@N06,4767,30,1202196215,1202196215,1,1,0
7776449@N06,4768,16,1204212903,1204213243,3,1,340
7776449@N06,4769,30,1206489883,1206489883,1,1,0
7776449@N06,4770,30,1206538133,1206538133,1,1,0
7776449@N06,4771,30,1207874739,1207874739,1,1,0
7776449@N06,4772,30,1207914634,1207914634,1,1,0
7776449@N06,4773,16,1208577855,1208577861,2,1,6
7776449@N06,4774,30,1210981428,1210981428,1,1,0
7776449@N06,4775,19,1216123451,1216123451,1,1,0
7776449@N06,4776,25,1217098403,1217098412,2,1,9
77765234@N00,4777,6,1189483579,1189483579,1,1,0
77799978@N00,4778,7,1309766485,1309767764,5,2,1279
77799978@N00,4778,16,1309766323,1309766323,1,2,0
77799978@N00,4779,7,1322237194,1322237194,1,1,0
77991136@N03,4780,21,1352540152,1352541542,7,1,1390
77991136@N03,4781,22,1353150654,1353151651,2,1,997
78015320@N00,4782,6,1277970855,1277971223,3,5,368
78015320@N00,4782,8,1277964790,1277964790,1,5,0
78015320@N00,4782,16,1277961912,1277964365,8,5,2453
78015320@N00,4782,22,1277969676,1277969718,2,5,42
78015320@N00,4782,28,1277968057,1277968057,1,5,0
78015320@N00,4783,6,1278121354,1278124810,4,3,3456
78015320@N00,4783,11,1278133392,1278133406,2,3,14
78015320@N00,4783,13,1278128303,1278129565,4,3,1262
78015320@N00,4784,3,1278317855,1278317855,1,1,0
78088681@N00,4785,16,1185889140,1185889140,1,1,0
78119761@N07,4786,7,1315031943,1315032956,2,1,1013
78191101@N00,4787,25,1162450800,1162450811,12,1,11
78266179@N00,4788,16,1375956559,1375957376,6,1,817
78297105@N00,4789,9,1158710893,1158710893,1,1,0
78297105@N00,4790,9,1225536308,1225536308,1,1,0
78319639@N08,4791,11,1336596617,1336596617,1,1,0
78353539@N00,4792,22,1104572882,1104572882,1,1,0
78353539@N00,4793,25,1133673089,1133673089,1,1,0
78353539@N00,4794,25,1143098082,1143098082,1,1,0
78353539@N00,4795,28,1157479656,1157479656,1,1,0
78353539@N00,4796,25,1159677597,1159678377,2,1,780
78353539@N00,4797,25,1161784800,1161784800,1,1,0
78353539@N00,4798,25,1162092403,1162092403,1,1,0
78353539@N00,4799,25,1164465579,1164465579,1,1,0
78353539@N00,4800,25,1193557873,1193557873,1,1,0
78353539@N00,4801,22,1247223983,1247223983,1,1,0
78353539@N00,4802,25,1345347814,1345347814,1,1,0
78433558@N00,4803,1,1156125339,1156125339,1,1,0
78433558@N00,4804,7,1157510202,1157514514,11,2,4312
78433558@N00,4804,28,1157510596,1157514524,7,2,3928
78433558@N00,4805,1,1162364649,1162364649,1,3,0
78433558@N00,4805,7,1162364794,1162364794,1,3,0
78433558@N00,4805,28,1162364995,1162364995,1,3,0
78433558@N00,4806,1,1165883609,1165883609,1,1,0
78433558@N00,4807,16,1205009557,1205009647,3,2,90
78433558@N00,4807,30,1205010775,1205010775,1,2,0
78436447@N00,4808,23,1126340154,1126340154,1,1,0
78436447@N00,4809,23,1126530016,1126530016,1,1,0
78436447@N00,4810,21,1131854568,1131856860,10,1,2292
78436447@N00,4811,28,1136010371,1136010371,1,1,0
78436447@N00,4812,7,1136217127,1136217127,1,1,0
78436447@N00,4813,6,1139876737,1139882026,22,1,5289
78436447@N00,4814,23,1142733761,1142733761,1,1,0
78436447@N00,4815,27,1146370744,1146370744,1,1,0
78436447@N00,4816,21,1148986130,1148986130,1,1,0
78436447@N00,4817,23,1157711731,1157711731,1,1,0
78436447@N00,4818,23,1157787441,1157806208,8,1,18767
78436447@N00,4819,23,1157885506,1157885582,3,1,76
78436447@N00,4820,23,1157979879,1157979879,1,1,0
78436447@N00,4821,23,1158060636,1158060728,3,1,92
78436447@N00,4822,23,1158144717,1158146017,4,1,1300
78436447@N00,4823,21,1167590821,1167590821,1,1,0
78436447@N00,4824,7,1168756137,1168756137,1,1,0
78436447@N00,4825,21,1170368845,1170368845,1,1,0
78436447@N00,4826,21,1170482359,1170483809,4,1,1450
78436447@N00,4827,11,1176888445,1176891192,2,1,2747
78436447@N00,4828,11,1180781818,1180784164,3,1,2346
78436447@N00,4829,11,1180853630,1180854163,2,1,533
78436447@N00,4830,11,1183111290,1183111290,1,1,0
78436447@N00,4831,11,1205546688,1205551393,2,2,4705
78436447@N00,4831,21,1205556594,1205556594,1,2,0
78436447@N00,4832,21,1206161062,1206161062,1,2,0
78436447@N00,4832,23,1206159344,1206159344,1,2,0
78436447@N00,4833,1,1206948800,1206948800,1,1,0
78436447@N00,4834,21,1207467462,1207467462,1,1,0
78436447@N00,4835,15,1208678973,1208682262,2,1,3289
78436447@N00,4836,21,1208941550,1208942934,3,1,1384
78436447@N00,4837,7,1210147437,1210147437,1,1,0
78436447@N00,4838,11,1210415524,1210415524,1,1,0
78436447@N00,4839,22,1211615469,1211615785,2,1,316
78436447@N00,4840,22,1211904752,1211904752,1,1,0
78436447@N00,4841,22,1212065854,1212065854,1,1,0
78436447@N00,4842,22,1212225934,1212227569,3,1,1635
78436447@N00,4843,21,1212291336,1212291336,1,1,0
78436447@N00,4844,21,1212750994,1212759963,2,1,8969
78436447@N00,4845,21,1212847373,1212849642,5,1,2269
78436447@N00,4846,21,1214037782,1214052627,14,1,14845
78436447@N00,4847,21,1214307624,1214307624,1,1,0
78436447@N00,4848,21,1214634244,1214634244,1,1,0
78436447@N00,4849,21,1214987397,1214997994,9,1,10597
78436447@N00,4850,21,1215515005,1215515461,2,1,456
78436447@N00,4851,21,1215685340,1215689294,2,1,3954
78436447@N00,4852,6,1215859846,1215859916,2,1,70
78436447@N00,4853,22,1215935705,1215935705,1,1,0
78436447@N00,4854,29,1217499798,1217499798,1,1,0
78436447@N00,4855,21,1218536762,1218536762,1,1,0
78436447@N00,4856,19,1218712211,1218712211,1,1,0
78436447@N00,4857,15,1233464924,1233464924,1,1,0
78436447@N00,4858,2,1241248171,1241248171,1,1,0
78436447@N00,4859,6,1242119132,1242119132,1,1,0
78436447@N00,4860,24,1243444086,1243444086,1,1,0
78436447@N00,4861,6,1343360993,1343360993,1,1,0
7893801@N07,4862,21,1239594868,1239594868,1,1,0
7893801@N07,4863,22,1295689343,1295689343,1,1,0
7893801@N07,4864,8,1296689137,1296689137,1,1,0
7893801@N07,4865,23,1298358880,1298358880,1,1,0
7893801@N07,4866,1,1298621497,1298621497,1,1,0
78961286@N00,4867,30,1340853667,1340862317,4,1,8650
78961286@N00,4868,15,1341065625,1341065625,1,1,0
78961286@N00,4869,30,1341120275,1341120275,1,1,0
7910884@N08,4870,25,1371698251,1371698251,1,1,0
7910884@N08,4871,16,1371812216,1371812216,1,1,0
7910884@N08,4872,7,1371994987,1371994987,1,1,0
7910884@N08,4873,25,1372576548,1372577706,2,1,1158
7910884@N08,4874,25,1372729503,1372735091,2,1,5588
7910884@N08,4875,21,1372925785,1372925785,1,1,0
79112147@N00,4876,8,1213337985,1213337985,1,2,0
79112147@N00,4876,30,1213339216,1213339216,1,2,0
79112147@N00,4877,25,1213440618,1213441608,3,1,990
79112147@N00,4878,16,1213490047,1213495247,4,1,5200
79112147@N00,4879,21,1213596015,1213597877,2,1,1862
79112147@N00,4880,4,1215767051,1215771363,3,1,4312
79281747@N00,4881,29,1357385587,1357385587,1,1,0
79281747@N00,4882,22,1359157018,1359158416,6,1,1398
79281747@N00,4883,8,1390965299,1390968342,49,1,3043
79353384@N00,4884,16,1329110152,1329110152,1,1,0
79409491@N00,4885,22,1215851492,1215851492,1,1,0
79409491@N00,4886,11,1374040848,1374040848,1,1,0
79442882@N03,4887,25,1348908257,1348908257,1,1,0
79442882@N03,4888,27,1348984418,1348984418,1,1,0
79442882@N03,4889,27,1349147609,1349147609,1,1,0
7956831@N04,4890,4,1313316987,1313316987,1,1,0
7956831@N04,4891,4,1314287238,1314293802,2,2,6564
7956831@N04,4891,16,1314274357,1314274357,1,2,0
79781814@N00,4892,16,1370056310,1370056359,2,1,49
79833224@N00,4893,4,1376036196,1376044907,10,2,8711
79833224@N00,4893,16,1376031065,1376031065,1,2,0
79844697@N07,4894,21,1343338154,1343338154,1,1,0
80081757@N00,4895,2,1376739960,1376739960,1,1,0
80081757@N00,4896,14,1376779628,1376779628,1,2,0
80081757@N00,4896,17,1376780354,1376780354,1,2,0
80135356@N00,4897,16,1189796628,1189796628,1,1,0
80189641@N00,4898,16,1088604000,1088604000,2,2,0
80189641@N00,4898,25,1088604000,1088604000,4,2,0
80316774@N00,4899,4,1246164320,1246164320,1,1,0
80316774@N00,4900,4,1301706929,1301715828,2,1,8899
80316774@N00,4901,4,1305024729,1305027670,3,1,2941
80337781@N00,4902,14,1282047557,1282047557,1,1,0
80355374@N00,4903,21,1167800257,1167800257,1,1,0
80355374@N00,4904,26,1226025343,1226025343,1,1,0
80383044@N00,4905,6,1355797675,1355797675,1,1,0
80383044@N00,4906,30,1369051691,1369051691,1,1,0
80383073@N08,4907,24,1336216007,1336216007,1,1,0
8051459@N02,4908,15,1151676000,1151676000,1,1,0
8053318@N07,4909,22,1177750327,1177750327,1,1,0
8053318@N07,4910,24,1178360986,1178360986,1,1,0
80585385@N00,4911,27,1186219417,1186219417,1,1,0
80585385@N00,4912,29,1213048635,1213048635,1,1,0
80620194@N03,4913,3,1347110257,1347110257,1,2,0
80620194@N03,4913,21,1347109898,1347109898,1,2,0
8070489@N02,4914,22,1180138280,1180141705,7,3,3425
8070489@N02,4914,23,1180142148,1180144330,20,3,2182
8070489@N02,4914,28,1180144774,1180144774,1,3,0
8086976@N02,4915,22,1260618131,1260620338,7,1,2207
8086976@N02,4916,24,1261357889,1261359187,5,1,1298
8086976@N02,4917,10,1268008537,1268014519,9,1,5982
8086976@N02,4918,21,1268541328,1268541328,1,1,0
80879993@N00,4919,6,1370744501,1370744501,1,1,0
80901997@N00,4920,23,1259383425,1259383425,1,2,0
80901997@N00,4920,28,1259383499,1259383499,1,2,0
80901997@N00,4921,21,1330586764,1330586764,1,1,0
80988556@N00,4922,7,1158792567,1158792567,1,2,0
80988556@N00,4922,30,1158792458,1158792458,1,2,0
80988556@N00,4923,30,1159218125,1159218140,2,1,15
80988556@N00,4924,7,1159311043,1159311144,2,1,101
80988556@N00,4925,7,1161651178,1161651178,1,1,0
80988556@N00,4926,7,1163397924,1163397938,2,1,14
80988556@N00,4927,7,1164058029,1164058029,1,1,0
80988556@N00,4928,30,1170138658,1170138658,1,1,0
80988556@N00,4929,7,1170198140,1170198140,1,1,0
80988556@N00,4930,30,1172011557,1172011606,2,1,49
80988556@N00,4931,30,1174861076,1174861085,2,1,9
80988556@N00,4932,30,1174890137,1174890311,3,1,174
80988556@N00,4933,30,1177363123,1177363123,1,1,0
80988556@N00,4934,30,1180906368,1180906417,2,1,49
80988556@N00,4935,30,1184146448,1184146448,1,1,0
80988556@N00,4936,7,1184192907,1184193118,6,1,211
80988556@N00,4937,1,1184234784,1184235341,9,2,557
80988556@N00,4937,30,1184235476,1184235945,9,2,469
80988556@N00,4938,30,1184537597,1184537597,1,1,0
80988556@N00,4939,7,1184570052,1184570138,2,1,86
80988556@N00,4940,7,1184624355,1184624425,3,1,70
80988556@N00,4941,30,1184679241,1184679466,7,1,225
80988556@N00,4942,30,1184796416,1184796416,1,1,0
80988556@N00,4943,7,1184883188,1184883188,1,1,0
80988556@N00,4944,7,1185142209,1185142209,1,2,0
80988556@N00,4944,30,1185141775,1185142095,3,2,320
80988556@N00,4945,7,1185173376,1185173529,4,2,153
80988556@N00,4945,30,1185173650,1185173672,2,2,22
80988556@N00,4946,7,1185228868,1185228918,3,1,50
80988556@N00,4947,7,1185315667,1185315667,1,1,0
80988556@N00,4948,7,1185346239,1185346239,1,1,0
80988556@N00,4949,7,1186470465,1186470465,1,1,0
80988556@N00,4950,7,1186557953,1186557953,1,2,0
80988556@N00,4950,30,1186529344,1186529421,4,2,77
80988556@N00,4951,30,1186697124,1186697194,2,1,70
80988556@N00,4952,7,1186956816,1186956816,1,1,0
80988556@N00,4953,7,1187216133,1187216133,1,1,0
80988556@N00,4954,7,1195420341,1195420341,1,2,0
80988556@N00,4954,30,1195420199,1195420199,1,2,0
80988556@N00,4955,7,1195504343,1195504343,1,1,0
80988556@N00,4956,7,1195711806,1195711806,1,1,0
8101189@N07,4957,11,1278667474,1278667474,1,1,0
81076746@N00,4958,22,1141020083,1141020083,2,1,0
81076746@N00,4959,7,1356839365,1356839386,2,2,21
81076746@N00,4959,22,1356837575,1356837575,1,2,0
81076746@N00,4960,12,1388424202,1388424236,3,1,34
8110030@N05,4961,1,1210653751,1210662160,4,10,8409
8110030@N05,4961,4,1210654091,1210654091,1,10,0
8110030@N05,4961,7,1210662173,1210666002,6,10,3829
8110030@N05,4961,16,1210651491,1210655867,5,10,4376
8110030@N05,4961,19,1210682928,1210682989,2,10,61
8110030@N05,4961,21,1210645664,1210646542,4,10,878
8110030@N05,4961,23,1210646225,1210649732,3,10,3507
8110030@N05,4961,24,1210660662,1210660892,2,10,230
8110030@N05,4961,28,1210649845,1210650175,3,10,330
8110030@N05,4961,30,1210650968,1210650968,1,10,0
81211130@N00,4962,30,1270848292,1270848292,1,1,0
81211130@N00,4963,7,1271367222,1271367222,1,2,0
81211130@N00,4963,16,1271380089,1271380089,1,2,0
81211130@N00,4964,22,1276340292,1276340292,1,1,0
81211130@N00,4965,27,1287775176,1287776191,10,1,1015
81211130@N00,4966,22,1313979193,1313981466,4,1,2273
81324440@N00,4967,25,1134895274,1134895280,7,1,6
81324440@N00,4968,25,1135223042,1135223051,6,1,9
81328667@N00,4969,22,1186221195,1186221195,1,1,0
81354599@N00,4970,16,1362899460,1362899477,2,1,17
81471618@N06,4971,11,1377047700,1377047700,1,1,0
81471618@N06,4972,21,1377144845,1377144845,1,3,0
81471618@N06,4972,23,1377142294,1377142294,1,3,0
81471618@N06,4972,28,1377141232,1377144391,2,3,3159
81471618@N06,4973,11,1377300642,1377300642,1,3,0
81471618@N06,4973,15,1377306302,1377307586,3,3,1284
81471618@N06,4973,19,1377304378,1377306222,3,3,1844
81471618@N06,4974,28,1377490051,1377491349,2,1,1298
8149753@N05,4975,15,1190512121,1190517258,3,1,5137
81603252@N06,4976,28,1373896800,1373896800,1,1,0
81603252@N06,4977,22,1374069600,1374069600,1,1,0
81685076@N00,4978,27,1312080839,1312080905,9,1,66
81685848@N00,4979,6,1376626143,1376626143,1,1,0
81966538@N00,4980,28,1226386333,1226386333,1,1,0
82108446@N00,4981,18,1314422437,1314422437,1,1,0
82277001@N00,4982,21,1224228601,1224235954,9,1,7353
82405581@N00,4983,6,1113472994,1113473124,2,1,130
82405581@N00,4984,25,1116029374,1116029374,1,1,0
82405581@N00,4985,7,1126352090,1126352090,1,1,0
82405581@N00,4986,28,1131767194,1131767194,1,1,0
82405581@N00,4987,28,1305079996,1305079996,1,1,0
82405581@N00,4988,4,1310354461,1310386101,6,1,31640
82405581@N00,4989,4,1310454703,1310454703,1,1,0
82405581@N00,4990,13,1313800276,1313801257,3,1,981
82405581@N00,4991,22,1319062050,1319062050,1,1,0
82405581@N00,4992,23,1328323896,1328323896,1,2,0
82405581@N00,4992,28,1328323846,1328323970,3,2,124
82405581@N00,4993,23,1334613830,1334613830,1,2,0
82405581@N00,4993,28,1334613793,1334613793,1,2,0
82405581@N00,4994,25,1335252830,1335252830,1,1,0
82405581@N00,4995,28,1336782763,1336782909,2,1,146
82405581@N00,4996,23,1340313219,1340313219,1,1,0
8250978@N04,4997,7,1250281804,1250281804,1,5,0
8250978@N04,4997,8,1250282654,1250282978,3,5,324
8250978@N04,4997,22,1250280114,1250285045,2,5,4931
8250978@N04,4997,28,1250280381,1250280488,2,5,107
8250978@N04,4997,30,1250273239,1250281987,3,5,8748
82517560@N00,4998,13,1065405553,1065405553,3,2,0
82517560@N00,4998,16,1065405553,1065405553,15,2,0
82568321@N00,4999,25,1349315535,1349315535,1,1,0
82568321@N00,5000,7,1350115395,1350115395,1,1,0
82568321@N00,5001,25,1350370086,1350370086,1,1,0
82568321@N00,5002,7,1351196393,1351196393,1,1,0
82568321@N00,5003,23,1351403178,1351403178,1,1,0
82568321@N00,5004,30,1352060685,1352060685,1,1,0
82568321@N00,5005,30,1352405953,1352405953,1,1,0
82568321@N00,5006,25,1353285901,1353289653,11,2,3752
82568321@N00,5006,30,1353301335,1353302114,2,2,779
82568321@N00,5007,30,1353387324,1353387324,1,1,0
82568321@N00,5008,25,1365037711,1365037711,1,1,0
82568321@N00,5009,6,1377928939,1377928939,1,1,0
82568321@N00,5010,27,1379137077,1379137077,1,1,0
82568321@N00,5011,7,1380762852,1380762852,1,1,0
82646093@N00,5012,28,1317866427,1317866427,1,1,0
82646093@N00,5013,28,1317940248,1317940386,4,1,138
82646093@N00,5014,28,1318301565,1318301671,2,1,106
82646093@N00,5015,23,1324517580,1324517639,3,1,59
82646093@N00,5016,26,1325564800,1325564852,3,1,52
82646093@N00,5017,6,1327029675,1327029818,4,1,143
8273134@N08,5018,4,1186153432,1186153432,1,1,0
8273134@N08,5019,4,1186216048,1186224304,6,1,8256
8280662@N03,5020,22,1293158921,1293158921,1,2,0
8280662@N03,5020,30,1293154382,1293154382,1,2,0
82845843@N04,5021,30,1342471814,1342471814,1,1,0
82845843@N04,5022,6,1342516136,1342516136,1,3,0
82845843@N04,5022,11,1342524081,1342524924,2,3,843
82845843@N04,5022,27,1342517546,1342517546,1,3,0
83312589@N00,5023,28,1222442150,1222442150,1,1,0
83312589@N00,5024,1,1224585128,1224585128,1,1,0
83868369@N00,5025,22,1286035562,1286035562,1,1,0
8389569@N08,5026,21,1219208326,1219208356,3,1,30
8389569@N08,5027,21,1219429630,1219429630,1,1,0
84035351@N00,5028,8,1055844484,1055844484,1,2,0
84035351@N00,5028,30,1055844485,1055844485,1,2,0
84035351@N00,5029,21,1065252876,1065253066,3,3,190
84035351@N00,5029,23,1065252744,1065252744,1,3,0
84035351@N00,5029,30,1065272531,1065272531,1,3,0
8410258@N03,5030,30,1216958182,1216958182,1,1,0
8410258@N03,5031,15,1217481880,1217481880,1,1,0
84197163@N00,5032,21,1328929958,1328929958,1,1,0
84197163@N00,5033,1,1332883609,1332883609,1,1,0
84197163@N00,5034,21,1333526557,1333526557,1,1,0
84197163@N00,5035,21,1334750296,1334750296,1,1,0
84197163@N00,5036,21,1334891669,1334891840,2,1,171
84197163@N00,5037,21,1339152809,1339153365,4,1,556
84197163@N00,5038,28,1341442964,1341442964,1,1,0
84197163@N00,5039,21,1341473590,1341473590,1,1,0
84197163@N00,5040,21,1343186657,1343186657,1,1,0
84197163@N00,5041,21,1343279711,1343279711,1,1,0
84197163@N00,5042,30,1351927416,1351927416,1,1,0
84197163@N00,5043,24,1352766079,1352766213,2,1,134
84197163@N00,5044,24,1356044838,1356044838,1,1,0
84197163@N00,5045,24,1358976152,1358976152,1,1,0
84197163@N00,5046,24,1359522477,1359522477,1,1,0
84197163@N00,5047,24,1360101332,1360101332,1,1,0
84197163@N00,5048,1,1367404981,1367404981,1,1,0
84197163@N00,5049,1,1368431784,1368431784,1,1,0
84197163@N00,5050,8,1370230100,1370230100,1,1,0
84197163@N00,5051,24,1371697144,1371697144,1,1,0
84197163@N00,5052,1,1378465383,1378465383,1,1,0
84197163@N00,5053,24,1380618621,1380618621,1,1,0
84197163@N00,5054,24,1385533534,1385533534,1,1,0
84197163@N00,5055,24,1387319187,1387319187,1,1,0
84197163@N00,5056,12,1388028183,1388029959,3,1,1776
84197163@N00,5057,24,1388714771,1388714771,1,1,0
84197163@N00,5058,1,1391417010,1391417010,1,1,0
84197163@N00,5059,1,1391684497,1391685673,3,1,1176
84197163@N00,5060,24,1392954067,1392954067,1,1,0
84197163@N00,5061,24,1394433814,1394433814,1,1,0
84197163@N00,5062,12,1397794479,1397794479,1,1,0
84213418@N00,5063,16,1206159932,1206167104,17,2,7172
84213418@N00,5063,25,1206184258,1206185254,4,2,996
84213418@N00,5064,28,1206264766,1206265104,3,1,338
84213851@N00,5065,6,1160652873,1160653396,2,1,523
84337607@N00,5066,16,1378952545,1378952545,1,1,0
84337607@N00,5067,24,1379205976,1379206174,2,1,198
84337607@N00,5068,11,1379399829,1379399829,1,1,0
84337607@N00,5069,6,1379499319,1379499319,1,1,0
84337607@N00,5070,9,1379548837,1379548837,1,1,0
8450063@N08,5071,16,1339753766,1339753766,1,1,0
84518681@N00,5072,6,1256945163,1256952299,3,1,7136
84518681@N00,5073,4,1277777066,1277786866,9,3,9800
84518681@N00,5073,8,1277785160,1277785160,1,3,0
84518681@N00,5073,16,1277765590,1277785633,13,3,20043
84518681@N00,5074,16,1280031943,1280031943,1,1,0
84614046@N00,5075,28,1240913830,1240913830,1,1,0
84614046@N00,5076,30,1275452743,1275452743,1,1,0
84614046@N00,5077,16,1276684954,1276684954,1,1,0
84614046@N00,5078,11,1295743606,1295743606,1,1,0
8466254@N03,5079,27,1241226720,1241227380,3,2,660
8466254@N03,5079,28,1241231400,1241231400,1,2,0
8466254@N03,5080,25,1241314260,1241314260,1,2,0
8466254@N03,5080,28,1241311500,1241311500,2,2,0
8466254@N03,5081,11,1249803476,1249803476,1,1,0
8466254@N03,5082,10,1254031778,1254031778,1,1,0
8466254@N03,5083,25,1254288263,1254289822,4,1,1559
8466254@N03,5084,6,1254634416,1254634416,1,1,0
8466254@N03,5085,25,1257312859,1257312859,1,1,0
8466254@N03,5086,10,1257660273,1257661990,10,1,1717
8466254@N03,5087,25,1277881284,1277881396,2,1,112
8466254@N03,5088,3,1281807598,1281807598,1,1,0
84711541@N00,5089,21,846078475,846078475,1,1,0
84711541@N00,5090,21,1004956097,1004956097,1,1,0
84711541@N00,5091,30,1160018333,1160018333,1,1,0
84711541@N00,5092,23,1161527126,1161527126,1,1,0
84711541@N00,5093,25,1194954761,1194954761,1,1,0
84711541@N00,5094,21,1195627842,1195628083,2,1,241
84711541@N00,5095,22,1196409132,1196409132,1,2,0
84711541@N00,5095,28,1196409227,1196409227,1,2,0
84711541@N00,5096,7,1212137303,1212137641,2,1,338
84711541@N00,5097,22,1212476545,1212476625,2,1,80
84711541@N00,5098,21,1213090467,1213090566,2,1,99
84711541@N00,5099,7,1223124539,1223124539,1,5,0
84711541@N00,5099,21,1223128741,1223129941,6,5,1200
84711541@N00,5099,22,1223125386,1223125386,1,5,0
84711541@N00,5099,23,1223127749,1223127911,2,5,162
84711541@N00,5099,30,1223123719,1223123801,2,5,82
84711541@N00,5100,21,1225800754,1225806150,10,1,5396
84711541@N00,5101,21,1252574807,1252582217,17,1,7410
84711541@N00,5102,21,1253357723,1253359780,3,1,2057
84711541@N00,5103,24,1264243027,1264243050,2,1,23
84711541@N00,5104,24,1278667741,1278675769,10,1,8028
84711541@N00,5105,25,1287807182,1287809282,27,1,2100
84711541@N00,5106,21,1293002287,1293002287,1,1,0
84711541@N00,5107,21,1294036308,1294036829,3,1,521
84711541@N00,5108,24,1296898354,1296898354,1,1,0
84711541@N00,5109,6,1307448298,1307448298,1,1,0
84711541@N00,5110,3,1309512364,1309512364,1,1,0
84711541@N00,5111,3,1309675905,1309677272,2,1,1367
84711541@N00,5112,28,1310721365,1310721365,1,1,0
84711541@N00,5113,24,1311219445,1311219445,1,1,0
84711541@N00,5114,21,1311330866,1311334047,2,1,3181
84711541@N00,5115,30,1311419122,1311420025,2,1,903
84711541@N00,5116,22,1314255473,1314256679,2,1,1206
84711541@N00,5117,22,1314311430,1314311430,1,1,0
84711541@N00,5118,25,1316937894,1316937894,1,1,0
84711541@N00,5119,21,1319785388,1319785388,1,2,0
84711541@N00,5119,23,1319807952,1319807952,1,2,0
84711541@N00,5120,21,1321165271,1321165271,1,1,0
84711541@N00,5121,30,1321772311,1321772311,1,1,0
84711541@N00,5122,27,1323771181,1323771181,1,1,0
84711541@N00,5123,28,1323940821,1323940821,1,1,0
84711541@N00,5124,6,1337787133,1337787133,1,1,0
84711541@N00,5125,21,1346817210,1346817210,1,1,0
84711541@N00,5126,24,1348368730,1348368730,1,1,0
84711541@N00,5127,6,1348941263,1348941263,1,2,0
84711541@N00,5127,21,1348922696,1348922696,1,2,0
84711541@N00,5128,24,1372420608,1372421706,2,1,1098
84711541@N00,5129,6,1378886636,1378886636,1,1,0
84711541@N00,5130,21,1393928962,1393928962,1,1,0
84800532@N02,5131,11,1269479610,1269482002,7,1,2392
84800532@N02,5132,11,1323925100,1323925732,8,3,632
84800532@N02,5132,16,1323927970,1323939925,15,3,11955
84800532@N02,5132,22,1323922790,1323922790,1,3,0
84800532@N02,5133,22,1323988865,1323988865,1,1,0
84800532@N02,5134,6,1324088082,1324088082,1,2,0
84800532@N02,5134,11,1324087320,1324087320,1,2,0
84800532@N02,5135,16,1324171680,1324171680,1,1,0
8487221@N05,5136,24,1213520148,1213520148,1,1,0
8487221@N05,5137,16,1214035928,1214035928,1,1,0
8487221@N05,5138,16,1219642542,1219642542,1,1,0
8487221@N05,5139,16,1220004742,1220004742,1,1,0
8487221@N05,5140,2,1223203796,1223203796,1,1,0
8487221@N05,5141,28,1225604875,1225604875,1,1,0
8487221@N05,5142,3,1228544872,1228544872,1,1,0
8487221@N05,5143,24,1244357345,1244357345,1,1,0
8491421@N05,5144,30,1217652761,1217652761,1,1,0
84987970@N00,5145,19,744127200,744127200,5,1,0
84987970@N00,5146,4,775663200,775663200,5,2,0
84987970@N00,5146,16,775663200,775663200,1,2,0
84987970@N00,5147,4,849358800,849358800,3,1,0
84987970@N00,5148,4,867679205,867679209,5,2,4
84987970@N00,5148,24,867679210,867679212,3,2,2
84987970@N00,5149,27,991317600,991317600,1,1,0
84987970@N00,5150,3,1009535749,1009535749,1,1,0
84987970@N00,5151,4,1025478000,1025478006,7,1,6
84987970@N00,5152,4,1025523648,1025523697,2,1,49
84987970@N00,5153,22,1038661200,1038661200,1,1,0
84987970@N00,5154,1,1039690274,1039690274,1,1,0
84987970@N00,5155,1,1040043606,1040043631,26,1,25
84987970@N00,5156,21,1041973490,1041973490,2,1,0
84987970@N00,5157,22,1045141200,1045141203,4,1,3
84987970@N00,5158,22,1045170852,1045170862,49,1,10
84987970@N00,5159,1,1049810400,1049810404,5,1,4
84987970@N00,5160,4,1055858400,1055858408,9,1,8
84987970@N00,5161,1,1057672800,1057672801,2,1,1
84987970@N00,5162,4,1067524183,1067524183,3,1,0
84987970@N00,5163,21,1089836478,1089836478,1,1,0
84987970@N00,5164,17,1126622165,1126622165,1,1,0
84987970@N00,5165,22,1170421200,1170421202,3,1,2
84987970@N00,5166,3,1175349600,1175349600,2,1,0
84987970@N00,5167,27,1177664329,1177664329,1,1,0
84987970@N00,5168,21,1191077280,1191077280,1,2,0
84987970@N00,5168,27,1191097680,1191097680,1,2,0
84987970@N00,5169,11,1199507491,1199507659,11,1,168
84987970@N00,5170,25,1200039025,1200039025,1,1,0
84987970@N00,5171,7,1201601093,1201601199,11,1,106
84987970@N00,5172,1,1202025895,1202036851,11,2,10956
84987970@N00,5172,30,1202038331,1202038351,2,2,20
84987970@N00,5173,3,1202393344,1202393382,3,1,38
84987970@N00,5174,21,1203227508,1203227508,1,1,0
84987970@N00,5175,3,1203563415,1203563424,2,2,9
84987970@N00,5175,21,1203562953,1203562969,2,2,16
84987970@N00,5176,27,1204259173,1204259173,1,1,0
84987970@N00,5177,7,1205819928,1205819928,1,1,0
84987970@N00,5178,21,1206164238,1206164238,1,1,0
84987970@N00,5179,28,1206443512,1206443512,1,1,0
84987970@N00,5180,21,1206780686,1206780987,10,4,301
84987970@N00,5180,22,1206774494,1206781398,25,4,6904
84987970@N00,5180,23,1206780436,1206780626,7,4,190
84987970@N00,5180,28,1206778764,1206778764,1,4,0
84987970@N00,5181,1,1207559333,1207569709,12,1,10376
84987970@N00,5182,11,1208603805,1208603831,4,1,26
84987970@N00,5183,3,1211596279,1211596370,6,4,91
84987970@N00,5183,21,1211596881,1211597256,8,4,375
84987970@N00,5183,22,1211598871,1211598939,5,4,68
84987970@N00,5183,25,1211603730,1211603739,2,4,9
84987970@N00,5184,21,1212402713,1212402850,6,2,137
84987970@N00,5184,22,1212401206,1212401247,2,2,41
84987970@N00,5185,3,1212646675,1212646675,1,1,0
84987970@N00,5186,21,1212729125,1212729125,1,1,0
84987970@N00,5187,3,1213269921,1213269921,1,1,0
84987970@N00,5188,22,1214189203,1214189463,3,1,260
84987970@N00,5189,27,1214231838,1214231838,1,1,0
84987970@N00,5190,3,1214312997,1214312997,1,2,0
84987970@N00,5190,21,1214314747,1214314747,1,2,0
84987970@N00,5191,28,1214557836,1214557836,1,1,0
84987970@N00,5192,3,1214620119,1214639031,15,1,18912
84987970@N00,5193,3,1214726517,1214729031,2,1,2514
84987970@N00,5194,27,1215125612,1215125612,1,1,0
84987970@N00,5195,21,1215603239,1215603239,1,2,0
84987970@N00,5195,22,1215601302,1215601302,1,2,0
84987970@N00,5196,11,1215943187,1215947421,2,2,4234
84987970@N00,5196,27,1215942198,1215942198,1,2,0
84987970@N00,5197,28,1216097323,1216097323,1,1,0
84987970@N00,5198,29,1216391254,1216391254,1,1,0
84987970@N00,5199,23,1216977300,1216977329,3,1,29
84987970@N00,5200,7,1217307181,1217307181,1,2,0
84987970@N00,5200,21,1217334252,1217334252,1,2,0
84987970@N00,5201,11,1217771019,1217771019,1,1,0
84987970@N00,5202,7,1217859777,1217859777,1,2,0
84987970@N00,5202,29,1217842869,1217842869,1,2,0
84987970@N00,5203,21,1218079612,1218079612,1,2,0
84987970@N00,5203,23,1218079201,1218079201,1,2,0
84987970@N00,5204,3,1219282484,1219282484,1,1,0
84987970@N00,5205,3,1219545474,1219545474,1,1,0
84987970@N00,5206,21,1220068174,1220068311,7,1,137
84987970@N00,5207,2,1220153658,1220154293,5,3,635
84987970@N00,5207,4,1220146982,1220147010,3,3,28
84987970@N00,5207,17,1220169253,1220185006,26,3,15753
84987970@N00,5208,11,1220636810,1220636839,4,1,29
84987970@N00,5209,3,1220764330,1220764459,4,2,129
84987970@N00,5209,24,1220766644,1220766644,1,2,0
84987970@N00,5210,21,1220934554,1220934887,3,1,333
84987970@N00,5211,7,1221231682,1221231682,1,1,0
84987970@N00,5212,21,1221528874,1221528874,1,1,0
84987970@N00,5213,6,1222844419,1222844419,1,2,0
84987970@N00,5213,25,1222853552,1222853552,1,2,0
84987970@N00,5214,3,1223142556,1223143079,13,5,523
84987970@N00,5214,7,1223113587,1223118561,5,5,4974
84987970@N00,5214,22,1223138265,1223138280,3,5,15
84987970@N00,5214,23,1223138628,1223138861,4,5,233
84987970@N00,5214,29,1223144860,1223144860,1,5,0
84987970@N00,5215,3,1223617504,1223617504,1,3,0
84987970@N00,5215,21,1223613120,1223613120,1,3,0
84987970@N00,5215,22,1223615166,1223615182,2,3,16
84987970@N00,5216,22,1228529624,1228532748,15,1,3124
84987970@N00,5217,22,1229158347,1229158891,3,1,544
84987970@N00,5218,21,1229520576,1229520576,1,1,0
84987970@N00,5219,24,1229766041,1229773660,6,1,7619
84987970@N00,5220,30,1230383958,1230383958,1,1,0
84987970@N00,5221,23,1231647293,1231647339,4,1,46
84987970@N00,5222,21,1233277109,1233277109,1,1,0
84987970@N00,5223,7,1233533555,1233533561,2,1,6
84987970@N00,5224,21,1234143222,1234143240,2,1,18
84987970@N00,5225,21,1237007232,1237007232,1,1,0
84987970@N00,5226,21,1237554942,1237554942,1,1,0
84987970@N00,5227,21,1238228479,1238228719,3,1,240
84987970@N00,5228,3,1238820478,1238820478,1,3,0
84987970@N00,5228,21,1238821134,1238821622,11,3,488
84987970@N00,5228,23,1238821413,1238830350,5,3,8937
84987970@N00,5229,23,1241089369,1241089375,2,1,6
84987970@N00,5230,11,1241243908,1241244104,2,1,196
84987970@N00,5231,22,1242909513,1242909513,1,1,0
84987970@N00,5232,22,1243140875,1243141721,31,1,846
84987970@N00,5233,4,1243588038,1243588038,1,1,0
84987970@N00,5234,21,1244862723,1244862723,1,1,0
84987970@N00,5235,11,1245564602,1245564602,1,1,0
84987970@N00,5236,25,1245763507,1245763507,1,1,0
84987970@N00,5237,3,1245817077,1245820942,2,3,3865
84987970@N00,5237,22,1245819209,1245819445,4,3,236
84987970@N00,5237,30,1245818604,1245818604,1,3,0
84987970@N00,5238,3,1245997287,1246026882,19,1,29595
84987970@N00,5239,3,1246105030,1246117494,9,1,12464
84987970@N00,5240,3,1246166367,1246200759,14,1,34392
84987970@N00,5241,3,1246663801,1246663801,1,1,0
84987970@N00,5242,11,1247207945,1247207994,3,1,49
84987970@N00,5243,22,1247299268,1247299268,1,1,0
84987970@N00,5244,21,1249525384,1249525384,1,1,0
84987970@N00,5245,21,1250403082,1250403082,1,1,0
84987970@N00,5246,3,1250948094,1250948106,2,1,12
84987970@N00,5247,17,1252120743,1252147943,16,1,27200
84987970@N00,5248,8,1252814030,1252814030,1,1,0
84987970@N00,5249,3,1253245637,1253245683,2,2,46
84987970@N00,5249,21,1253254066,1253254066,1,2,0
84987970@N00,5250,6,1253328010,1253328041,2,6,31
84987970@N00,5250,16,1253331441,1253331458,2,6,17
84987970@N00,5250,21,1253326645,1253326836,10,6,191
84987970@N00,5250,22,1253327159,1253327180,2,6,21
84987970@N00,5250,23,1253326596,1253326596,1,6,0
84987970@N00,5250,30,1253326282,1253326282,1,6,0
84987970@N00,5251,11,1253422383,1253422945,5,1,562
84987970@N00,5252,16,1253781935,1253781935,1,1,0
84987970@N00,5253,1,1254306629,1254309349,2,3,2720
84987970@N00,5253,21,1254284702,1254285695,2,3,993
84987970@N00,5253,23,1254285770,1254285770,1,3,0
84987970@N00,5254,6,1254567690,1254568228,10,7,538
84987970@N00,5254,7,1254591039,1254591117,3,7,78
84987970@N00,5254,21,1254574774,1254575196,10,7,422
84987970@N00,5254,22,1254569894,1254594243,25,7,24349
84987970@N00,5254,23,1254575303,1254597455,16,7,22152
84987970@N00,5254,28,1254570791,1254593810,6,7,23019
84987970@N00,5254,30,1254588278,1254590051,7,7,1773
84987970@N00,5255,1,1259397259,1259409557,2,1,12298
84987970@N00,5256,21,1261039334,1261057208,14,3,17874
84987970@N00,5256,22,1261040174,1261040814,20,3,640
84987970@N00,5256,23,1261041439,1261041439,1,3,0
84987970@N00,5257,24,1261223672,1261223689,4,2,17
84987970@N00,5257,30,1261225449,1261225449,1,2,0
84987970@N00,5258,30,1261610619,1261611075,2,1,456
84987970@N00,5259,3,1263564154,1263564222,2,1,68
84987970@N00,5260,22,1263798260,1263801283,6,1,3023
84987970@N00,5261,21,1264215335,1264224715,31,2,9380
84987970@N00,5261,28,1264221423,1264221665,5,2,242
84987970@N00,5262,28,1265531863,1265531863,1,1,0
84987970@N00,5263,3,1269682283,1269682607,2,7,324
84987970@N00,5263,7,1269684355,1269684514,4,7,159
84987970@N00,5263,21,1269682904,1269683463,23,7,559
84987970@N00,5263,22,1269685295,1269685441,7,7,146
84987970@N00,5263,23,1269683508,1269686133,15,7,2625
84987970@N00,5263,28,1269683896,1269683993,3,7,97
84987970@N00,5263,30,1269684562,1269684619,3,7,57
84987970@N00,5264,7,1269914777,1269914777,1,1,0
84987970@N00,5265,1,1270181209,1270181209,1,1,0
84987970@N00,5266,21,1271473181,1271473181,1,1,0
84987970@N00,5267,22,1271839767,1271842643,2,1,2876
84987970@N00,5268,1,1272090052,1272090052,1,1,0
84987970@N00,5269,27,1273399310,1273399627,3,1,317
84987970@N00,5270,28,1273901668,1273901668,1,1,0
84987970@N00,5271,21,1274478151,1274478151,1,1,0
84987970@N00,5272,11,1274594992,1274594992,1,2,0
84987970@N00,5272,27,1274594739,1274594784,5,2,45
84987970@N00,5273,21,1275114358,1275123446,10,2,9088
84987970@N00,5273,22,1275112838,1275113103,4,2,265
84987970@N00,5274,27,1275217263,1275217263,1,1,0
84987970@N00,5275,22,1275633421,1275633430,2,1,9
84987970@N00,5276,4,1276778287,1276778582,7,6,295
84987970@N00,5276,6,1276776771,1276776771,1,6,0
84987970@N00,5276,7,1276780170,1276780236,4,6,66
84987970@N00,5276,21,1276782669,1276782669,1,6,0
84987970@N00,5276,28,1276780584,1276780584,1,6,0
84987970@N00,5276,30,1276779560,1276780096,9,6,536
84987970@N00,5277,21,1277534230,1277552569,6,6,18339
84987970@N00,5277,22,1277531599,1277531742,6,6,143
84987970@N00,5277,23,1277533721,1277552409,12,6,18688
84987970@N00,5277,27,1277549048,1277549256,4,6,208
84987970@N00,5277,28,1277531902,1277552040,11,6,20138
84987970@N00,5277,29,1277525391,1277546806,31,6,21415
84987970@N00,5278,6,1277631300,1277631300,1,4,0
84987970@N00,5278,21,1277618533,1277618594,4,4,61
84987970@N00,5278,23,1277618969,1277620676,3,4,1707
84987970@N00,5278,28,1277620820,1277621015,4,4,195
84987970@N00,5279,22,1277690641,1277692066,13,1,1425
84987970@N00,5280,3,1277774156,1277774156,1,1,0
84987970@N00,5281,24,1277806536,1277811031,9,1,4495
84987970@N00,5282,11,1277992573,1277992573,1,4,0
84987970@N00,5282,22,1277966029,1277966044,2,4,15
84987970@N00,5282,24,1277979535,1277982557,4,4,3022
84987970@N00,5282,29,1277969307,1277973921,37,4,4614
84987970@N00,5283,3,1278585103,1278585103,1,1,0
84987970@N00,5284,16,1278740236,1278742341,28,2,2105
84987970@N00,5284,29,1278731610,1278735659,40,2,4049
84987970@N00,5285,3,1278851441,1278851441,1,1,0
84987970@N00,5286,21,1279196200,1279196200,1,1,0
84987970@N00,5287,21,1279438973,1279438973,1,3,0
84987970@N00,5287,22,1279436043,1279436043,1,3,0
84987970@N00,5287,28,1279423474,1279423474,1,3,0
84987970@N00,5288,3,1279512355,1279512391,4,1,36
84987970@N00,5289,7,1279546719,1279546864,4,2,145
84987970@N00,5289,16,1279545899,1279545899,1,2,0
84987970@N00,5290,22,1279867066,1279867066,1,1,0
84987970@N00,5291,3,1279953419,1279953419,1,1,0
84987970@N00,5292,22,1280126588,1280127744,24,1,1156
84987970@N00,5293,22,1280990049,1280990195,3,1,146
84987970@N00,5294,2,1282270565,1282273951,7,3,3386
84987970@N00,5294,14,1282288830,1282288830,1,3,0
84987970@N00,5294,17,1282277120,1282304938,58,3,27818
84987970@N00,5295,3,1283424598,1283424598,1,1,0
84987970@N00,5296,28,1284043248,1284043248,1,1,0
84987970@N00,5297,22,1284439128,1284439158,3,1,30
84987970@N00,5298,3,1284868390,1284875860,9,1,7470
84987970@N00,5299,3,1285574161,1285576243,3,1,2082
84987970@N00,5300,8,1285667429,1285668481,2,1,1052
84987970@N00,5301,7,1286022803,1286024161,13,4,1358
84987970@N00,5301,22,1286028910,1286028971,6,4,61
84987970@N00,5301,28,1286025764,1286027818,6,4,2054
84987970@N00,5301,30,1286048088,1286048088,1,4,0
84987970@N00,5302,21,1286152247,1286152247,1,1,0
84987970@N00,5303,3,1286237838,1286237838,1,1,0
84987970@N00,5304,3,1307367861,1307367861,1,1,0
84987970@N00,5305,3,1307424191,1307424191,1,1,0
84987970@N00,5306,1,1307524314,1307538142,7,1,13828
84987970@N00,5307,22,1308567845,1308567845,1,1,0
84987970@N00,5308,1,1308643886,1308643886,1,1,0
84987970@N00,5309,22,1308794547,1308794547,1,1,0
84987970@N00,5310,7,1308878350,1308878350,1,1,0
84987970@N00,5311,11,1308916848,1308916848,1,1,0
84987970@N00,5312,29,1308977171,1308980591,6,1,3420
84987970@N00,5313,29,1309054581,1309056925,3,1,2344
84987970@N00,5314,22,1309140363,1309141878,16,1,1515
84987970@N00,5315,3,1309393968,1309393968,1,1,0
84987970@N00,5316,3,1309515598,1309519710,3,1,4112
84987970@N00,5317,22,1310092336,1310092344,2,1,8
84987970@N00,5318,3,1310382290,1310382300,2,1,10
84987970@N00,5319,3,1325551849,1325551857,2,1,8
84987970@N00,5320,21,1325639251,1325639251,1,2,0
84987970@N00,5320,23,1325638458,1325638458,1,2,0
84987970@N00,5321,24,1340276443,1340276609,5,1,166
84987970@N00,5322,3,1340432789,1340432789,1,1,0
84987970@N00,5323,23,1340524531,1340524531,1,2,0
84987970@N00,5323,28,1340524540,1340524872,2,2,332
84987970@N00,5324,3,1340624101,1340624301,3,4,200
84987970@N00,5324,22,1340588348,1340622015,13,4,33667
84987970@N00,5324,23,1340622719,1340622719,1,4,0
84987970@N00,5324,28,1340622393,1340622602,3,4,209
84987970@N00,5325,15,1340765154,1340765154,1,3,0
84987970@N00,5325,19,1340767378,1340767378,1,3,0
84987970@N00,5325,24,1340757580,1340757580,1,3,0
84987970@N00,5326,3,1340965772,1340972247,4,1,6475
84987970@N00,5327,22,1341552351,1341556247,5,2,3896
84987970@N00,5327,28,1341556433,1341556433,1,2,0
84987970@N00,5328,21,1342845159,1342846009,3,3,850
84987970@N00,5328,22,1342841730,1342843315,2,3,1585
84987970@N00,5328,23,1342827420,1342841600,4,3,14180
84987970@N00,5329,30,1351477800,1351477800,1,1,0
84987970@N00,5330,16,1351645896,1351645896,1,1,0
84987970@N00,5331,25,1351744541,1351744547,2,1,6
84987970@N00,5332,6,1352001405,1352001405,1,2,0
84987970@N00,5332,7,1351997933,1351997933,1,2,0
84987970@N00,5333,30,1352073024,1352073024,1,1,0
84987970@N00,5334,30,1371199026,1371199026,1,1,0
84987970@N00,5335,22,1371367095,1371368590,8,1,1495
84987970@N00,5336,28,1371970526,1371970526,1,1,0
84987970@N00,5337,3,1372074604,1372075223,2,5,619
84987970@N00,5337,21,1372046561,1372076700,3,5,30139
84987970@N00,5337,22,1372039382,1372080214,15,5,40832
84987970@N00,5337,23,1372077067,1372077067,1,5,0
84987970@N00,5337,28,1372077505,1372080838,2,5,3333
84987970@N00,5338,3,1372167860,1372167860,1,1,0
84987970@N00,5339,3,1372416302,1372416655,2,1,353
84987970@N00,5340,24,1373099515,1373099515,1,1,0
84987970@N00,5341,22,1373173810,1373173818,2,1,8
84987970@N00,5342,1,1383022313,1383022313,1,2,0
84987970@N00,5342,30,1383022320,1383022320,1,2,0
84987970@N00,5343,21,1383281621,1383281621,1,3,0
84987970@N00,5343,22,1383276435,1383276582,5,3,147
84987970@N00,5343,30,1383278502,1383278502,1,3,0
8509783@N03,5344,11,1220283079,1220283079,1,1,0
8509783@N03,5345,23,1220383658,1220383658,1,1,0
8509783@N03,5346,22,1313952959,1313957662,7,1,4703
85173164@N00,5347,24,1094879194,1094879194,1,1,0
85173164@N00,5348,16,1189238452,1189238452,1,2,0
85173164@N00,5348,24,1189234333,1189237377,2,2,3044
85213921@N04,5349,8,1378693245,1378693245,1,2,0
85213921@N04,5349,16,1378691175,1378692566,2,2,1391
85213921@N04,5350,24,1378784668,1378785203,2,1,535
85234674@N02,5351,21,1342188008,1342188008,1,1,0
85313983@N00,5352,28,1147991620,1147991620,1,1,0
85313983@N00,5353,7,1159875682,1159875682,1,1,0
85313983@N00,5354,30,1227404693,1227404693,1,1,0
85318305@N00,5355,28,1279796134,1279796134,1,1,0
85397023@N00,5356,25,1307787941,1307787941,1,1,0
85397023@N00,5357,24,1343380962,1343380962,1,1,0
85397023@N00,5358,25,1346552046,1346552046,1,1,0
85397023@N00,5359,28,1348457354,1348457354,1,1,0
85397023@N00,5360,24,1349488438,1349489361,2,1,923
85397023@N00,5361,24,1349673649,1349673649,1,1,0
85397023@N00,5362,11,1350634238,1350634238,1,1,0
85632980@N00,5363,30,1275988250,1275988250,1,1,0
85644838@N00,5364,8,1369546087,1369546087,1,1,0
85724483@N00,5365,1,1384690280,1384690280,1,1,0
85724483@N00,5366,22,1386150626,1386150626,1,1,0
85724483@N00,5367,1,1387189115,1387189115,1,1,0
85777547@N00,5368,11,1376145435,1376145523,2,1,88
85801042@N00,5369,3,1223095496,1223095496,1,8,0
85801042@N00,5369,4,1223108006,1223108006,1,8,0
85801042@N00,5369,7,1223091139,1223093611,15,8,2472
85801042@N00,5369,8,1223108073,1223108073,1,8,0
85801042@N00,5369,16,1223109799,1223111670,14,8,1871
85801042@N00,5369,21,1223095289,1223095289,1,8,0
85801042@N00,5369,23,1223095183,1223095192,2,8,9
85801042@N00,5369,28,1223094654,1223094725,2,8,71
85801042@N00,5370,11,1223169743,1223169753,2,2,10
85801042@N00,5370,13,1223169031,1223169346,3,2,315
85827196@N00,5371,25,1364634612,1364634612,1,1,0
86095634@N00,5372,26,1158646634,1158646674,5,1,40
86266489@N00,5373,27,1345688649,1345688649,1,1,0
86266489@N00,5374,27,1348540844,1348540844,1,1,0
86266489@N00,5375,23,1348920693,1348920693,1,1,0
86266489@N00,5376,26,1353801194,1353801194,1,1,0
86292040@N00,5377,1,1358647147,1358647147,1,5,0
86292040@N00,5377,8,1358647476,1358648574,3,5,1098
86292040@N00,5377,16,1358648369,1358648369,1,5,0
86292040@N00,5377,23,1358655192,1358655192,1,5,0
86292040@N00,5377,30,1358646929,1358646929,1,5,0
86292040@N00,5378,22,1359091905,1359091905,1,1,0
86292040@N00,5379,22,1359123108,1359123168,2,1,60
86292040@N00,5380,22,1359176505,1359176532,2,1,27
86335404@N00,5381,9,1144298666,1144298666,1,1,0
86358560@N00,5382,16,1157167101,1157167101,1,1,0
8637262@N02,5383,8,1277371122,1277371122,1,1,0
86427212@N00,5384,16,1344078244,1344078244,1,1,0
8643216@N02,5385,21,1310284000,1310284000,1,1,0
86485258@N07,5386,23,1350796447,1350799550,46,1,3103
86564087@N00,5387,16,1243997281,1243997281,1,1,0
86725178@N00,5388,7,1191551199,1191551199,1,1,0
86725178@N00,5389,8,1192158446,1192158446,1,1,0
86814251@N00,5390,16,1176506370,1176508562,5,2,2192
86814251@N00,5390,28,1176514664,1176514664,1,2,0
86822950@N03,5391,4,1336983669,1336998749,20,1,15080
86822950@N03,5392,4,1337072433,1337077506,5,1,5073
86822950@N03,5393,4,1337157065,1337169946,18,1,12881
86822950@N03,5394,4,1337248831,1337255368,5,1,6537
86822950@N03,5395,4,1337331162,1337342792,60,1,11630
86822950@N03,5396,4,1337395772,1337405120,24,1,9348
86822950@N03,5397,4,1337436000,1337436000,1,1,0
86822950@N03,5398,4,1337475256,1337510662,12,1,35406
86822950@N03,5399,4,1337604885,1337604885,1,1,0
86822950@N03,5400,4,1337843783,1337843783,1,1,0
86822950@N03,5401,4,1338196307,1338222126,11,1,25819
86822950@N03,5402,4,1338300050,1338301943,4,1,1893
86822950@N03,5403,4,1338372794,1338389123,17,1,16329
86822950@N03,5404,4,1338541884,1338549323,2,1,7439
86822950@N03,5405,4,1338610077,1338613694,2,1,3617
86822950@N03,5406,4,1338709818,1338713837,11,1,4019
86822950@N03,5407,4,1338883292,1338883292,1,1,0
86822950@N03,5408,4,1339420384,1339423897,10,1,3513
86822950@N03,5409,4,1339495205,1339515094,7,1,19889
86822950@N03,5410,4,1339554549,1339578960,12,1,24411
86822950@N03,5411,4,1339768057,1339769824,9,1,1767
86822950@N03,5412,4,1339837666,1339840195,47,1,2529
86822950@N03,5413,4,1339897080,1339924464,167,1,27384
86822950@N03,5414,4,1340874413,1340897636,7,1,23223
86822950@N03,5415,4,1340960419,1340971732,4,1,11313
86822950@N03,5416,4,1341032020,1341039523,10,1,7503
86822950@N03,5417,4,1341118937,1341157942,43,1,39005
86822950@N03,5418,4,1341233763,1341235094,4,1,1331
86822950@N03,5419,4,1341319826,1341323429,5,1,3603
86822950@N03,5420,4,1341399677,1341409033,5,1,9356
86822950@N03,5421,4,1341487308,1341491425,3,1,4117
86822950@N03,5422,4,1342253574,1342264734,22,1,11160
86822950@N03,5423,4,1342331201,1342341757,14,1,10556
86822950@N03,5424,4,1343120997,1343139091,24,1,18094
86822950@N03,5425,4,1343222716,1343222716,1,1,0
86822950@N03,5426,4,1343272440,1343324043,10,1,51603
86822950@N03,5427,4,1343383388,1343400406,39,1,17018
86822950@N03,5428,4,1343445151,1343472429,42,1,27278
86822950@N03,5429,4,1343525147,1343546830,14,1,21683
86822950@N03,5430,4,1343660796,1343660796,1,1,0
86822950@N03,5431,4,1344599057,1344605199,6,1,6142
86822950@N03,5432,4,1344664236,1344671658,3,1,7422
86822950@N03,5433,4,1344743294,1344770176,42,1,26882
86822950@N03,5434,4,1344863482,1344865253,18,1,1771
86822950@N03,5435,4,1344937322,1344950117,29,1,12795
86822950@N03,5436,4,1345027661,1345035817,9,1,8156
86822950@N03,5437,4,1345108269,1345129866,14,1,21597
86822950@N03,5438,4,1345202411,1345214187,47,1,11776
86822950@N03,5439,4,1345261874,1345274469,26,1,12595
86822950@N03,5440,4,1345345134,1345363143,34,1,18009
86822950@N03,5441,4,1346317037,1346327488,27,1,10451
86822950@N03,5442,4,1346403981,1346413330,49,1,9349
86822950@N03,5443,4,1346464594,1346492718,34,1,28124
86822950@N03,5444,4,1346553983,1346566301,35,1,12318
86822950@N03,5445,4,1346637953,1346651769,19,1,13816
86822950@N03,5446,4,1346749212,1346758282,5,1,9070
86822950@N03,5447,4,1346836141,1346846401,20,1,10260
86822950@N03,5448,4,1347265303,1347270821,2,1,5518
86822950@N03,5449,4,1347350447,1347364617,38,1,14170
86822950@N03,5450,4,1347436456,1347451765,24,1,15309
86822950@N03,5451,4,1347522738,1347537308,26,1,14570
86822950@N03,5452,4,1347604602,1347625501,27,1,20899
86822950@N03,5453,4,1347678461,1347692566,21,1,14105
86822950@N03,5454,4,1347758110,1347774942,23,1,16832
86822950@N03,5455,4,1348736407,1348755265,18,1,18858
86822950@N03,5456,4,1348824164,1348834114,8,1,9950
86822950@N03,5457,4,1348885114,1348898975,22,1,13861
86822950@N03,5458,4,1348968908,1348981282,14,1,12374
86822950@N03,5459,4,1349080984,1349094498,24,1,13514
86822950@N03,5460,4,1349164717,1349178474,44,1,13757
8684258@N02,5461,11,1181379526,1181380240,4,1,714
86993416@N00,5462,7,1332050378,1332050378,1,1,0
86993416@N00,5463,13,1364430889,1364439806,4,1,8917
86993416@N00,5464,24,1371886124,1371887844,2,1,1720
8702301@N06,5465,7,1276955826,1276955826,1,1,0
8706861@N08,5466,25,1359244387,1359244387,1,1,0
87085448@N00,5467,6,1271482920,1271483559,3,1,639
87106004@N00,5468,7,1177930283,1177930283,1,1,0
87106004@N00,5469,16,1182344112,1182344112,1,1,0
87106106@N00,5470,24,1250759531,1250761898,5,1,2367
87126425@N00,5471,27,1157796054,1157796054,1,1,0
87126425@N00,5472,27,1213179949,1213179949,1,1,0
87126425@N00,5473,25,1226707403,1226707403,1,1,0
87164784@N00,5474,16,1364531302,1364553252,4,1,21950
87473264@N00,5475,13,1177387641,1177388992,2,3,1351
87473264@N00,5475,16,1177410847,1177410847,1,3,0
87473264@N00,5475,24,1177399003,1177400357,2,3,1354
87473264@N00,5476,13,1179055645,1179055645,1,1,0
87473264@N00,5477,13,1179154971,1179154971,1,1,0
87473264@N00,5478,13,1179233266,1179233266,1,1,0
87473264@N00,5479,13,1179309868,1179309868,1,1,0
87473264@N00,5480,13,1179410656,1179410656,1,1,0
87473264@N00,5481,16,1180016303,1180016303,1,1,0
87473264@N00,5482,24,1180107745,1180107745,1,1,0
87533529@N00,5483,4,1123116689,1123116689,1,1,0
87533529@N00,5484,4,1123206809,1123244057,139,1,37248
87533529@N00,5485,4,1123313258,1123313298,3,1,40
87825431@N00,5486,11,1220065088,1220065088,1,1,0
87857621@N00,5487,16,1042849623,1042849623,1,1,0
87963908@N00,5488,23,1255734456,1255734456,1,1,0
87964435@N04,5489,16,1332205227,1332212420,4,1,7193
88041054@N00,5490,4,1314422793,1314422793,1,1,0
88105592@N00,5491,30,1220334119,1220334387,2,1,268
88105592@N00,5492,16,1295607377,1295608903,3,1,1526
8815250@N02,5493,1,1043396031,1043402055,3,1,6024
8815250@N02,5494,1,1089100770,1089100770,1,1,0
8815250@N02,5495,1,1301220725,1301220725,1,1,0
88276719@N00,5496,23,1169010000,1169010000,1,1,0
88276719@N00,5497,7,1169172000,1169172000,1,3,0
88276719@N00,5497,16,1169172000,1169172000,1,3,0
88276719@N00,5497,30,1169172000,1169172000,1,3,0
88276719@N00,5498,16,1169352037,1169352037,1,1,0
88307048@N06,5499,13,1338358312,1338359364,3,1,1052
88379351@N00,5500,23,1387762386,1387762386,1,1,0
88943473@N00,5501,7,1346925978,1346925978,1,1,0
88943473@N00,5502,16,1347161073,1347175820,13,1,14747
88943473@N00,5503,16,1347329063,1347329063,1,1,0
88943473@N00,5504,16,1347426666,1347426666,1,1,0
88943473@N00,5505,16,1347497110,1347504280,3,1,7170
88943473@N00,5506,16,1347575688,1347622075,7,1,46387
88943473@N00,5507,22,1364076547,1364076547,1,1,0
88943473@N00,5508,21,1390273786,1390273860,2,1,74
88982631@N00,5509,21,1146127342,1146127342,1,1,0
88982631@N00,5510,28,1167472315,1167472315,1,1,0
88982631@N00,5511,21,1186393622,1186398155,4,1,4533
89093444@N00,5512,13,1176866275,1176871697,80,1,5422
89285199@N00,5513,21,1307440170,1307440170,1,1,0
89285199@N00,5514,7,1308304943,1308304943,1,1,0
89285199@N00,5515,11,1335515122,1335515122,1,2,0
89285199@N00,5515,27,1335514850,1335514850,1,2,0
89285199@N00,5516,21,1343470635,1343473556,3,1,2921
89309115@N00,5517,16,1276804534,1276804534,1,1,0
89309115@N00,5518,6,1277391538,1277391538,1,1,0
8938019@N02,5519,29,1349889322,1349889322,1,1,0
89461633@N00,5520,24,1358204177,1358214975,3,1,10798
89461633@N00,5521,22,1358321895,1358321895,1,1,0
89466786@N00,5522,21,1153829587,1153831471,2,1,1884
89466786@N00,5523,25,1155448645,1155448645,1,1,0
89466786@N00,5524,25,1156418392,1156419108,6,1,716
89466786@N00,5525,23,1347097850,1347098479,2,1,629
89466786@N00,5526,20,1367730005,1367730005,1,1,0
89466786@N00,5527,9,1371474879,1371475738,7,1,859
89504146@N00,5528,24,1219545452,1219545516,2,1,64
89504146@N00,5529,4,1338368831,1338377635,85,1,8804
89613559@N07,5530,7,1380068609,1380069181,3,3,572
89613559@N07,5530,8,1380073430,1380074896,9,3,1466
89613559@N07,5530,16,1380069630,1380079012,11,3,9382
89958805@N00,5531,7,1256815109,1256815109,1,1,0
89958805@N00,5532,6,1359194646,1359197008,2,1,2362
89958805@N00,5533,8,1359274798,1359274798,1,1,0
89958805@N00,5534,16,1359424453,1359424453,1,1,0
89958805@N00,5535,16,1359701443,1359701443,1,1,0
90044280@N00,5536,16,1118744361,1118744361,1,1,0
9012248@N07,5537,8,1234762320,1234762320,1,1,0
9025385@N07,5538,8,1332311054,1332311054,1,2,0
9025385@N07,5538,30,1332306760,1332317057,3,2,10297
9025385@N07,5539,7,1332405438,1332405438,1,4,0
9025385@N07,5539,16,1332415181,1332415181,1,4,0
9025385@N07,5539,24,1332408454,1332408454,1,4,0
9025385@N07,5539,30,1332366421,1332386638,2,4,20217
9025385@N07,5540,1,1332466147,1332466147,1,2,0
9025385@N07,5540,30,1332457103,1332485512,6,2,28409
9025385@N07,5541,1,1332568849,1332569159,2,5,310
9025385@N07,5541,4,1332558058,1332558173,2,5,115
9025385@N07,5541,7,1332582801,1332582801,1,5,0
9025385@N07,5541,16,1332557408,1332570187,3,5,12779
9025385@N07,5541,30,1332553071,1332575116,4,5,22045
90358960@N00,5542,22,1145197390,1145197390,1,1,0
90415862@N00,5543,12,1160872948,1160872948,1,1,0
90425990@N00,5544,16,1191315973,1191318605,3,1,2632
9050799@N06,5545,23,1220532240,1220532240,1,2,0
9050799@N06,5545,28,1220519700,1220519700,1,2,0
9050799@N06,5546,30,1221206100,1221206190,4,1,90
9050799@N06,5547,8,1345878913,1345889296,21,1,10383
9050799@N06,5548,30,1394434810,1394434810,1,1,0
90618151@N00,5549,23,1316176151,1316176151,1,1,0
90618151@N00,5550,23,1316208963,1316208963,1,1,0
90678392@N00,5551,4,1316317896,1316323494,6,1,5598
90721168@N00,5552,7,1254224782,1254232796,3,1,8014
90818051@N00,5553,8,1157209195,1157209195,1,2,0
90818051@N00,5553,16,1157209185,1157209224,3,2,39
90941661@N00,5554,16,1248176794,1248176794,1,1,0
91008793@N00,5555,4,1253081663,1253082899,8,5,1236
91008793@N00,5555,6,1253061221,1253071763,45,5,10542
91008793@N00,5555,8,1253083001,1253083017,2,5,16
91008793@N00,5555,11,1253073331,1253073342,2,5,11
91008793@N00,5555,16,1253068676,1253084688,11,5,16012
91032493@N00,5556,7,1357973355,1357973355,1,5,0
91032493@N00,5556,16,1357970666,1357972533,3,5,1867
91032493@N00,5556,22,1357967353,1357967741,5,5,388
91032493@N00,5556,28,1357966579,1357966671,2,5,92
91032493@N00,5556,30,1357973053,1357973053,1,5,0
91032493@N00,5557,28,1360277502,1360277502,1,1,0
91032493@N00,5558,3,1360382277,1360384391,7,1,2114
91032493@N00,5559,27,1361674488,1361676085,7,1,1597
91032493@N00,5560,8,1362889646,1362889646,1,1,0
91032493@N00,5561,21,1364697508,1364697508,1,1,0
91032493@N00,5562,21,1365305719,1365305732,2,1,13
91032493@N00,5563,22,1371539886,1371540056,7,1,170
91032493@N00,5564,23,1375610365,1375610844,3,1,479
91032493@N00,5565,22,1376614916,1376614939,2,1,23
91032493@N00,5566,21,1378201884,1378201884,1,1,0
91032493@N00,5567,11,1380154972,1380156498,9,1,1526
91032493@N00,5568,6,1383967292,1383967292,1,1,0
91032493@N00,5569,22,1390947660,1390947660,1,1,0
91056830@N00,5570,23,1321332051,1321332051,1,1,0
91056830@N00,5571,25,1331962879,1331962879,1,1,0
91056830@N00,5572,21,1388035161,1388035161,1,1,0
91082225@N00,5573,22,1217916459,1217962577,59,1,46118
91082225@N00,5574,22,1217993225,1218197010,163,1,203785
91255327@N00,5575,3,1223106125,1223106221,2,4,96
91255327@N00,5575,6,1223117256,1223117256,1,4,0
91255327@N00,5575,21,1223113404,1223113649,3,4,245
91255327@N00,5575,22,1223114706,1223114726,2,4,20
91312924@N00,5576,4,1145425642,1145425642,1,1,0
91312924@N00,5577,21,1305545321,1305545501,2,1,180
91387326@N00,5578,3,1041382809,1041382809,1,1,0
91387326@N00,5579,7,1233404115,1233404115,1,1,0
91387326@N00,5580,3,1235783642,1235783642,1,1,0
91387326@N00,5581,10,1236922841,1236922841,1,1,0
91387326@N00,5582,10,1237014883,1237014883,1,1,0
91387326@N00,5583,3,1237435405,1237437702,10,1,2297
91387326@N00,5584,10,1240381760,1240382645,5,1,885
91387326@N00,5585,10,1240814179,1240822145,10,1,7966
91387326@N00,5586,10,1241270856,1241295640,2,1,24784
91387326@N00,5587,10,1246434167,1246436670,4,1,2503
91387326@N00,5588,10,1249365117,1249365117,1,1,0
91387326@N00,5589,10,1269842864,1269842864,1,1,0
91387326@N00,5590,10,1270276987,1270276987,1,1,0
91387326@N00,5591,10,1270653625,1270653625,1,1,0
91387326@N00,5592,22,1285051179,1285051179,1,1,0
91387326@N00,5593,22,1287450797,1287450797,1,1,0
91387326@N00,5594,3,1288665688,1288669260,6,1,3572
91387326@N00,5595,10,1295328225,1295328225,1,1,0
91387326@N00,5596,3,1301017583,1301017583,1,1,0
91387326@N00,5597,6,1301643962,1301644064,3,2,102
91387326@N00,5597,25,1301642113,1301642113,1,2,0
91387326@N00,5598,10,1304659207,1304659207,1,1,0
91387326@N00,5599,3,1309519395,1309519415,2,1,20
91387326@N00,5600,3,1309590612,1309595403,16,1,4791
91387326@N00,5601,3,1309669746,1309669990,2,1,244
91387326@N00,5602,10,1311925577,1311925580,2,1,3
91387326@N00,5603,10,1312782307,1312782307,1,1,0
91387326@N00,5604,22,1312881722,1312881722,1,1,0
91387326@N00,5605,10,1314424747,1314428355,12,1,3608
91387326@N00,5606,22,1317022774,1317026713,23,1,3939
91387326@N00,5607,10,1317110211,1317110724,2,1,513
91387326@N00,5608,10,1323584482,1323584482,1,1,0
91387326@N00,5609,10,1332395819,1332395819,1,1,0
91387326@N00,5610,10,1333699142,1333699455,3,1,313
91387326@N00,5611,3,1341124398,1341124398,1,1,0
91387326@N00,5612,10,1344072372,1344072372,1,1,0
91387326@N00,5613,22,1347382219,1347382219,1,1,0
91387326@N00,5614,10,1350362440,1350362440,1,1,0
91387326@N00,5615,10,1351139185,1351140048,6,1,863
91387326@N00,5616,22,1353935274,1353938887,4,1,3613
91387326@N00,5617,10,1364017149,1364018472,6,1,1323
91387326@N00,5618,22,1368882627,1368882627,1,1,0
91396833@N00,5619,30,1264984099,1264984099,1,1,0
91545223@N00,5620,22,1236325380,1236325380,1,1,0
91545223@N00,5621,29,1277776755,1277776755,1,1,0
91545223@N00,5622,22,1328341743,1328341743,1,1,0
91575892@N00,5623,16,1304573632,1304575313,2,1,1681
91575892@N00,5624,11,1304668630,1304668907,2,1,277
9161595@N03,5625,6,1094352421,1094352427,2,4,6
9161595@N03,5625,16,1094374877,1094379382,14,4,4505
9161595@N03,5625,21,1094351244,1094351244,1,4,0
9161595@N03,5625,22,1094342144,1094348591,7,4,6447
9161595@N03,5626,16,1094426118,1094426118,1,2,0
9161595@N03,5626,28,1094423468,1094423477,2,2,9
9161595@N03,5627,22,1220564894,1220564899,2,1,5
91642841@N00,5628,16,1153898722,1153898722,1,1,0
91855519@N00,5629,12,1209775644,1209778757,8,1,3113
92078278@N07,5630,29,1358141373,1358141373,1,1,0
92155161@N00,5631,11,1312338014,1312345421,2,1,7407
92176602@N05,5632,28,1364559905,1364559905,1,1,0
9225942@N03,5633,25,1331694690,1331694690,1,1,0
9225942@N03,5634,1,1334129079,1334129079,1,1,0
9225942@N03,5635,8,1390553519,1390553596,2,1,77
92354342@N00,5636,16,1184818892,1184822878,24,1,3986
92354342@N00,5637,16,1184900103,1184900228,5,1,125
92431035@N00,5638,13,1188513463,1188518951,28,2,5488
92431035@N00,5638,16,1188521245,1188525335,20,2,4090
92431035@N00,5639,16,1204872098,1204886425,26,1,14327
92487715@N03,5640,7,1278907200,1278907200,1,3,0
92487715@N03,5640,16,1278932785,1278934283,3,3,1498
92487715@N03,5640,22,1278909600,1278928210,3,3,18610
92487715@N03,5641,9,1278988150,1278988150,1,2,0
92487715@N03,5641,22,1278984397,1278984397,1,2,0
92487715@N03,5642,16,1279073370,1279077130,14,2,3760
92487715@N03,5642,22,1279071063,1279079117,3,2,8054
92487715@N03,5643,22,1285923076,1285923076,1,1,0
92487715@N03,5644,16,1350295754,1350295813,2,1,59
92607898@N00,5645,16,1305210091,1305221164,3,1,11073
92607898@N00,5646,13,1305354215,1305354965,5,1,750
93159879@N00,5647,29,1354006587,1354017544,2,1,10957
93241698@N00,5648,22,1215151607,1215151874,3,3,267
93241698@N00,5648,23,1215152712,1215152712,1,3,0
93241698@N00,5648,28,1215151983,1215152163,3,3,180
93241698@N00,5649,16,1215765490,1215767259,19,3,1769
93241698@N00,5649,22,1215758101,1215758101,1,3,0
93241698@N00,5649,23,1215752340,1215752352,2,3,12
9324295@N06,5650,21,1245147652,1245147652,1,1,0
9324295@N06,5651,21,1324268503,1324268503,1,1,0
93243688@N00,5652,6,1370301116,1370303864,3,2,2748
93243688@N00,5652,24,1370314709,1370314709,1,2,0
93352468@N00,5653,24,1214462608,1214462608,1,1,0
9341347@N06,5654,25,1367721954,1367721954,1,1,0
93507286@N00,5655,23,1345957585,1345957585,1,1,0
93507286@N00,5656,11,1357532021,1357534224,3,1,2203
93645046@N00,5657,27,1110519429,1110519429,1,1,0
93645046@N00,5658,11,1125825644,1125825644,1,1,0
93645046@N00,5659,11,1126151787,1126151787,1,1,0
93645046@N00,5660,11,1126429291,1126429291,1,1,0
93645046@N00,5661,11,1126933661,1126933661,1,1,0
93645046@N00,5662,11,1129204835,1129206992,3,1,2157
93645046@N00,5663,11,1129365871,1129365936,2,1,65
93645046@N00,5664,11,1129642835,1129642835,1,1,0
93645046@N00,5665,11,1131782244,1131782827,2,1,583
93645046@N00,5666,11,1132291182,1132291182,1,1,0
93645046@N00,5667,11,1132458800,1132458800,1,1,0
93645046@N00,5668,11,1132488801,1132488806,2,1,5
93645046@N00,5669,11,1133255743,1133256432,3,1,689
93645046@N00,5670,11,1137562358,1137562358,1,1,0
93645046@N00,5671,11,1138599195,1138613719,7,1,14524
93645046@N00,5672,11,1138700372,1138700372,1,1,0
93645046@N00,5673,11,1139383223,1139383223,1,1,0
93645046@N00,5674,11,1139722137,1139736404,2,1,14267
93645046@N00,5675,11,1141348657,1141348657,1,1,0
93645046@N00,5676,11,1142573504,1142573504,1,1,0
93645046@N00,5677,11,1143523987,1143523987,1,1,0
93645046@N00,5678,11,1143703162,1143703495,5,1,333
93645046@N00,5679,11,1143781575,1143781642,2,1,67
93645046@N00,5680,11,1144487399,1144487399,1,1,0
93645046@N00,5681,11,1146724881,1146725053,6,1,172
93645046@N00,5682,11,1147329174,1147329174,1,1,0
93645046@N00,5683,11,1147489383,1147489383,1,2,0
93645046@N00,5683,27,1147492394,1147529270,10,2,36876
93645046@N00,5684,11,1148986858,1148986858,1,1,0
93645046@N00,5685,27,1149645700,1149646382,4,1,682
93645046@N00,5686,27,1149829894,1149829894,1,1,0
93645046@N00,5687,11,1150449424,1150449424,1,1,0
93645046@N00,5688,23,1152273988,1152275721,10,1,1733
93645046@N00,5689,11,1154052779,1154052779,1,1,0
93645046@N00,5690,11,1154427908,1154431548,8,1,3640
93645046@N00,5691,30,1154769129,1154770795,4,1,1666
93645046@N00,5692,30,1154852301,1154853865,2,1,1564
93645046@N00,5693,22,1155025871,1155029302,2,2,3431
93645046@N00,5693,28,1155028116,1155033023,5,2,4907
93645046@N00,5694,21,1155103105,1155108098,5,2,4993
93645046@N00,5694,23,1155105248,1155105248,1,2,0
93645046@N00,5695,11,1155355351,1155355746,3,1,395
93645046@N00,5696,11,1155618691,1155627201,2,1,8510
93645046@N00,5697,11,1157260220,1157260220,1,1,0
93645046@N00,5698,11,1157374524,1157374524,1,1,0
93645046@N00,5699,22,1178947384,1178951529,21,1,4145
93645046@N00,5700,4,1184996097,1184996237,4,1,140
93741870@N00,5701,30,1191450525,1191450833,2,1,308
93824428@N00,5702,6,1114849951,1114849951,1,1,0
93851844@N00,5703,7,1290298344,1290299563,2,1,1219
93852598@N00,5704,6,1157170404,1157170404,1,1,0
93852598@N00,5705,4,1157255723,1157256683,2,2,960
93852598@N00,5705,16,1157246473,1157255189,10,2,8716
93871603@N00,5706,17,1252318769,1252318769,1,1,0
93897327@N00,5707,7,1216037771,1216037918,2,4,147
93897327@N00,5707,11,1216011322,1216011994,4,4,672
93897327@N00,5707,16,1216035268,1216035268,1,4,0
93897327@N00,5707,24,1216015888,1216020949,3,4,5061
94064020@N00,5708,6,1243679414,1243681756,9,1,2342
94064020@N00,5709,6,1286020475,1286020868,4,4,393
94064020@N00,5709,11,1286027844,1286028150,4,4,306
94064020@N00,5709,21,1286033116,1286033690,3,4,574
94064020@N00,5709,28,1286034885,1286034939,3,4,54
94064020@N00,5710,1,1306635477,1306637817,11,2,2340
94064020@N00,5710,23,1306624514,1306627188,30,2,2674
94064020@N00,5711,1,1311376486,1311376505,3,2,19
94064020@N00,5711,19,1311380521,1311380521,1,2,0
94064020@N00,5712,3,1322598568,1322603935,60,1,5367
94064020@N00,5713,22,1338510542,1338516405,28,1,5863
94064020@N00,5714,21,1339852307,1339852510,3,1,203
9416709@N08,5715,8,1381122058,1381122337,2,3,279
9416709@N08,5715,16,1381117512,1381117512,1,3,0
9416709@N08,5715,22,1381111118,1381111952,2,3,834
94382772@N00,5716,27,1284521208,1284528349,7,1,7141
94382772@N00,5717,1,1302852507,1302852507,1,2,0
94382772@N00,5717,24,1302823145,1302852494,13,2,29349
94382772@N00,5718,21,1310641429,1310647874,10,1,6445
94409852@N03,5719,22,1382755313,1382757354,30,1,2041
94416001@N00,5720,21,1130076803,1130076813,4,1,10
94416001@N00,5721,21,1130128375,1130128375,1,1,0
94416001@N00,5722,25,1140092488,1140092488,1,1,0
94416001@N00,5723,19,1157883895,1157883895,1,1,0
94416001@N00,5724,25,1161497008,1161497015,2,1,7
94416001@N00,5725,22,1174103488,1174104075,5,1,587
94416001@N00,5726,10,1209188207,1209188207,1,1,0
94416001@N00,5727,13,1241329047,1241329351,3,1,304
94416001@N00,5728,25,1247896281,1247896281,1,1,0
94416001@N00,5729,25,1248583433,1248589556,11,1,6123
94416001@N00,5730,4,1249110356,1249110356,1,1,0
94416001@N00,5731,27,1260628937,1260629208,2,1,271
94416001@N00,5732,6,1287227578,1287227825,2,1,247
9449875@N03,5733,29,1252218314,1252218779,4,1,465
9449875@N03,5734,11,1254015400,1254022583,5,1,7183
9449875@N03,5735,23,1256368564,1256368564,1,1,0
9449875@N03,5736,16,1259453489,1259466684,89,1,13195
9449875@N03,5737,11,1264048017,1264048017,1,1,0
9449875@N03,5738,21,1268355498,1268355498,1,1,0
9449875@N03,5739,21,1269673865,1269682141,9,1,8276
9449875@N03,5740,24,1274050528,1274073971,9,1,23443
9449875@N03,5741,24,1274138271,1274156347,8,1,18076
9449875@N03,5742,11,1276353544,1276353662,2,1,118
9449875@N03,5743,11,1276501569,1276501569,1,1,0
9449875@N03,5744,24,1276732592,1276749497,8,1,16905
9449875@N03,5745,21,1276926761,1276931682,9,1,4921
9449875@N03,5746,7,1279706001,1279706095,2,1,94
9449875@N03,5747,21,1286018624,1286018742,4,3,118
9449875@N03,5747,23,1286019672,1286022071,4,3,2399
9449875@N03,5747,28,1286016761,1286016761,1,3,0
9449875@N03,5748,9,1286062803,1286072483,4,1,9680
9449875@N03,5749,16,1290903013,1290911420,15,1,8407
9449875@N03,5750,11,1313294955,1313306483,11,1,11528
9449875@N03,5751,2,1314505829,1314506986,2,3,1157
9449875@N03,5751,14,1314503476,1314505178,3,3,1702
9449875@N03,5751,17,1314522354,1314522354,1,3,0
9449875@N03,5752,27,1315526418,1315528974,2,1,2556
9449875@N03,5753,11,1332553326,1332562968,17,1,9642
94662720@N00,5754,13,1196496350,1196509090,18,1,12740
94662720@N00,5755,21,1219547347,1219547347,1,2,0
94662720@N00,5755,23,1219548741,1219548931,2,2,190
94662720@N00,5756,30,1276000822,1276000822,1,1,0
94725783@N00,5757,16,1318941829,1318941829,1,1,0
94725783@N00,5758,6,1336282969,1336282969,1,1,0
94725783@N00,5759,21,1355294659,1355294659,1,4,0
94725783@N00,5759,22,1355293242,1355293242,1,4,0
94725783@N00,5759,23,1355293736,1355293736,1,4,0
94725783@N00,5759,25,1355284483,1355286873,10,4,2390
94725783@N00,5760,25,1355964431,1355964431,1,1,0
94725783@N00,5761,6,1356047225,1356048745,5,1,1520
94828981@N08,5762,21,1362030959,1362030959,1,1,0
94828981@N08,5763,21,1363147962,1363147962,1,1,0
94828981@N08,5764,11,1364196097,1364196097,1,1,0
94828981@N08,5765,23,1365235537,1365235537,1,1,0
94828981@N08,5766,27,1366501503,1366501503,1,1,0
94828981@N08,5767,27,1366702619,1366702619,1,1,0
94828981@N08,5768,21,1367823237,1367823237,1,2,0
94828981@N08,5768,25,1367830740,1367830740,1,2,0
94828981@N08,5769,21,1369297106,1369297507,2,1,401
94828981@N08,5770,25,1369363200,1369363200,1,1,0
94828981@N08,5771,27,1369446156,1369446156,1,1,0
94828981@N08,5772,27,1370141237,1370141237,1,1,0
94828981@N08,5773,21,1371018525,1371018525,1,2,0
94828981@N08,5773,28,1371020219,1371020219,1,2,0
94828981@N08,5774,16,1371200981,1371200981,1,1,0
94828981@N08,5775,21,1371956399,1371958895,3,1,2496
94828981@N08,5776,21,1372738918,1372738918,1,1,0
94828981@N08,5777,11,1372830778,1372830778,1,1,0
94828981@N08,5778,21,1374132033,1374132033,1,1,0
94828981@N08,5779,21,1374215455,1374216329,2,2,874
94828981@N08,5779,23,1374217534,1374217534,1,2,0
94828981@N08,5780,21,1374650664,1374650664,1,1,0
94828981@N08,5781,21,1375951220,1375951220,1,1,0
94828981@N08,5782,21,1376478440,1376478440,1,1,0
94828981@N08,5783,21,1378203260,1378203260,1,1,0
94828981@N08,5784,21,1378359166,1378359337,2,1,171
94828981@N08,5785,23,1378711308,1378724133,2,1,12825
94828981@N08,5786,21,1378971154,1378971154,1,1,0
94828981@N08,5787,23,1379918712,1379918712,1,1,0
94828981@N08,5788,21,1380020085,1380020085,1,1,0
94828981@N08,5789,21,1380179570,1380194510,2,1,14940
94828981@N08,5790,21,1380607001,1380607696,4,1,695
94828981@N08,5791,22,1380980919,1380980919,1,1,0
94828981@N08,5792,21,1381213508,1381213508,1,1,0
94828981@N08,5793,21,1382418533,1382419319,2,1,786
94828981@N08,5794,21,1382764419,1382764419,1,1,0
94828981@N08,5795,21,1384858943,1384858943,1,1,0
94828981@N08,5796,21,1385533334,1385534256,3,1,922
94828981@N08,5797,21,1386048027,1386048027,1,1,0
94828981@N08,5798,21,1387690177,1387690177,1,3,0
94828981@N08,5798,23,1387690888,1387690888,1,3,0
94828981@N08,5798,28,1387692331,1387692702,3,3,371
94894823@N00,5799,4,1262263132,1262263132,1,1,0
94894823@N00,5800,4,1262422678,1262422678,1,1,0
9492113@N02,5801,21,1305053037,1305053037,1,1,0
9492113@N02,5802,22,1305232373,1305232373,1,1,0
9492113@N02,5803,28,1305310878,1305310878,1,1,0
9492113@N02,5804,21,1305360683,1305360683,1,1,0
9492113@N02,5805,23,1310539940,1310539940,1,1,0
9492113@N02,5806,16,1310886148,1310886148,1,1,0
9492113@N02,5807,4,1311983154,1311984148,2,1,994
9492113@N02,5808,4,1312066330,1312066330,1,1,0
9492113@N02,5809,22,1314166477,1314167258,2,1,781
9492113@N02,5810,24,1315107637,1315107637,1,1,0
9492113@N02,5811,21,1315548915,1315548915,1,1,0
9492113@N02,5812,25,1316989407,1317016040,2,1,26633
9492113@N02,5813,25,1317063501,1317063501,1,1,0
9492113@N02,5814,25,1317166175,1317166175,1,1,0
9492113@N02,5815,21,1317509172,1317509172,1,1,0
9492113@N02,5816,22,1317585040,1317585040,1,1,0
9492113@N02,5817,22,1317805418,1317805418,1,1,0
9492113@N02,5818,28,1318550913,1318550913,1,1,0
9492113@N02,5819,21,1320809663,1320809663,1,1,0
9492113@N02,5820,22,1325222903,1325222903,1,1,0
9492113@N02,5821,7,1325332540,1325332540,1,1,0
9492113@N02,5822,23,1325841446,1325841446,1,1,0
9492113@N02,5823,23,1326278886,1326278886,1,1,0
9492113@N02,5824,7,1326526461,1326526461,1,1,0
9492113@N02,5825,21,1326871871,1326871871,1,1,0
9492113@N02,5826,21,1327364351,1327364351,1,1,0
9492113@N02,5827,7,1329545735,1329545735,1,1,0
9492113@N02,5828,21,1336357170,1336357170,1,1,0
9492113@N02,5829,4,1337411260,1337411260,1,1,0
9492113@N02,5830,25,1344814042,1344814042,1,1,0
95128448@N00,5831,1,1221803863,1221803863,1,1,0
95128448@N00,5832,27,1221887848,1221887848,1,1,0
95128448@N00,5833,22,1276742279,1276742458,10,2,179
95128448@N00,5833,28,1276742091,1276742172,4,2,81
95128448@N00,5834,1,1277184997,1277184997,1,1,0
95674706@N00,5835,16,1129907592,1129909380,9,1,1788
95766322@N00,5836,22,1191160800,1191160800,1,1,0
95766322@N00,5837,22,1192862329,1192862329,1,1,0
9584004@N03,5838,6,1215237306,1215237687,8,2,381
9584004@N03,5838,25,1215238167,1215239829,18,2,1662
95933287@N00,5839,25,1165143947,1165143947,1,1,0
95933287@N00,5840,27,1165192859,1165192859,1,1,0
9595542@N03,5841,21,1199079679,1199082510,5,2,2831
9595542@N03,5841,23,1199083021,1199083033,2,2,12
96083563@N00,5842,7,1218325968,1218325968,1,3,0
96083563@N00,5842,11,1218336248,1218336731,3,3,483
96083563@N00,5842,16,1218329644,1218329644,1,3,0
96241281@N00,5843,28,1186033312,1186033317,2,1,5
96241281@N00,5844,22,1186095003,1186095003,1,1,0
96241281@N00,5845,22,1186178373,1186203126,2,1,24753
9640216@N04,5846,1,1393730077,1393730077,1,1,0
96416581@N00,5847,28,1165145385,1165145385,1,1,0
96416581@N00,5848,28,1184321253,1184323612,2,1,2359
96416581@N00,5849,4,1334464299,1334464299,1,1,0
96416581@N00,5850,4,1344598164,1344598164,1,1,0
96416581@N00,5851,30,1352611603,1352611603,1,1,0
96416581@N00,5852,11,1370673346,1370673346,1,1,0
96475889@N00,5853,22,1367291403,1367291403,1,1,0
96545415@N00,5854,16,1333591148,1333591148,1,1,0
96545415@N00,5855,22,1347959528,1347959528,1,1,0
96684313@N00,5856,7,1282604211,1282604649,4,3,438
96684313@N00,5856,8,1282634385,1282649861,51,3,15476
96684313@N00,5856,30,1282605552,1282605665,3,3,113
96863630@N00,5857,11,1343358872,1343358872,1,1,0
97092152@N00,5858,22,1197439372,1197439372,1,1,0
97092152@N00,5859,22,1198483517,1198483517,1,1,0
97092152@N00,5860,23,1198627231,1198631834,3,1,4603
97171555@N00,5861,25,1211685201,1211686292,9,1,1091
97171555@N00,5862,25,1252126973,1252126973,1,1,0
97171555@N00,5863,28,1276255133,1276255133,1,1,0
97171555@N00,5864,25,1280028121,1280030213,3,1,2092
97171555@N00,5865,25,1310790298,1310790310,2,1,12
97171555@N00,5866,16,1311911470,1311911470,1,1,0
97171555@N00,5867,25,1333775443,1333775443,1,1,0
97171555@N00,5868,6,1336187525,1336187525,1,1,0
97171555@N00,5869,13,1338104676,1338104676,1,1,0
97171555@N00,5870,28,1347118593,1347118593,1,1,0
97171555@N00,5871,25,1354332435,1354332435,1,1,0
97171555@N00,5872,22,1372213662,1372214035,12,1,373
97179711@N04,5873,16,1306335014,1306335014,1,1,0
97201346@N00,5874,16,1164075183,1164075183,1,1,0
97201346@N00,5875,30,1178422229,1178422229,1,1,0
97201346@N00,5876,25,1179723246,1179723246,1,1,0
97201346@N00,5877,11,1181385142,1181385142,1,1,0
97241039@N00,5878,16,1302939691,1302939691,1,1,0
97241039@N00,5879,16,1304827920,1304828134,4,1,214
97241039@N00,5880,21,1309070243,1309070243,1,1,0
97373666@N00,5881,22,1226209201,1226209201,1,1,0
97373666@N00,5882,3,1229413063,1229413063,1,1,0
97373666@N00,5883,22,1239007168,1239007168,1,1,0
97373666@N00,5884,22,1255861352,1255861352,1,1,0
97373666@N00,5885,22,1387069783,1387069783,1,1,0
97373666@N00,5886,8,1395336635,1395336759,2,1,124
97478728@N00,5887,25,1364588186,1364588299,2,1,113
97551727@N00,5888,7,1222931596,1222931596,1,1,0
97639305@N00,5889,16,1103523332,1103523332,1,1,0
97675182@N00,5890,2,1178949472,1178956581,10,3,7109
97675182@N00,5890,14,1178957121,1178957139,2,3,18
97675182@N00,5890,17,1178957969,1178958717,2,3,748
97768382@N00,5891,6,1258795103,1258796985,6,2,1882
97768382@N00,5891,11,1258805525,1258824678,2,2,19153
97904784@N00,5892,16,1191917011,1191927877,21,1,10866
97904784@N00,5893,7,1192002164,1192011826,23,2,9662
97904784@N00,5893,16,1191973673,1191973687,3,2,14
98001747@N00,5894,11,1270979755,1270979755,1,1,0
98001747@N00,5895,11,1271421313,1271421313,1,1,0
98001747@N00,5896,11,1271492915,1271496535,2,1,3620
98123816@N00,5897,16,1087879071,1087879071,1,1,0
98123816@N00,5898,23,1127199438,1127199438,2,1,0
98123816@N00,5899,21,1129024445,1129024445,1,1,0
98123816@N00,5900,3,1138354289,1138354289,1,1,0
98123816@N00,5901,21,1139095839,1139095839,1,1,0
98123816@N00,5902,7,1151210962,1151210962,1,1,0
98123816@N00,5903,16,1152962425,1152962425,1,1,0
98123816@N00,5904,23,1195915159,1195915877,2,1,718
98123816@N00,5905,22,1201340364,1201340364,1,1,0
98153629@N00,5906,6,1289535784,1289535832,2,1,48
98153629@N00,5907,16,1289623873,1289627149,9,1,3276
98153629@N00,5908,3,1347531505,1347536711,2,2,5206
98153629@N00,5908,21,1347533580,1347533580,1,2,0
98153629@N00,5909,24,1347666958,1347666958,1,1,0
98179942@N02,5910,30,1306652115,1306652115,1,1,0
98185064@N00,5911,6,1241831306,1241831306,1,2,0
98185064@N00,5911,11,1241840138,1241841345,2,2,1207
98185064@N00,5912,4,1242102827,1242115719,2,3,12892
98185064@N00,5912,16,1242116997,1242116997,1,3,0
98185064@N00,5912,28,1242097142,1242097142,1,3,0
98222757@N02,5913,7,1344214289,1344217079,2,4,2790
98222757@N02,5913,23,1344208919,1344208919,1,4,0
98222757@N02,5913,24,1344219136,1344219136,1,4,0
98222757@N02,5913,28,1344209256,1344209949,2,4,693
98222757@N02,5914,16,1344299800,1344299800,1,1,0
98321778@N00,5915,22,1301870765,1301871192,5,1,427
98321778@N00,5916,6,1378437582,1378440980,6,1,3398
98321778@N00,5917,16,1388043942,1388043942,1,2,0
98321778@N00,5917,24,1388041576,1388045820,5,2,4244
98321778@N00,5918,27,1388104096,1388104096,1,1,0
98453206@N00,5919,16,1389570400,1389572761,4,1,2361
98471558@N00,5920,27,1325829049,1325829073,2,1,24
98715075@N00,5921,18,1185619693,1185619693,1,1,0
98715075@N00,5922,4,1186379050,1186379916,5,1,866
98715075@N00,5923,4,1190107447,1190107447,1,1,0
98715075@N00,5924,4,1190438680,1190438763,2,1,83
98715075@N00,5925,4,1190536050,1190536116,2,1,66
98715075@N00,5926,4,1190912171,1190912261,2,1,90
98715075@N00,5927,1,1200700130,1200700130,1,3,0
98715075@N00,5927,4,1200705924,1200706069,2,3,145
98715075@N00,5927,30,1200700529,1200700896,2,3,367
98715075@N00,5928,1,1201164417,1201165329,3,1,912
98715075@N00,5929,4,1214387710,1214393028,8,1,5318
98715075@N00,5930,25,1220865876,1220865876,1,1,0
98715075@N00,5931,30,1221634365,1221634369,2,1,4
98715075@N00,5932,21,1223129813,1223129813,1,3,0
98715075@N00,5932,22,1223125536,1223125539,2,3,3
98715075@N00,5932,23,1223126233,1223126233,1,3,0
98715075@N00,5933,6,1231293195,1231293195,1,1,0
98715075@N00,5934,8,1237073520,1237073520,1,1,0
98715075@N00,5935,4,1246275082,1246275082,1,1,0
98715075@N00,5936,23,1254577718,1254577718,1,1,0
98715075@N00,5937,4,1337480935,1337480935,1,1,0
98715075@N00,5938,8,1366699282,1366699282,1,1,0
98715075@N00,5939,13,1382682887,1382682887,1,1,0
98782544@N00,5940,26,1384751582,1384751582,1,1,0
98833136@N00,5941,7,933429600,933429600,2,1,0
98879514@N00,5942,16,1184465463,1184465463,1,1,0
98944018@N00,5943,25,1247911046,1247911046,1,1,0
98966112@N00,5944,2,1216076878,1216076878,1,1,0
99029180@N00,5945,1,1394708408,1394708408,1,1,0
99063926@N00,5946,4,1334740599,1334740599,1,1,0
9911655@N08,5947,8,1211653564,1211654820,40,3,1256
9911655@N08,5947,25,1211643255,1211643938,18,3,683
9911655@N08,5947,29,1211646493,1211649807,65,3,3314
9911655@N08,5948,30,1276760349,1276764026,69,1,3677
9911655@N08,5949,21,1276843920,1276845720,7,1,1800
9911655@N08,5950,21,1279093664,1279101006,34,1,7342
9911655@N08,5951,21,1279182114,1279182114,1,1,0
9911655@N08,5952,21,1285988877,1286006621,8,1,17744
9911655@N08,5953,21,1322121633,1322121682,2,1,49
9911655@N08,5954,21,1337318552,1337318700,2,1,148
9911655@N08,5955,21,1339129393,1339132183,24,1,2790
9911655@N08,5956,21,1345179365,1345180725,19,1,1360
9911655@N08,5957,21,1348295680,1348295680,1,1,0
9911655@N08,5958,22,1368088189,1368088566,10,2,377
9911655@N08,5958,23,1368083001,1368083001,1,2,0
9911655@N08,5959,21,1368691216,1368691288,2,3,72
9911655@N08,5959,28,1368689071,1368690950,9,3,1879
9911655@N08,5959,30,1368692435,1368692435,1,3,0
9911655@N08,5960,1,1376629836,1376630159,8,2,323
9911655@N08,5960,24,1376630171,1376631969,29,2,1798
9911655@N08,5961,11,1376706549,1376706549,1,1,0
99125755@N00,5962,11,1249447242,1249452726,51,2,5484
99125755@N00,5962,13,1249440550,1249440606,2,2,56
99127884@N00,5963,21,1252218174,1252219496,2,3,1322
99127884@N00,5963,23,1252222089,1252222203,2,3,114
99127884@N00,5963,28,1252224560,1252224560,1,3,0
99127884@N00,5964,1,1252305865,1252305883,3,9,18
99127884@N00,5964,6,1252291347,1252302039,9,9,10692
99127884@N00,5964,7,1252305264,1252305347,2,9,83
99127884@N00,5964,11,1252286703,1252286989,7,9,286
99127884@N00,5964,15,1252309267,1252309296,4,9,29
99127884@N00,5964,22,1252303538,1252303740,8,9,202
99127884@N00,5964,28,1252304366,1252304366,1,9,0
99127884@N00,5964,29,1252287781,1252288319,13,9,538
99127884@N00,5964,30,1252305561,1252305561,1,9,0
99242024@N00,5965,8,1314440576,1314440576,1,1,0
99242024@N00,5966,11,1320802484,1320802484,1,1,0
99336797@N00,5967,16,1146685960,1146691418,3,1,5458
99345230@N00,5968,11,1297954924,1297954924,4,1,0
99385068@N00,5969,8,1187077209,1187077250,3,1,41
9942515@N05,5970,22,1292746706,1292746782,2,1,76
99436246@N00,5971,16,1284012909,1284015323,6,3,2414
99436246@N00,5971,22,1284019438,1284019438,1,3,0
99436246@N00,5971,29,1284022140,1284022140,1,3,0
9975544@N07,5972,25,1192269239,1192269239,1,1,0
99771506@N00,5973,16,1104403938,1104403938,1,1,0
99771506@N00,5974,8,1171724917,1171724917,1,1,0
99771506@N00,5975,13,1215915779,1215915779,1,1,0
99771506@N00,5976,8,1227330261,1227330261,1,1,0
99771506@N00,5977,23,1228007318,1228007318,1,1,0
99771506@N00,5978,22,1306560358,1306560358,1,1,0
99771506@N00,5979,23,1306645304,1306646956,2,1,1652
99771506@N00,5980,2,1311756088,1311756088,1,2,0
99771506@N00,5980,17,1311765590,1311765590,1,2,0
99771506@N00,5981,2,1358588099,1358588099,1,8,0
99771506@N00,5981,7,1358588130,1358590669,3,8,2539
99771506@N00,5981,11,1358579904,1358605243,2,8,25339
99771506@N00,5981,13,1358588017,1358588017,1,8,0
99771506@N00,5981,21,1358598109,1358598109,1,8,0
99771506@N00,5981,23,1358588114,1358589239,2,8,1125
99771506@N00,5981,29,1358583196,1358583310,3,8,114
99771506@N00,5981,30,1358588038,1358588038,1,8,0
99771506@N00,5982,7,1369525303,1369525303,1,2,0
99771506@N00,5982,30,1369520409,1369520409,1,2,0
99771506@N00,5983,22,1380997071,1380999549,2,1,2478
9985167@N04,5984,22,1201327778,1201328860,2,1,1082
9985167@N04,5985,21,1202116734,1202116853,2,1,119
9985167@N04,5986,10,1202157651,1202158427,3,1,776
9985167@N04,5987,22,1202556707,1202556906,2,2,199
9985167@N04,5987,30,1202543998,1202543998,1,2,0
9985167@N04,5988,21,1203589951,1203589951,1,1,0
9985167@N04,5989,3,1203930874,1203930874,1,1,0
9985167@N04,5990,21,1204528480,1204528522,2,1,42
9985167@N04,5991,10,1204854964,1204854964,1,1,0
9985167@N04,5992,29,1205706975,1205706975,1,1,0
9985167@N04,5993,11,1205915693,1205915693,1,2,0
9985167@N04,5993,27,1205916661,1205916661,1,2,0
9985167@N04,5994,21,1206076408,1206076408,1,2,0
9985167@N04,5994,23,1206074859,1206074859,1,2,0
9985167@N04,5995,21,1206109982,1206109982,1,1,0
9985167@N04,5996,21,1206430988,1206431045,3,1,57
9985167@N04,5997,23,1206926015,1206926015,1,1,0
9985167@N04,5998,21,1207458552,1207458552,1,1,0
9985167@N04,5999,11,1207899776,1207899776,1,1,0
9985167@N04,6000,10,1207980494,1207980494,1,1,0
9985167@N04,6001,23,1208058432,1208058432,1,1,0
9985167@N04,6002,3,1208343719,1208343719,1,1,0
9985167@N04,6003,21,1208428998,1208428998,1,1,0
9985167@N04,6004,28,1208514197,1208514197,1,1,0
9985167@N04,6005,21,1208771092,1208771092,1,1,0
9985167@N04,6006,23,1209217454,1209217454,1,1,0
9985167@N04,6007,21,1209266586,1209272398,2,1,5812
9985167@N04,6008,21,1209553123,1209553123,1,1,0
9985167@N04,6009,21,1209885925,1209886086,2,1,161
9985167@N04,6010,21,1209983808,1209984585,3,1,777
9985167@N04,6011,21,1210493363,1210493363,1,3,0
9985167@N04,6011,22,1210488261,1210488261,1,3,0
9985167@N04,6011,28,1210489464,1210489464,1,3,0
9985167@N04,6012,22,1211621252,1211621425,2,1,173
9985167@N04,6013,6,1211802131,1211802131,1,1,0
9985167@N04,6014,10,1213096845,1213096845,1,1,0
9985167@N04,6015,21,1213357896,1213358016,2,1,120
9985167@N04,6016,10,1214701250,1214705604,6,1,4354
9985167@N04,6017,7,1214913975,1214913975,1,2,0
9985167@N04,6017,30,1214913983,1214918886,2,2,4903
9985167@N04,6018,21,1217667981,1217674236,7,3,6255
9985167@N04,6018,23,1217665689,1217667493,3,3,1804
9985167@N04,6018,28,1217665504,1217665504,1,3,0
9985167@N04,6019,23,1217924006,1217924482,3,2,476
9985167@N04,6019,28,1217925453,1217929559,8,2,4106
9985167@N04,6020,23,1219398383,1219398383,1,1,0
9985167@N04,6021,23,1219559787,1219559787,1,1,0
9985167@N04,6022,21,1219657376,1219657376,1,1,0
9985167@N04,6023,21,1220011803,1220011803,1,2,0
9985167@N04,6023,23,1220001764,1220001767,2,2,3
9985167@N04,6024,21,1220259926,1220259926,1,1,0
9985167@N04,6025,10,1220689612,1220689612,1,1,0
9985167@N04,6026,21,1220864677,1220864677,1,2,0
9985167@N04,6026,23,1220863713,1220863713,1,2,0
9985167@N04,6027,21,1221371881,1221377057,5,1,5176
9985167@N04,6028,3,1223129153,1223129153,1,5,0
9985167@N04,6028,22,1223124574,1223124574,1,5,0
9985167@N04,6028,23,1223109764,1223110034,2,5,270
9985167@N04,6028,28,1223125358,1223125358,1,5,0
9985167@N04,6028,30,1223121418,1223121758,2,5,340
9985167@N04,6029,21,1228303850,1228304321,6,1,471
9985167@N04,6030,22,1230733228,1230733228,1,1,0
9985167@N04,6031,23,1231143948,1231143948,1,1,0
9985167@N04,6032,11,1232102482,1232102482,1,1,0
9985167@N04,6033,22,1238224384,1238224578,2,1,194
9985167@N04,6034,23,1255944477,1255944477,1,1,0
9985167@N04,6035,25,1256362474,1256362474,1,1,0
99906907@N00,6036,26,1142413769,1142415732,3,1,1963
99906907@N00,6037,26,1143059030,1143059030,1,1,0
99906907@N00,6038,21,1143786189,1143786189,1,1,0
99906907@N00,6039,21,1145830992,1145830992,1,1,0
99906907@N00,6040,22,1145947335,1145947335,1,1,0
99906907@N00,6041,23,1146005377,1146033113,4,1,27736
99906907@N00,6042,23,1146178372,1146178372,1,1,0
99906907@N00,6043,8,1178339449,1178340299,2,2,850
99906907@N00,6043,22,1178331800,1178331800,1,2,0
99906907@N00,6044,3,1182673560,1182673560,1,1,0
99906907@N00,6045,11,1199061309,1199077107,11,1,15798
99906907@N00,6046,10,1255127979,1255135247,10,1,7268
99906907@N00,6047,7,1256246320,1256273364,4,1,27044
99906907@N00,6048,10,1281746737,1281746737,1,1,0
99906907@N00,6049,9,1286681068,1286704888,4,1,23820
99906907@N00,6050,10,1287189680,1287204023,3,1,14343
99906907@N00,6051,9,1287304161,1287308493,3,1,4332
99906907@N00,6052,9,1290843478,1290843478,1,1,0
99906907@N00,6053,9,1299317179,1299321548,2,1,4369
99906907@N00,6054,10,1299911514,1299911514,1,1,0
99906907@N00,6055,10,1304750599,1304757433,5,1,6834
99906907@N00,6056,9,1312708790,1312708790,1,1,0
99906907@N00,6057,11,1354954784,1354954784,1,1,0
